사용일자,노선명,역명,승차총승객수,하차총승객수,승하차객수,승하차객_2
20240701,9호선2~3단계,석촌고분,7665,7414,15079,7539.5
20240701,중앙선,도농,12178,10957,23135,11567.5
20240701,중앙선,구리,14053,14085,28138,14069
20240701,4호선,길음,22687,22215,44902,22451
20240701,분당선,복정,1,0,1,0.5
20240701,중앙선,오빈,341,346,687,343.5
20240701,중앙선,양평,3373,3272,6645,3322.5
20240701,중앙선,원덕,395,343,738,369
20240701,중앙선,용문,2079,2014,4093,2046.5
20240701,중앙선,지평,83,92,175,87.5
20240701,중앙선,양원,3609,3434,7043,3521.5
20240701,중앙선,망우,8145,7826,15971,7985.5
20240701,중앙선,상봉,6388,6324,12712,6356
20240701,중앙선,중랑,5804,5629,11433,5716.5
20240701,중앙선,회기,26435,25277,51712,25856
20240701,장항선,신창(순천향대),1298,1444,2742,1371
20240701,장항선,온양온천,4436,4400,8836,4418
20240701,장항선,배방,1283,1245,2528,1264
20240701,장항선,탕정,1799,1636,3435,1717.5
20240701,중앙선,양정,684,534,1218,609
20240701,중앙선,덕소,5723,5704,11427,5713.5
20240701,중앙선,도심,2673,2107,4780,2390
20240701,중앙선,팔당,858,874,1732,866
20240701,중앙선,운길산,711,719,1430,715
20240701,중앙선,양수,2098,2121,4219,2109.5
20240701,중앙선,신원,180,168,348,174
20240701,중앙선,국수,779,775,1554,777
20240701,중앙선,아신,559,550,1109,554.5
20240701,장항선,아산,3724,3451,7175,3587.5
20240701,장항선,쌍용(나사렛대),2408,2391,4799,2399.5
20240701,장항선,봉명,1647,1631,3278,1639
20240701,일산선,대화,15161,11585,26746,13373
20240701,일산선,주엽,10577,10751,21328,10664
20240701,일산선,정발산,7465,7571,15036,7518
20240701,일산선,마두,8834,9065,17899,8949.5
20240701,일산선,백석,10586,10627,21213,10606.5
20240701,일산선,대곡,3314,2429,5743,2871.5
20240701,일산선,화정,18060,18600,36660,18330
20240701,일산선,원당,11883,11284,23167,11583.5
20240701,일산선,삼송,20233,19728,39961,19980.5
20240701,일산선,지축,1,0,1,0.5
20240701,일산선,원흥,12308,11761,24069,12034.5
20240701,우이신설선,신설동,2711,2431,5142,2571
20240701,우이신설선,보문,1755,1695,3450,1725
20240701,우이신설선,성신여대입구(돈암),3949,4255,8204,4102
20240701,우이신설선,정릉,5087,5062,10149,5074.5
20240701,우이신설선,북한산보국문,6534,6689,13223,6611.5
20240701,우이신설선,솔샘,6167,6581,12748,6374
20240701,우이신설선,삼양사거리,2961,3014,5975,2987.5
20240701,우이신설선,삼양,2351,2604,4955,2477.5
20240701,우이신설선,화계,4007,3943,7950,3975
20240701,우이신설선,가오리,4740,4981,9721,4860.5
20240701,우이신설선,4.19민주묘지,3412,3357,6769,3384.5
20240701,우이신설선,솔밭공원,2959,2970,5929,2964.5
20240701,우이신설선,북한산우이,3383,3105,6488,3244
20240701,안산선,수리산,4419,3720,8139,4069.5
20240701,안산선,오이도,8111,8173,16284,8142
20240701,안산선,정왕,9549,9757,19306,9653
20240701,안산선,신길온천,2188,1883,4071,2035.5
20240701,안산선,안산,13053,11933,24986,12493
20240701,안산선,초지,5322,5213,10535,5267.5
20240701,안산선,고잔,9541,8991,18532,9266
20240701,안산선,중앙,19119,19660,38779,19389.5
20240701,안산선,한대앞,9699,9797,19496,9748
20240701,안산선,상록수,15543,15840,31383,15691.5
20240701,안산선,반월,4737,4718,9455,4727.5
20240701,안산선,대야미,5301,4887,10188,5094
20240701,안산선,산본,17151,18133,35284,17642
20240701,신림선,관악산(서울대),3405,3312,6717,3358.5
20240701,신림선,서울대벤처타운,10276,9722,19998,9999
20240701,신림선,서원,3838,3328,7166,3583
20240701,신림선,신림,2105,2784,4889,2444.5
20240701,신림선,당곡,5297,5221,10518,5259
20240701,신림선,보라매병원,8309,8829,17138,8569
20240701,신림선,보라매공원,2406,2667,5073,2536.5
20240701,신림선,보라매,4649,4301,8950,4475
20240701,신림선,서울지방병무청,3414,3851,7265,3632.5
20240701,신림선,대방,3149,2584,5733,2866.5
20240701,신림선,샛강,3585,3850,7435,3717.5
20240701,수인선,인천,1120,1751,2871,1435.5
20240701,수인선,신포,2004,2041,4045,2022.5
20240701,수인선,숭의,4614,4327,8941,4470.5
20240701,수인선,인하대,6810,6541,13351,6675.5
20240701,수인선,송도,2686,2439,5125,2562.5
20240701,수인선,연수,4988,4908,9896,4948
20240701,수인선,원인재,4614,4752,9366,4683
20240701,수인선,남동인더스파크,2523,2842,5365,2682.5
20240701,수인선,인천논현,5903,6170,12073,6036.5
20240701,수인선,소래포구,5034,4616,9650,4825
20240701,수인선,월곶,2928,2642,5570,2785
20240701,수인선,달월,122,68,190,95
20240701,수인선,사리,5400,4645,10045,5022.5
20240701,수인선,야목,436,379,815,407.5
20240701,수인선,어천,1495,1448,2943,1471.5
20240701,수인선,오목천,4288,3918,8206,4103
20240701,수인선,고색,5984,5427,11411,5705.5
20240701,서해선,부천종합운동장,2692,2287,4979,2489.5
20240701,서해선,원종,4946,5084,10030,5015
20240701,서해선,김포공항,2966,3772,6738,3369
20240701,분당선,매교,5904,5819,11723,5861.5
20240701,분당선,수원시청,14602,15421,30023,15011.5
20240701,분당선,매탄권선,5868,5789,11657,5828.5
20240701,분당선,망포,16591,15992,32583,16291.5
20240701,분당선,영통,9284,9619,18903,9451.5
20240701,분당선,청명,4902,4733,9635,4817.5
20240701,분당선,상갈,5715,5502,11217,5608.5
20240701,분당선,기흥,10910,10020,20930,10465
20240701,분당선,신갈,5166,4973,10139,5069.5
20240701,분당선,구성,6987,7128,14115,7057.5
20240701,분당선,죽전,12570,14007,26577,13288.5
20240701,분당선,보정,2918,2663,5581,2790.5
20240701,분당선,이매,6117,5741,11858,5929
20240701,분당선,오리,12565,10958,23523,11761.5
20240701,분당선,미금,16867,17332,34199,17099.5
20240701,분당선,정자,19767,20595,40362,20181
20240701,분당선,수내,15207,15363,30570,15285
20240701,분당선,서현,26175,26769,52944,26472
20240701,분당선,야탑,26938,28223,55161,27580.5
20240701,분당선,모란,20556,21025,41581,20790.5
20240701,분당선,태평,14003,13285,27288,13644
20240701,분당선,가천대,8035,8497,16532,8266
20240701,분당선,선정릉,8596,8883,17479,8739.5
20240701,분당선,강남구청,10503,12110,22613,11306.5
20240701,분당선,압구정로데오,18383,19745,38128,19064
20240701,분당선,서울숲,13330,13412,26742,13371
20240701,분당선,수원,8242,7555,15797,7898.5
20240701,분당선,수서,17709,18390,36099,18049.5
20240701,분당선,대모산입구,6609,6152,12761,6380.5
20240701,분당선,개포동,4945,5068,10013,5006.5
20240701,분당선,구룡,3955,3965,7920,3960
20240701,분당선,도곡,8753,8748,17501,8750.5
20240701,분당선,한티,16409,17619,34028,17014
20240701,분당선,선릉,15294,23287,38581,19290.5
20240701,과천선,범계,28498,28256,56754,28377
20240701,과천선,평촌,19609,19265,38874,19437
20240701,과천선,인덕원,27005,27764,54769,27384.5
20240701,과천선,정부과천청사,13532,14232,27764,13882
20240701,과천선,과천,6883,6310,13193,6596.5
20240701,과천선,대공원,2307,2358,4665,2332.5
20240701,과천선,경마공원,840,840,1680,840
20240701,과천선,선바위,7977,7060,15037,7518.5
20240701,공항철도 1호선,영종,4359,4377,8736,4368
20240701,공항철도 1호선,인천공항2터미널,7296,6561,13857,6928.5
20240701,공항철도 1호선,인천공항1터미널,15350,15558,30908,15454
20240701,공항철도 1호선,공항화물청사,2225,2442,4667,2333.5
20240701,공항철도 1호선,운서,9609,10011,19620,9810
20240701,공항철도 1호선,청라국제도시,8058,7546,15604,7802
20240701,공항철도 1호선,검암,6862,7058,13920,6960
20240701,공항철도 1호선,계양,14258,13583,27841,13920.5
20240701,공항철도 1호선,김포공항,9885,5859,15744,7872
20240701,공항철도 1호선,마곡나루(서울식물원),12879,12361,25240,12620
20240701,공항철도 1호선,디지털미디어시티,15369,14649,30018,15009
20240701,공항철도 1호선,홍대입구,14403,13852,28255,14127.5
20240701,공항철도 1호선,공덕,3387,4186,7573,3786.5
20240701,공항철도 1호선,서울역,13149,11741,24890,12445
20240701,경춘선,춘천,1375,1192,2567,1283.5
20240701,경춘선,남춘천,2341,2542,4883,2441.5
20240701,경춘선,김유정,388,369,757,378.5
20240701,경춘선,강촌,370,379,749,374.5
20240701,경춘선,백양리,79,102,181,90.5
20240701,경춘선,굴봉산,153,124,277,138.5
20240701,경춘선,가평,2228,2397,4625,2312.5
20240701,경춘선,상천,272,327,599,299.5
20240701,경춘선,청평,1902,1979,3881,1940.5
20240701,경춘선,대성리,778,1188,1966,983
20240701,경춘선,마석,4037,3815,7852,3926
20240701,경춘선,천마산,1622,1533,3155,1577.5
20240701,경춘선,평내호평,6579,6317,12896,6448
20240701,경춘선,금곡,1615,1571,3186,1593
20240701,경춘선,사릉,2175,2109,4284,2142
20240701,경춘선,퇴계원,3937,3610,7547,3773.5
20240701,경춘선,별내,3761,3523,7284,3642
20240701,경춘선,갈매,3254,2805,6059,3029.5
20240701,경춘선,신내,3119,2772,5891,2945.5
20240701,경인선,도화,4575,4224,8799,4399.5
20240701,경인선,중동,9988,9373,19361,9680.5
20240701,경인선,온수(성공회대입구),6759,6395,13154,6577
20240701,경인선,도원,3759,3793,7552,3776
20240701,경인선,간석,6207,5927,12134,6067
20240701,경인선,부개,9506,8956,18462,9231
20240701,경인선,소사,7913,7656,15569,7784.5
20240701,경인선,구일,6675,6713,13388,6694
20240701,경인선,인천,3848,3034,6882,3441
20240701,경인선,동인천,14605,13671,28276,14138
20240701,경인선,제물포,11375,11171,22546,11273
20240701,경인선,주안,19332,17328,36660,18330
20240701,경인선,동암,16363,16298,32661,16330.5
20240701,경인선,백운,8188,7939,16127,8063.5
20240701,경인선,부평,29589,30837,60426,30213
20240701,경인선,송내,28501,27996,56497,28248.5
20240701,경인선,부천,32509,32278,64787,32393.5
20240701,경인선,역곡,27054,27218,54272,27136
20240701,경인선,오류동,12436,11725,24161,12080.5
20240701,경인선,개봉,23010,22593,45603,22801.5
20240701,경의선,김포공항,1,0,1,0.5
20240701,경의선,운천,8,4,12,6
20240701,경의선,임진강,6,12,18,9
20240701,경의선,문산,6109,5435,11544,5772
20240701,경의선,파주,1380,982,2362,1181
20240701,경의선,월롱,2124,2012,4136,2068
20240701,경의선,금촌,7547,7109,14656,7328
20240701,경의선,금릉,5987,5747,11734,5867
20240701,경의선,운정,8487,8052,16539,8269.5
20240701,경의선,야당,9569,9631,19200,9600
20240701,경의선,탄현,8404,8216,16620,8310
20240701,경의선,일산,11896,11600,23496,11748
20240701,경의선,풍산,6635,6239,12874,6437
20240701,경의선,백마,8146,7880,16026,8013
20240701,경의선,곡산,727,797,1524,762
20240701,경의선,능곡,5246,4813,10059,5029.5
20240701,경의선,행신,8722,8791,17513,8756.5
20240701,경의선,강매,3650,3061,6711,3355.5
20240701,경의선,한국항공대,2291,2109,4400,2200
20240701,경의선,수색,3922,3905,7827,3913.5
20240701,경의선,디지털미디어시티,3047,2842,5889,2944.5
20240701,경의선,가좌,6600,6209,12809,6404.5
20240701,경의선,홍대입구,1999,2413,4412,2206
20240701,경의선,서강대,2412,2301,4713,2356.5
20240701,경의선,공덕,4470,3959,8429,4214.5
20240701,경의선,효창공원앞,3569,4043,7612,3806
20240701,경의선,신촌,1198,1496,2694,1347
20240701,경의선,서울역,5258,6734,11992,5996
20240701,경원선,연천,1320,1077,2397,1198.5
20240701,경원선,전곡,1180,963,2143,1071.5
20240701,경원선,청산,172,137,309,154.5
20240701,경원선,소요산,1970,1838,3808,1904
20240701,경원선,동두천,1938,1837,3775,1887.5
20240701,경원선,보산,1658,1455,3113,1556.5
20240701,경원선,동두천중앙,3363,3253,6616,3308
20240701,경원선,지행,6997,7035,14032,7016
20240701,경원선,덕정,6559,6180,12739,6369.5
20240701,경원선,덕계,6397,5828,12225,6112.5
20240701,경원선,양주,7608,7250,14858,7429
20240701,경원선,녹양,4652,4405,9057,4528.5
20240701,경원선,가능,7028,6818,13846,6923
20240701,경원선,의정부,18778,19055,37833,18916.5
20240701,경원선,회룡,14157,13829,27986,13993
20240701,경원선,망월사,7823,7991,15814,7907
20240701,경원선,도봉산,7856,5021,12877,6438.5
20240701,경원선,도봉,6374,6063,12437,6218.5
20240701,경원선,방학,10697,10320,21017,10508.5
20240701,경원선,창동,4,0,4,2
20240701,경원선,녹천,4940,4157,9097,4548.5
20240701,경원선,월계,7108,6698,13806,6903
20240701,경원선,광운대,8465,8105,16570,8285
20240701,경원선,석계,7649,8920,16569,8284.5
20240701,경원선,신이문,9217,8534,17751,8875.5
20240701,경원선,외대앞,9593,9448,19041,9520.5
20240701,경원선,청량리(서울시립대입구),16063,17275,33338,16669
20240701,경원선,왕십리(성동구청),17071,17112,34183,17091.5
20240701,경원선,응봉,2042,1777,3819,1909.5
20240701,경원선,옥수,49,33,82,41
20240701,경원선,한남,4215,4058,8273,4136.5
20240701,경원선,서빙고,2212,2031,4243,2121.5
20240701,경원선,이촌(국립중앙박물관),4258,3437,7695,3847.5
20240701,경부선,광명,4046,3426,7472,3736
20240701,경부선,서동탄,1659,1388,3047,1523.5
20240701,경부선,당정,6477,6147,12624,6312
20240701,경부선,천안,5878,6272,12150,6075
20240701,경부선,두정,6709,6845,13554,6777
20240701,경부선,직산,1087,1003,2090,1045
20240701,경부선,성환,4178,4287,8465,4232.5
20240701,경부선,평택,12845,12458,25303,12651.5
20240701,경부선,평택지제,4484,4324,8808,4404
20240701,경부선,서정리,8480,8088,16568,8284
20240701,경부선,송탄,4724,4589,9313,4656.5
20240701,경부선,진위,1933,1769,3702,1851
20240701,경부선,오산,10222,10436,20658,10329
20240701,경부선,오산대,3812,3592,7404,3702
20240701,경부선,세마,3507,3391,6898,3449
20240701,경부선,병점,15160,15062,30222,15111
20240701,경부선,세류,3535,3320,6855,3427.5
20240701,경부선,독산,19279,19985,39264,19632
20240701,경부선,수원,35926,37565,73491,36745.5
20240701,경부선,화서,12236,11676,23912,11956
20240701,경부선,성균관대,15881,15719,31600,15800
20240701,경부선,의왕,9530,9576,19106,9553
20240701,경부선,군포,7945,7882,15827,7913.5
20240701,경부선,금정,29544,29701,59245,29622.5
20240701,경부선,명학,9217,9137,18354,9177
20240701,경부선,안양,22155,21918,44073,22036.5
20240701,경부선,관악,7828,7448,15276,7638
20240701,경부선,석수,9048,8379,17427,8713.5
20240701,경부선,금천구청,11919,12189,24108,12054
20240701,경부선,가산디지털단지,19614,22504,42118,21059
20240701,경부선,구로,18771,18744,37515,18757.5
20240701,경부선,신길,9567,8054,17621,8810.5
20240701,경부선,신도림,4224,4341,8565,4282.5
20240701,경부선,영등포,39225,40004,79229,39614.5
20240701,경부선,대방,11416,12281,23697,11848.5
20240701,경부선,노량진,8115,7926,16041,8020.5
20240701,경부선,용산,38520,39800,78320,39160
20240701,경부선,남영,10593,11015,21608,10804
20240701,경부선,서울역,8814,3301,12115,6057.5
20240701,경강선,성남,988,871,1859,929.5
20240701,경강선,여주,2748,2636,5384,2692
20240701,경강선,세종대왕릉,365,330,695,347.5
20240701,경강선,부발,2358,2369,4727,2363.5
20240701,경강선,이천,3012,3063,6075,3037.5
20240701,경강선,신둔도예촌,1476,1425,2901,1450.5
20240701,경강선,곤지암,2316,2327,4643,2321.5
20240701,경강선,초월,3639,3528,7167,3583.5
20240701,경강선,경기광주,8434,8027,16461,8230.5
20240701,경강선,삼동,2730,2582,5312,2656
20240701,경강선,이매,1164,1088,2252,1126
20240701,경강선,판교,6056,6027,12083,6041.5
20240701,9호선2~3단계,중앙보훈병원,13472,12008,25480,12740
20240701,9호선2~3단계,둔촌오륜,1454,1385,2839,1419.5
20240701,9호선2~3단계,올림픽공원(한국체대),5874,6284,12158,6079
20240701,9호선2~3단계,한성백제,3345,2928,6273,3136.5
20240701,9호선2~3단계,송파나루,5952,6177,12129,6064.5
20240701,9호선2~3단계,석촌,10135,9118,19253,9626.5
20240701,9호선2~3단계,삼전,8693,8009,16702,8351
20240701,9호선2~3단계,종합운동장,5139,5118,10257,5128.5
20240701,9호선2~3단계,봉은사,21727,22510,44237,22118.5
20240701,9호선2~3단계,삼성중앙,8905,9268,18173,9086.5
20240701,9호선2~3단계,선정릉,11020,11833,22853,11426.5
20240701,9호선2~3단계,언주,12795,13386,26181,13090.5
20240701,9호선,신논현,32235,31985,64220,32110
20240701,9호선,사평,5018,4777,9795,4897.5
20240701,9호선,고속터미널,14404,18345,32749,16374.5
20240701,9호선,신반포,4689,4585,9274,4637
20240701,9호선,구반포,1479,1546,3025,1512.5
20240701,9호선,동작(현충원),2294,2814,5108,2554
20240701,9호선,흑석(중앙대입구),7362,7026,14388,7194
20240701,9호선,노들,5546,5050,10596,5298
20240701,9호선,노량진,26242,26253,52495,26247.5
20240701,9호선,샛강,7453,7471,14924,7462
20240701,9호선,여의도,34585,33720,68305,34152.5
20240701,9호선,국회의사당,18915,20084,38999,19499.5
20240701,9호선,당산,20663,20677,41340,20670
20240701,9호선,선유도,10086,9492,19578,9789
20240701,9호선,신목동,5357,4756,10113,5056.5
20240701,9호선,염창,19201,18666,37867,18933.5
20240701,9호선,등촌,13724,13141,26865,13432.5
20240701,9호선,증미,9330,9136,18466,9233
20240701,9호선,가양,24308,23955,48263,24131.5
20240701,9호선,양천향교,10910,10996,21906,10953
20240701,9호선,마곡나루(서울식물원),14738,14633,29371,14685.5
20240701,9호선,신방화,7842,7645,15487,7743.5
20240701,9호선,공항시장,3242,3504,6746,3373
20240701,9호선,김포공항,7039,10108,17147,8573.5
20240701,9호선,개화,3155,2105,5260,2630
20240701,8호선,남위례,8038,8054,16092,8046
20240701,8호선,모란,5091,3904,8995,4497.5
20240701,8호선,수진,6031,5544,11575,5787.5
20240701,8호선,신흥,5601,5822,11423,5711.5
20240701,8호선,단대오거리,12846,12556,25402,12701
20240701,8호선,남한산성입구(성남법원.검찰청),13946,12564,26510,13255
20240701,8호선,산성,7046,7206,14252,7126
20240701,8호선,복정,9842,8448,18290,9145
20240701,8호선,장지,18339,17011,35350,17675
20240701,8호선,문정,25006,26393,51399,25699.5
20240701,8호선,가락시장,8452,9355,17807,8903.5
20240701,8호선,송파,10344,10135,20479,10239.5
20240701,8호선,석촌,8582,9957,18539,9269.5
20240701,8호선,잠실(송파구청),16923,19339,36262,18131
20240701,8호선,몽촌토성(평화의문),7322,7310,14632,7316
20240701,8호선,강동구청,11441,11808,23249,11624.5
20240701,8호선,천호(풍납토성),15990,18171,34161,17080.5
20240701,8호선,암사,20563,18267,38830,19415
20240701,7호선,온수(성공회대입구),10649,9644,20293,10146.5
20240701,7호선,천왕,12870,12616,25486,12743
20240701,7호선,광명사거리,21360,20988,42348,21174
20240701,7호선,철산,23020,23358,46378,23189
20240701,7호선,가산디지털단지,51392,52007,103399,51699.5
20240701,7호선,남구로,16887,17389,34276,17138
20240701,7호선,대림(구로구청),9771,9718,19489,9744.5
20240701,7호선,신풍,12175,11464,23639,11819.5
20240701,7호선,보라매,7127,7433,14560,7280
20240701,7호선,신대방삼거리,15885,15508,31393,15696.5
20240701,7호선,장승배기,10276,10037,20313,10156.5
20240701,7호선,상도,12443,12143,24586,12293
20240701,7호선,숭실대입구(살피재),13398,13910,27308,13654
20240701,7호선,남성,12335,11934,24269,12134.5
20240701,7호선,이수,17091,16855,33946,16973
20240701,7호선,내방,16616,16634,33250,16625
20240701,7호선,고속터미널,17384,14515,31899,15949.5
20240701,7호선,반포,6966,6666,13632,6816
20240701,7호선,논현,20830,21143,41973,20986.5
20240701,7호선,학동,26679,27428,54107,27053.5
20240701,7호선,강남구청,17447,19198,36645,18322.5
20240701,7호선,청담,21387,22906,44293,22146.5
20240701,7호선,자양(뚝섬한강공원),10159,9775,19934,9967
20240701,7호선,건대입구,13794,14204,27998,13999
20240701,7호선,어린이대공원(세종대),14478,14277,28755,14377.5
20240701,7호선,군자(능동),16191,13136,29327,14663.5
20240701,7호선,중곡,12008,11232,23240,11620
20240701,7호선,용마산(용마폭포공원),6355,6225,12580,6290
20240701,7호선,사가정,17044,17294,34338,17169
20240701,7호선,면목,16006,15584,31590,15795
20240701,7호선,상봉,18123,17382,35505,17752.5
20240701,7호선,중화,11272,11123,22395,11197.5
20240701,7호선,먹골,10902,10902,21804,10902
20240701,7호선,태릉입구,9182,8660,17842,8921
20240701,7호선,공릉(서울과학기술대),13012,12845,25857,12928.5
20240701,7호선,하계,19420,18092,37512,18756
20240701,7호선,중계,16076,14811,30887,15443.5
20240701,7호선,노원,26223,27178,53401,26700.5
20240701,7호선,마들,14365,13602,27967,13983.5
20240701,7호선,수락산,13101,13120,26221,13110.5
20240701,7호선,도봉산,9518,10854,20372,10186
20240701,7호선,장암,2956,1098,4054,2027
20240701,6호선,신내,1,0,1,0.5
20240701,6호선,봉화산(서울의료원),9805,9140,18945,9472.5
20240701,6호선,화랑대(서울여대입구),12756,10056,22812,11406
20240701,6호선,태릉입구,5834,6511,12345,6172.5
20240701,6호선,석계,13279,13867,27146,13573
20240701,6호선,돌곶이,10856,10251,21107,10553.5
20240701,6호선,상월곡(한국과학기술연구원),6810,6128,12938,6469
20240701,6호선,월곡(동덕여대),12597,12585,25182,12591
20240701,6호선,고려대(종암),8976,8669,17645,8822.5
20240701,6호선,안암(고대병원앞),12375,12783,25158,12579
20240701,6호선,보문,8450,7967,16417,8208.5
20240701,6호선,창신,4000,3333,7333,3666.5
20240701,6호선,동묘앞,8791,9138,17929,8964.5
20240701,6호선,신당,8816,9560,18376,9188
20240701,6호선,청구,4264,4215,8479,4239.5
20240701,6호선,약수,4064,3945,8009,4004.5
20240701,6호선,버티고개,2324,2409,4733,2366.5
20240701,6호선,한강진,8599,10094,18693,9346.5
20240701,6호선,이태원,10719,10936,21655,10827.5
20240701,6호선,녹사평(용산구청),5265,5015,10280,5140
20240701,6호선,삼각지,7128,6234,13362,6681
20240701,6호선,효창공원앞,8027,7322,15349,7674.5
20240701,6호선,공덕,21275,20708,41983,20991.5
20240701,6호선,대흥(서강대앞),9985,10263,20248,10124
20240701,6호선,광흥창(서강),10451,9891,20342,10171
20240701,6호선,상수,9591,10478,20069,10034.5
20240701,6호선,합정,13255,12976,26231,13115.5
20240701,6호선,망원,15351,16431,31782,15891
20240701,6호선,마포구청,15669,14216,29885,14942.5
20240701,6호선,월드컵경기장(성산),4502,4587,9089,4544.5
20240701,6호선,디지털미디어시티,16084,17501,33585,16792.5
20240701,6호선,증산(명지대앞),10563,10618,21181,10590.5
20240701,6호선,새절(신사),13816,12705,26521,13260.5
20240701,6호선,구산,8980,6924,15904,7952
20240701,6호선,독바위,3169,3255,6424,3212
20240701,6호선,불광,4962,4917,9879,4939.5
20240701,6호선,역촌,4144,4645,8789,4394.5
20240701,6호선,응암,19017,18947,37964,18982
20240701,5호선,하남검단산,6928,6511,13439,6719.5
20240701,5호선,하남시청(덕풍·신장),8883,8574,17457,8728.5
20240701,5호선,하남풍산,4966,4858,9824,4912
20240701,5호선,미사,18798,19278,38076,19038
20240701,5호선,강일,6497,6065,12562,6281
20240701,5호선,마천,8448,7594,16042,8021
20240701,5호선,거여,11211,10974,22185,11092.5
20240701,5호선,개롱,7199,7473,14672,7336
20240701,5호선,오금,4254,4339,8593,4296.5
20240701,5호선,방이,7800,8053,15853,7926.5
20240701,5호선,올림픽공원(한국체대),6258,5055,11313,5656.5
20240701,5호선,둔촌동,9544,9494,19038,9519
20240701,5호선,상일동,16222,15238,31460,15730
20240701,5호선,고덕,12146,11758,23904,11952
20240701,5호선,명일,9574,10008,19582,9791
20240701,5호선,굽은다리(강동구민회관앞),10404,9920,20324,10162
20240701,5호선,길동,8954,9230,18184,9092
20240701,5호선,강동,19792,19304,39096,19548
20240701,5호선,천호(풍납토성),19880,19970,39850,19925
20240701,5호선,광나루(장신대),14563,13784,28347,14173.5
20240701,5호선,아차산(어린이대공원후문),15464,15131,30595,15297.5
20240701,5호선,군자(능동),11905,12953,24858,12429
20240701,5호선,장한평,20741,20667,41408,20704
20240701,5호선,답십리,17369,15843,33212,16606
20240701,5호선,마장,6378,5884,12262,6131
20240701,5호선,왕십리(성동구청),4945,5608,10553,5276.5
20240701,5호선,행당,8804,7905,16709,8354.5
20240701,5호선,신금호,7170,7610,14780,7390
20240701,5호선,청구,4378,4057,8435,4217.5
20240701,5호선,동대문역사문화공원(DDP),3488,3955,7443,3721.5
20240701,5호선,을지로4가,7337,7411,14748,7374
20240701,5호선,종로3가,14690,15315,30005,15002.5
20240701,5호선,광화문(세종문화회관),35350,36878,72228,36114
20240701,5호선,서대문,23160,23292,46452,23226
20240701,5호선,충정로(경기대입구),5195,5368,10563,5281.5
20240701,5호선,애오개,7757,7828,15585,7792.5
20240701,5호선,공덕,16265,17609,33874,16937
20240701,5호선,마포,17001,16900,33901,16950.5
20240701,5호선,여의나루,16013,16237,32250,16125
20240701,5호선,여의도,34410,35017,69427,34713.5
20240701,5호선,신길,5306,5558,10864,5432
20240701,5호선,영등포시장,12089,12315,24404,12202
20240701,5호선,영등포구청,5375,5327,10702,5351
20240701,5호선,양평,8626,8489,17115,8557.5
20240701,5호선,오목교(목동운동장앞),21979,23622,45601,22800.5
20240701,5호선,목동,17750,19412,37162,18581
20240701,5호선,신정(은행정),14589,12176,26765,13382.5
20240701,5호선,까치산,29768,29067,58835,29417.5
20240701,5호선,화곡,30736,28926,59662,29831
20240701,5호선,우장산,16105,15901,32006,16003
20240701,5호선,발산,24408,25074,49482,24741
20240701,5호선,마곡,13825,13811,27636,13818
20240701,5호선,송정,6945,6630,13575,6787.5
20240701,5호선,김포공항,11297,8114,19411,9705.5
20240701,5호선,개화산,6606,6381,12987,6493.5
20240701,5호선,방화,7863,7508,15371,7685.5
20240701,4호선,남태령,1307,1116,2423,1211.5
20240701,4호선,사당,25725,22524,48249,24124.5
20240701,4호선,총신대입구(이수),20903,22337,43240,21620
20240701,4호선,동작(현충원),1671,1915,3586,1793
20240701,4호선,이촌(국립중앙박물관),8507,9544,18051,9025.5
20240701,4호선,신용산,20804,21919,42723,21361.5
20240701,4호선,삼각지,6144,6767,12911,6455.5
20240701,4호선,숙대입구(갈월),15101,14611,29712,14856
20240701,4호선,서울역,13715,21364,35079,17539.5
20240701,4호선,회현(남대문시장),27977,29414,57391,28695.5
20240701,4호선,명동,33431,35193,68624,34312
20240701,4호선,충무로,32289,32994,65283,32641.5
20240701,4호선,동대문역사문화공원(DDP),19495,17356,36851,18425.5
20240701,4호선,동대문,22461,22714,45175,22587.5
20240701,4호선,혜화,31213,31262,62475,31237.5
20240701,4호선,한성대입구(삼선교),14145,13745,27890,13945
20240701,4호선,성신여대입구(돈암),22162,21452,43614,21807
20240701,4호선,미아사거리,28847,28021,56868,28434
20240701,4호선,미아(서울사이버대학),16455,16031,32486,16243
20240701,4호선,수유(강북구청),35817,35948,71765,35882.5
20240701,4호선,쌍문,31519,29147,60666,30333
20240701,4호선,창동,27657,29065,56722,28361
20240701,4호선,노원,30175,33598,63773,31886.5
20240701,4호선,상계,20974,19654,40628,20314
20240701,4호선,당고개,10388,8773,19161,9580.5
20240701,3호선,오금,7163,6328,13491,6745.5
20240701,3호선,경찰병원,8524,8706,17230,8615
20240701,3호선,가락시장,9865,9521,19386,9693
20240701,3호선,수서,19217,19516,38733,19366.5
20240701,3호선,일원,12239,11932,24171,12085.5
20240701,3호선,대청,12170,11425,23595,11797.5
20240701,3호선,학여울,2284,2253,4537,2268.5
20240701,3호선,대치,12680,12747,25427,12713.5
20240701,3호선,도곡,6594,6616,13210,6605
20240701,3호선,매봉,14354,13696,28050,14025
20240701,3호선,양재(서초구청),40184,43672,83856,41928
20240701,3호선,남부터미널(예술의전당),31194,31691,62885,31442.5
20240701,3호선,교대(법원.검찰청),18139,11099,29238,14619
20240701,3호선,고속터미널,39774,36774,76548,38274
20240701,3호선,잠원,5558,5300,10858,5429
20240701,3호선,신사,29427,30566,59993,29996.5
20240701,3호선,압구정,34292,36350,70642,35321
20240701,3호선,옥수,9377,9707,19084,9542
20240701,3호선,금호,8558,8041,16599,8299.5
20240701,3호선,약수,13816,13789,27605,13802.5
20240701,수인선,호구포,4241,4367,8608,4304
20240701,3호선,동대입구,9335,10098,19433,9716.5
20240701,3호선,충무로,6,0,6,3
20240701,3호선,을지로3가,12682,12517,25199,12599.5
20240701,3호선,종로3가,12056,13028,25084,12542
20240701,3호선,안국,27786,28258,56044,28022
20240701,3호선,경복궁(정부서울청사),24658,24596,49254,24627
20240701,3호선,독립문,7890,7894,15784,7892
20240701,3호선,무악재,4951,4764,9715,4857.5
20240701,3호선,홍제,19130,18253,37383,18691.5
20240701,3호선,녹번,16486,15364,31850,15925
20240701,3호선,불광,17864,19129,36993,18496.5
20240701,3호선,연신내,36454,34724,71178,35589
20240701,3호선,구파발,23356,22437,45793,22896.5
20240701,3호선,지축,8210,8281,16491,8245.5
20240701,2호선,용두(동대문구청),2679,2823,5502,2751
20240701,2호선,신정네거리,10894,11306,22200,11100
20240701,2호선,양천구청,7385,7731,15116,7558
20240701,2호선,도림천,1514,1640,3154,1577
20240701,2호선,신설동,3585,3448,7033,3516.5
20240701,2호선,신답,1877,2114,3991,1995.5
20240701,2호선,용답,3095,3076,6171,3085.5
20240701,2호선,충정로(경기대입구),11427,11993,23420,11710
20240701,2호선,아현,11789,10860,22649,11324.5
20240701,2호선,이대,16866,18864,35730,17865
20240701,2호선,신촌,38320,38797,77117,38558.5
20240701,2호선,홍대입구,68513,72441,140954,70477
20240701,2호선,합정,31876,33826,65702,32851
20240701,2호선,당산,19116,22661,41777,20888.5
20240701,2호선,영등포구청,24618,25392,50010,25005
20240701,2호선,문래,25593,26195,51788,25894
20240701,2호선,신도림,52030,50407,102437,51218.5
20240701,2호선,대림(구로구청),26349,26813,53162,26581
20240701,2호선,구로디지털단지,62554,62131,124685,62342.5
20240701,2호선,신대방,26718,25946,52664,26332
20240701,2호선,신림,57327,55411,112738,56369
20240701,2호선,봉천,26453,25095,51548,25774
20240701,2호선,서울대입구(관악구청),49359,48579,97938,48969
20240701,2호선,낙성대(강감찬),29414,28970,58384,29192
20240701,2호선,사당,39975,41536,81511,40755.5
20240701,2호선,방배,17238,17798,35036,17518
20240701,2호선,서초,23998,23682,47680,23840
20240701,2호선,교대(법원.검찰청),34405,40750,75155,37577.5
20240701,2호선,강남,86648,84979,171627,85813.5
20240701,2호선,역삼,58652,67029,125681,62840.5
20240701,2호선,선릉,65979,58231,124210,62105
20240701,2호선,삼성(무역센터),57969,59341,117310,58655
20240701,2호선,종합운동장,8393,9059,17452,8726
20240701,2호선,잠실새내,25148,24398,49546,24773
20240701,2호선,잠실(송파구청),78515,78503,157018,78509
20240701,2호선,잠실나루,17150,16607,33757,16878.5
20240701,2호선,강변(동서울터미널),31249,28846,60095,30047.5
20240701,2호선,구의(광진구청),26628,26269,52897,26448.5
20240701,2호선,건대입구,35948,37728,73676,36838
20240701,2호선,성수,44577,48653,93230,46615
20240701,2호선,뚝섬,25563,27051,52614,26307
20240701,2호선,한양대,10992,11890,22882,11441
20240701,2호선,왕십리(성동구청),16044,14530,30574,15287
20240701,2호선,상왕십리,15736,15624,31360,15680
20240701,2호선,신당,15440,15981,31421,15710.5
20240701,2호선,동대문역사문화공원(DDP),14628,16756,31384,15692
20240701,2호선,을지로4가,15868,15485,31353,15676.5
20240701,2호선,을지로3가,27086,26914,54000,27000
20240701,2호선,을지로입구,53917,55357,109274,54637
20240701,2호선,시청,29542,28262,57804,28902
20240701,1호선,동묘앞,9171,9320,18491,9245.5
20240701,1호선,청량리(서울시립대입구),23940,23062,47002,23501
20240701,1호선,제기동,17951,18156,36107,18053.5
20240701,1호선,신설동,15557,15072,30629,15314.5
20240701,1호선,동대문,12074,11684,23758,11879
20240701,1호선,종로5가,25143,24698,49841,24920.5
20240701,1호선,종로3가,25248,22927,48175,24087.5
20240701,1호선,종각,42386,42377,84763,42381.5
20240701,1호선,시청,27392,27297,54689,27344.5
20240701,1호선,서울역,55778,52158,107936,53968
20240702,중앙선,지평,41,51,92,46
20240702,경의선,검암,1,0,1,0.5
20240702,중앙선,양평,2804,2732,5536,2768
20240702,중앙선,오빈,274,282,556,278
20240702,중앙선,아신,485,458,943,471.5
20240702,중앙선,국수,643,607,1250,625
20240702,중앙선,신원,150,127,277,138.5
20240702,중앙선,양수,1597,1643,3240,1620
20240702,중앙선,운길산,486,470,956,478
20240702,중앙선,팔당,655,663,1318,659
20240702,중앙선,도심,2443,1934,4377,2188.5
20240702,중앙선,덕소,5327,5164,10491,5245.5
20240702,중앙선,양정,528,427,955,477.5
20240702,중앙선,도농,11337,10343,21680,10840
20240702,중앙선,구리,12780,12967,25747,12873.5
20240702,중앙선,양원,3269,3249,6518,3259
20240702,중앙선,망우,7291,6783,14074,7037
20240702,중앙선,상봉,5701,5695,11396,5698
20240702,중앙선,중랑,5425,5241,10666,5333
20240702,중앙선,회기,24356,23565,47921,23960.5
20240702,장항선,신창(순천향대),1080,1130,2210,1105
20240702,장항선,온양온천,3543,3588,7131,3565.5
20240702,장항선,배방,1110,1156,2266,1133
20240702,장항선,탕정,1541,1394,2935,1467.5
20240702,장항선,아산,3155,2863,6018,3009
20240702,장항선,쌍용(나사렛대),2219,2118,4337,2168.5
20240702,장항선,봉명,1438,1465,2903,1451.5
20240702,일산선,대화,14788,11287,26075,13037.5
20240702,일산선,주엽,9931,10122,20053,10026.5
20240702,일산선,정발산,6506,6716,13222,6611
20240702,일산선,마두,7977,8130,16107,8053.5
20240702,일산선,백석,9875,10008,19883,9941.5
20240702,일산선,대곡,3052,2317,5369,2684.5
20240702,일산선,화정,16477,17016,33493,16746.5
20240702,일산선,원당,10822,10278,21100,10550
20240702,일산선,삼송,19319,18615,37934,18967
20240702,일산선,지축,1,0,1,0.5
20240702,일산선,원흥,11513,11005,22518,11259
20240702,우이신설선,신설동,2369,2183,4552,2276
20240702,우이신설선,보문,1661,1611,3272,1636
20240702,우이신설선,성신여대입구(돈암),3519,3823,7342,3671
20240702,우이신설선,정릉,4465,4398,8863,4431.5
20240702,우이신설선,북한산보국문,5936,5911,11847,5923.5
20240702,우이신설선,솔샘,6037,5869,11906,5953
20240702,우이신설선,삼양사거리,2499,2577,5076,2538
20240702,우이신설선,삼양,1968,2120,4088,2044
20240702,우이신설선,화계,3446,3353,6799,3399.5
20240702,우이신설선,가오리,4376,4546,8922,4461
20240702,우이신설선,4.19민주묘지,2750,2693,5443,2721.5
20240702,우이신설선,솔밭공원,2565,2426,4991,2495.5
20240702,우이신설선,북한산우이,2551,2189,4740,2370
20240702,안산선,수리산,4105,3448,7553,3776.5
20240702,안산선,오이도,7457,7085,14542,7271
20240702,안산선,정왕,8091,8407,16498,8249
20240702,안산선,신길온천,1884,1684,3568,1784
20240702,안산선,안산,11451,10311,21762,10881
20240702,안산선,초지,4875,4800,9675,4837.5
20240702,안산선,고잔,8640,8262,16902,8451
20240702,안산선,중앙,17036,17584,34620,17310
20240702,안산선,한대앞,8751,8872,17623,8811.5
20240702,안산선,상록수,14273,14608,28881,14440.5
20240702,안산선,반월,4245,4175,8420,4210
20240702,안산선,대야미,4830,4420,9250,4625
20240702,안산선,산본,15702,16649,32351,16175.5
20240702,신림선,관악산(서울대),2471,2421,4892,2446
20240702,신림선,서울대벤처타운,9410,8961,18371,9185.5
20240702,신림선,서원,3739,3370,7109,3554.5
20240702,신림선,신림,1905,2531,4436,2218
20240702,신림선,당곡,5022,5031,10053,5026.5
20240702,신림선,보라매병원,8850,9197,18047,9023.5
20240702,신림선,보라매공원,2363,2503,4866,2433
20240702,신림선,보라매,4566,4098,8664,4332
20240702,신림선,서울지방병무청,3391,3671,7062,3531
20240702,신림선,대방,2931,2408,5339,2669.5
20240702,신림선,샛강,3287,3730,7017,3508.5
20240702,수인선,인천,863,1362,2225,1112.5
20240702,수인선,신포,1702,1746,3448,1724
20240702,수인선,숭의,3978,3723,7701,3850.5
20240702,수인선,인하대,6194,5923,12117,6058.5
20240702,수인선,송도,2244,2013,4257,2128.5
20240702,수인선,연수,4430,4347,8777,4388.5
20240702,수인선,원인재,4136,4235,8371,4185.5
20240702,수인선,남동인더스파크,2495,2775,5270,2635
20240702,수인선,호구포,3980,4186,8166,4083
20240702,수인선,인천논현,5213,5527,10740,5370
20240702,수인선,소래포구,4141,3872,8013,4006.5
20240702,수인선,월곶,2667,2467,5134,2567
20240702,수인선,달월,124,60,184,92
20240702,수인선,사리,4889,4361,9250,4625
20240702,수인선,야목,414,358,772,386
20240702,수인선,어천,1173,1225,2398,1199
20240702,수인선,오목천,3825,3427,7252,3626
20240702,수인선,고색,5644,5120,10764,5382
20240702,서해선,부천종합운동장,2631,2206,4837,2418.5
20240702,서해선,원종,4575,4655,9230,4615
20240702,서해선,김포공항,2791,3676,6467,3233.5
20240702,분당선,매교,5458,5407,10865,5432.5
20240702,분당선,수원시청,13439,14362,27801,13900.5
20240702,분당선,매탄권선,5627,5650,11277,5638.5
20240702,분당선,망포,16031,15365,31396,15698
20240702,분당선,영통,8595,8825,17420,8710
20240702,분당선,청명,4685,4526,9211,4605.5
20240702,분당선,상갈,5388,5038,10426,5213
20240702,분당선,기흥,10323,9341,19664,9832
20240702,분당선,신갈,4771,4642,9413,4706.5
20240702,분당선,구성,6402,6549,12951,6475.5
20240702,분당선,죽전,12550,13729,26279,13139.5
20240702,분당선,보정,2750,2477,5227,2613.5
20240702,분당선,이매,5923,5497,11420,5710
20240702,분당선,오리,11842,10145,21987,10993.5
20240702,분당선,미금,15323,15962,31285,15642.5
20240702,분당선,정자,19412,20369,39781,19890.5
20240702,분당선,수내,14625,15004,29629,14814.5
20240702,분당선,서현,24011,24595,48606,24303
20240702,분당선,야탑,25369,26929,52298,26149
20240702,분당선,모란,18748,18694,37442,18721
20240702,분당선,태평,13122,12480,25602,12801
20240702,분당선,가천대,7972,8482,16454,8227
20240702,분당선,선정릉,8580,8923,17503,8751.5
20240702,분당선,강남구청,10514,12116,22630,11315
20240702,분당선,압구정로데오,18853,20655,39508,19754
20240702,분당선,서울숲,12014,12238,24252,12126
20240702,분당선,수원,7430,6685,14115,7057.5
20240702,분당선,수서,16833,17540,34373,17186.5
20240702,분당선,대모산입구,6546,6231,12777,6388.5
20240702,분당선,개포동,4724,4802,9526,4763
20240702,분당선,구룡,3931,3962,7893,3946.5
20240702,분당선,도곡,8162,8203,16365,8182.5
20240702,분당선,한티,16266,17568,33834,16917
20240702,분당선,선릉,15233,23100,38333,19166.5
20240702,과천선,범계,26481,26514,52995,26497.5
20240702,과천선,평촌,18670,18411,37081,18540.5
20240702,과천선,인덕원,25969,26955,52924,26462
20240702,과천선,정부과천청사,13029,13486,26515,13257.5
20240702,과천선,과천,6700,6219,12919,6459.5
20240702,과천선,대공원,2353,2423,4776,2388
20240702,과천선,경마공원,1169,1178,2347,1173.5
20240702,과천선,선바위,7824,6890,14714,7357
20240702,공항철도 1호선,영종,3997,4005,8002,4001
20240702,공항철도 1호선,인천공항2터미널,6570,5731,12301,6150.5
20240702,공항철도 1호선,인천공항1터미널,13723,14064,27787,13893.5
20240702,공항철도 1호선,공항화물청사,2201,2407,4608,2304
20240702,공항철도 1호선,운서,8741,9028,17769,8884.5
20240702,공항철도 1호선,청라국제도시,7641,7229,14870,7435
20240702,공항철도 1호선,검암,6434,6642,13076,6538
20240702,공항철도 1호선,계양,13452,12824,26276,13138
20240702,공항철도 1호선,김포공항,9293,5842,15135,7567.5
20240702,공항철도 1호선,마곡나루(서울식물원),13366,12441,25807,12903.5
20240702,공항철도 1호선,디지털미디어시티,15975,15014,30989,15494.5
20240702,공항철도 1호선,홍대입구,11923,11774,23697,11848.5
20240702,공항철도 1호선,공덕,3109,3942,7051,3525.5
20240702,공항철도 1호선,서울역,11384,10488,21872,10936
20240702,경춘선,춘천,973,830,1803,901.5
20240702,경춘선,남춘천,2160,2214,4374,2187
20240702,경춘선,김유정,274,290,564,282
20240702,경춘선,강촌,412,296,708,354
20240702,경춘선,백양리,61,44,105,52.5
20240702,경춘선,굴봉산,94,79,173,86.5
20240702,경춘선,가평,1877,1864,3741,1870.5
20240702,경춘선,상천,240,208,448,224
20240702,경춘선,청평,1620,1572,3192,1596
20240702,경춘선,대성리,1111,837,1948,974
20240702,경춘선,마석,3510,3408,6918,3459
20240702,경춘선,천마산,1387,1298,2685,1342.5
20240702,경춘선,평내호평,5929,5712,11641,5820.5
20240702,경춘선,금곡,1371,1404,2775,1387.5
20240702,경춘선,사릉,2013,1963,3976,1988
20240702,경춘선,퇴계원,3575,3253,6828,3414
20240702,경춘선,별내,3451,3254,6705,3352.5
20240702,경춘선,갈매,3075,2669,5744,2872
20240702,경춘선,신내,2846,2587,5433,2716.5
20240702,경인선,도화,4036,3777,7813,3906.5
20240702,경인선,중동,9012,8475,17487,8743.5
20240702,경인선,온수(성공회대입구),6263,5965,12228,6114
20240702,경인선,도원,3346,3406,6752,3376
20240702,경인선,간석,5763,5528,11291,5645.5
20240702,경인선,부개,8640,8108,16748,8374
20240702,경인선,소사,7139,6934,14073,7036.5
20240702,경인선,구일,10630,11326,21956,10978
20240702,경인선,인천,2912,2116,5028,2514
20240702,경인선,동인천,12837,11937,24774,12387
20240702,경인선,제물포,10151,9890,20041,10020.5
20240702,경인선,주안,17305,15795,33100,16550
20240702,경인선,동암,14696,14742,29438,14719
20240702,경인선,백운,7247,7097,14344,7172
20240702,경인선,부평,26143,27138,53281,26640.5
20240702,경인선,송내,26279,26228,52507,26253.5
20240702,경인선,부천,28240,28135,56375,28187.5
20240702,경인선,역곡,25171,25278,50449,25224.5
20240702,경인선,오류동,11458,10840,22298,11149
20240702,경인선,개봉,21193,21218,42411,21205.5
20240702,경의선,운천,3,1,4,2
20240702,경의선,임진강,8,4,12,6
20240702,경의선,문산,5051,4768,9819,4909.5
20240702,경의선,파주,1156,793,1949,974.5
20240702,경의선,월롱,1974,1806,3780,1890
20240702,경의선,금촌,6119,6004,12123,6061.5
20240702,경의선,금릉,5313,5134,10447,5223.5
20240702,경의선,운정,7989,7460,15449,7724.5
20240702,경의선,야당,8678,8471,17149,8574.5
20240702,경의선,탄현,7961,7794,15755,7877.5
20240702,경의선,일산,10957,10854,21811,10905.5
20240702,경의선,풍산,6025,5664,11689,5844.5
20240702,경의선,백마,7602,7428,15030,7515
20240702,경의선,곡산,697,726,1423,711.5
20240702,경의선,능곡,4841,4535,9376,4688
20240702,경의선,행신,8093,7950,16043,8021.5
20240702,경의선,강매,3445,2902,6347,3173.5
20240702,경의선,한국항공대,1995,1899,3894,1947
20240702,경의선,수색,3761,3890,7651,3825.5
20240702,경의선,디지털미디어시티,2857,2586,5443,2721.5
20240702,경의선,가좌,6109,5810,11919,5959.5
20240702,경의선,홍대입구,1825,2060,3885,1942.5
20240702,경의선,서강대,2223,2206,4429,2214.5
20240702,경의선,공덕,4464,3612,8076,4038
20240702,경의선,효창공원앞,3384,3884,7268,3634
20240702,경의선,신촌,1153,1341,2494,1247
20240702,경의선,서울역,4922,6130,11052,5526
20240702,경원선,연천,873,791,1664,832
20240702,경원선,전곡,874,817,1691,845.5
20240702,경원선,청산,138,108,246,123
20240702,경원선,소요산,1048,973,2021,1010.5
20240702,경원선,동두천,1674,1614,3288,1644
20240702,경원선,보산,1407,1338,2745,1372.5
20240702,경원선,동두천중앙,2866,2810,5676,2838
20240702,경원선,지행,6118,6085,12203,6101.5
20240702,경원선,덕정,5827,5560,11387,5693.5
20240702,경원선,덕계,5909,5367,11276,5638
20240702,경원선,양주,6748,6426,13174,6587
20240702,경원선,녹양,4190,3836,8026,4013
20240702,경원선,가능,6351,6240,12591,6295.5
20240702,경원선,의정부,17158,17305,34463,17231.5
20240702,경원선,회룡,12758,12496,25254,12627
20240702,경원선,망월사,7154,7274,14428,7214
20240702,경원선,도봉산,6023,3686,9709,4854.5
20240702,경원선,도봉,5888,5614,11502,5751
20240702,경원선,방학,9701,9543,19244,9622
20240702,경원선,창동,2,0,2,1
20240702,경원선,녹천,4603,3882,8485,4242.5
20240702,경원선,월계,6545,6136,12681,6340.5
20240702,경원선,광운대,7831,7277,15108,7554
20240702,경원선,석계,6921,8051,14972,7486
20240702,경원선,신이문,8598,8054,16652,8326
20240702,경원선,외대앞,8764,8611,17375,8687.5
20240702,경원선,청량리(서울시립대입구),14002,14997,28999,14499.5
20240702,경원선,왕십리(성동구청),15983,16112,32095,16047.5
20240702,경원선,응봉,1855,1564,3419,1709.5
20240702,경원선,옥수,42,35,77,38.5
20240702,경원선,한남,3846,3683,7529,3764.5
20240702,경원선,서빙고,2132,2005,4137,2068.5
20240702,경원선,이촌(국립중앙박물관),4070,3129,7199,3599.5
20240702,경부선,광명,3428,3073,6501,3250.5
20240702,경부선,서동탄,1518,1286,2804,1402
20240702,경부선,당정,6062,5754,11816,5908
20240702,경부선,천안,4868,4969,9837,4918.5
20240702,경부선,두정,5880,5890,11770,5885
20240702,경부선,직산,957,942,1899,949.5
20240702,경부선,성환,3657,3579,7236,3618
20240702,경부선,평택,10622,10515,21137,10568.5
20240702,경부선,평택지제,3942,3892,7834,3917
20240702,경부선,서정리,7436,7020,14456,7228
20240702,경부선,송탄,3987,3857,7844,3922
20240702,경부선,진위,1805,1673,3478,1739
20240702,경부선,오산,8992,9072,18064,9032
20240702,경부선,오산대,3358,3061,6419,3209.5
20240702,경부선,세마,3264,3164,6428,3214
20240702,경부선,병점,13631,13503,27134,13567
20240702,경부선,세류,3185,2844,6029,3014.5
20240702,경부선,독산,18728,19427,38155,19077.5
20240702,경부선,수원,31409,32658,64067,32033.5
20240702,경부선,화서,10881,10550,21431,10715.5
20240702,경부선,성균관대,14685,14423,29108,14554
20240702,경부선,의왕,9105,9179,18284,9142
20240702,경부선,군포,7412,7448,14860,7430
20240702,경부선,금정,27898,28155,56053,28026.5
20240702,경부선,명학,8993,8965,17958,8979
20240702,경부선,안양,19913,19783,39696,19848
20240702,경부선,관악,7207,6953,14160,7080
20240702,경부선,석수,8580,7901,16481,8240.5
20240702,경부선,금천구청,11161,11447,22608,11304
20240702,경부선,가산디지털단지,18886,21824,40710,20355
20240702,경부선,구로,17545,17602,35147,17573.5
20240702,경부선,신길,8975,7414,16389,8194.5
20240702,경부선,신도림,3642,3922,7564,3782
20240702,경부선,영등포,37021,37963,74984,37492
20240702,경부선,대방,10742,11714,22456,11228
20240702,경부선,노량진,6852,7308,14160,7080
20240702,경부선,용산,35744,36614,72358,36179
20240702,경부선,남영,10078,10455,20533,10266.5
20240702,경부선,서울역,7538,2868,10406,5203
20240702,경강선,성남,924,875,1799,899.5
20240702,경강선,여주,2393,2321,4714,2357
20240702,경강선,세종대왕릉,289,287,576,288
20240702,경강선,부발,2094,2028,4122,2061
20240702,경강선,이천,2609,2791,5400,2700
20240702,경강선,신둔도예촌,1389,1312,2701,1350.5
20240702,경강선,곤지암,2017,1962,3979,1989.5
20240702,경강선,초월,3415,3285,6700,3350
20240702,경강선,경기광주,7988,7671,15659,7829.5
20240702,경강선,삼동,2722,2441,5163,2581.5
20240702,경강선,이매,1100,1010,2110,1055
20240702,경강선,판교,6052,5975,12027,6013.5
20240702,9호선2~3단계,중앙보훈병원,13417,11787,25204,12602
20240702,9호선2~3단계,둔촌오륜,1590,1414,3004,1502
20240702,9호선2~3단계,올림픽공원(한국체대),5343,5657,11000,5500
20240702,9호선2~3단계,한성백제,3242,2925,6167,3083.5
20240702,9호선2~3단계,송파나루,5737,6113,11850,5925
20240702,9호선2~3단계,석촌,9820,8663,18483,9241.5
20240702,9호선2~3단계,석촌고분,7638,7551,15189,7594.5
20240702,9호선2~3단계,삼전,8634,8254,16888,8444
20240702,9호선2~3단계,종합운동장,5195,5061,10256,5128
20240702,9호선2~3단계,봉은사,22251,23100,45351,22675.5
20240702,9호선2~3단계,삼성중앙,9101,9500,18601,9300.5
20240702,9호선2~3단계,선정릉,11010,11706,22716,11358
20240702,9호선2~3단계,언주,13189,13471,26660,13330
20240702,9호선,신논현,30821,30755,61576,30788
20240702,9호선,사평,4763,4559,9322,4661
20240702,9호선,고속터미널,13333,17920,31253,15626.5
20240702,9호선,신반포,4512,4215,8727,4363.5
20240702,9호선,구반포,1338,1311,2649,1324.5
20240702,9호선,동작(현충원),1734,1504,3238,1619
20240702,9호선,흑석(중앙대입구),8696,9090,17786,8893
20240702,9호선,노들,4896,4060,8956,4478
20240702,9호선,노량진,24996,24013,49009,24504.5
20240702,9호선,샛강,7111,7183,14294,7147
20240702,9호선,여의도,34677,33017,67694,33847
20240702,9호선,국회의사당,19934,20541,40475,20237.5
20240702,9호선,당산,20343,20071,40414,20207
20240702,9호선,선유도,9703,9275,18978,9489
20240702,9호선,신목동,4765,4308,9073,4536.5
20240702,9호선,염창,18396,17684,36080,18040
20240702,9호선,등촌,13001,12530,25531,12765.5
20240702,9호선,증미,9237,8990,18227,9113.5
20240702,9호선,가양,22738,22377,45115,22557.5
20240702,9호선,양천향교,10801,11097,21898,10949
20240702,9호선,마곡나루(서울식물원),14575,14370,28945,14472.5
20240702,9호선,신방화,7595,7642,15237,7618.5
20240702,9호선,공항시장,3163,3427,6590,3295
20240702,9호선,김포공항,6675,9526,16201,8100.5
20240702,9호선,개화,3077,2002,5079,2539.5
20240702,8호선,남위례,7749,7735,15484,7742
20240702,8호선,모란,4767,3564,8331,4165.5
20240702,8호선,수진,5425,5000,10425,5212.5
20240702,8호선,신흥,5158,5378,10536,5268
20240702,8호선,단대오거리,11959,11978,23937,11968.5
20240702,8호선,남한산성입구(성남법원.검찰청),13330,11933,25263,12631.5
20240702,8호선,산성,6658,6749,13407,6703.5
20240702,8호선,복정,9768,8473,18241,9120.5
20240702,8호선,장지,17957,16691,34648,17324
20240702,8호선,문정,24997,26279,51276,25638
20240702,8호선,가락시장,7934,8968,16902,8451
20240702,8호선,송파,10812,10519,21331,10665.5
20240702,8호선,석촌,8351,9443,17794,8897
20240702,8호선,잠실(송파구청),16715,19281,35996,17998
20240702,8호선,몽촌토성(평화의문),7047,7065,14112,7056
20240702,8호선,강동구청,11241,11697,22938,11469
20240702,8호선,천호(풍납토성),15278,17236,32514,16257
20240702,8호선,암사,19784,17566,37350,18675
20240702,7호선,온수(성공회대입구),10249,9028,19277,9638.5
20240702,7호선,천왕,12321,11987,24308,12154
20240702,7호선,광명사거리,19456,19174,38630,19315
20240702,7호선,철산,21744,22269,44013,22006.5
20240702,7호선,가산디지털단지,50958,51148,102106,51053
20240702,7호선,남구로,16070,16897,32967,16483.5
20240702,7호선,대림(구로구청),8762,9003,17765,8882.5
20240702,7호선,신풍,11867,11065,22932,11466
20240702,7호선,보라매,6763,7116,13879,6939.5
20240702,7호선,신대방삼거리,15393,14719,30112,15056
20240702,7호선,장승배기,9669,9540,19209,9604.5
20240702,7호선,상도,11766,11601,23367,11683.5
20240702,7호선,숭실대입구(살피재),12820,12880,25700,12850
20240702,7호선,남성,11924,11354,23278,11639
20240702,7호선,이수,16741,16122,32863,16431.5
20240702,7호선,내방,15802,15961,31763,15881.5
20240702,7호선,고속터미널,15818,14198,30016,15008
20240702,7호선,반포,6407,6238,12645,6322.5
20240702,7호선,논현,20232,20406,40638,20319
20240702,7호선,학동,26302,27528,53830,26915
20240702,7호선,강남구청,17676,19277,36953,18476.5
20240702,7호선,청담,20708,22633,43341,21670.5
20240702,7호선,자양(뚝섬한강공원),7651,7537,15188,7594
20240702,7호선,건대입구,13542,13632,27174,13587
20240702,7호선,어린이대공원(세종대),13871,13802,27673,13836.5
20240702,7호선,군자(능동),15636,12519,28155,14077.5
20240702,7호선,중곡,11618,10870,22488,11244
20240702,7호선,용마산(용마폭포공원),6025,5797,11822,5911
20240702,7호선,사가정,16126,16531,32657,16328.5
20240702,7호선,면목,14945,14728,29673,14836.5
20240702,7호선,상봉,17050,16273,33323,16661.5
20240702,7호선,중화,10942,10805,21747,10873.5
20240702,7호선,먹골,10533,10478,21011,10505.5
20240702,7호선,태릉입구,8586,8056,16642,8321
20240702,7호선,공릉(서울과학기술대),12082,12074,24156,12078
20240702,7호선,하계,18370,17469,35839,17919.5
20240702,7호선,중계,15227,14201,29428,14714
20240702,7호선,노원,24187,24819,49006,24503
20240702,7호선,마들,13452,12867,26319,13159.5
20240702,7호선,수락산,12109,12000,24109,12054.5
20240702,7호선,도봉산,8748,9808,18556,9278
20240702,7호선,장암,2725,1025,3750,1875
20240702,6호선,신내,1,0,1,0.5
20240702,6호선,봉화산(서울의료원),9392,8824,18216,9108
20240702,6호선,화랑대(서울여대입구),12384,9567,21951,10975.5
20240702,6호선,태릉입구,5414,5969,11383,5691.5
20240702,6호선,석계,12998,13322,26320,13160
20240702,6호선,돌곶이,10401,9668,20069,10034.5
20240702,6호선,상월곡(한국과학기술연구원),6606,5959,12565,6282.5
20240702,6호선,월곡(동덕여대),11938,11871,23809,11904.5
20240702,6호선,고려대(종암),8565,8105,16670,8335
20240702,6호선,안암(고대병원앞),11514,11898,23412,11706
20240702,6호선,보문,8226,7618,15844,7922
20240702,6호선,창신,3910,3225,7135,3567.5
20240702,6호선,동묘앞,7507,7856,15363,7681.5
20240702,6호선,신당,8831,9388,18219,9109.5
20240702,6호선,청구,4130,4102,8232,4116
20240702,6호선,약수,3850,3693,7543,3771.5
20240702,6호선,버티고개,2236,2287,4523,2261.5
20240702,6호선,한강진,9012,10174,19186,9593
20240702,6호선,이태원,9388,9934,19322,9661
20240702,6호선,녹사평(용산구청),4619,4528,9147,4573.5
20240702,6호선,삼각지,7901,6894,14795,7397.5
20240702,6호선,효창공원앞,7663,6948,14611,7305.5
20240702,6호선,공덕,20344,19825,40169,20084.5
20240702,6호선,대흥(서강대앞),9676,10138,19814,9907
20240702,6호선,광흥창(서강),10107,9754,19861,9930.5
20240702,6호선,상수,9198,10070,19268,9634
20240702,6호선,합정,12792,12559,25351,12675.5
20240702,6호선,망원,13936,14845,28781,14390.5
20240702,6호선,마포구청,15271,14007,29278,14639
20240702,6호선,월드컵경기장(성산),3666,3779,7445,3722.5
20240702,6호선,디지털미디어시티,15827,17711,33538,16769
20240702,6호선,증산(명지대앞),10073,10130,20203,10101.5
20240702,6호선,새절(신사),13210,12221,25431,12715.5
20240702,6호선,구산,8768,6721,15489,7744.5
20240702,6호선,연신내,1,0,1,0.5
20240702,6호선,독바위,2992,3080,6072,3036
20240702,6호선,불광,4624,4685,9309,4654.5
20240702,6호선,역촌,3942,4627,8569,4284.5
20240702,6호선,응암,17947,17930,35877,17938.5
20240702,5호선,하남검단산,6209,5945,12154,6077
20240702,5호선,하남시청(덕풍·신장),8157,7678,15835,7917.5
20240702,5호선,하남풍산,4543,4658,9201,4600.5
20240702,5호선,미사,17457,17871,35328,17664
20240702,5호선,강일,6061,5744,11805,5902.5
20240702,5호선,마천,7918,7040,14958,7479
20240702,5호선,거여,10869,10821,21690,10845
20240702,5호선,개롱,6956,7186,14142,7071
20240702,5호선,오금,4142,4091,8233,4116.5
20240702,5호선,방이,7854,8170,16024,8012
20240702,5호선,올림픽공원(한국체대),5550,4491,10041,5020.5
20240702,5호선,둔촌동,9271,9362,18633,9316.5
20240702,5호선,상일동,15785,14911,30696,15348
20240702,5호선,고덕,11624,11327,22951,11475.5
20240702,5호선,명일,9442,9502,18944,9472
20240702,5호선,굽은다리(강동구민회관앞),9986,9582,19568,9784
20240702,5호선,길동,8334,8589,16923,8461.5
20240702,5호선,강동,19277,18622,37899,18949.5
20240702,5호선,천호(풍납토성),18406,18259,36665,18332.5
20240702,5호선,광나루(장신대),13401,12319,25720,12860
20240702,5호선,아차산(어린이대공원후문),14285,14035,28320,14160
20240702,5호선,군자(능동),11526,12516,24042,12021
20240702,5호선,장한평,20050,20005,40055,20027.5
20240702,5호선,답십리,16833,15380,32213,16106.5
20240702,5호선,마장,6003,5532,11535,5767.5
20240702,5호선,왕십리(성동구청),4598,5232,9830,4915
20240702,5호선,행당,8714,7850,16564,8282
20240702,5호선,신금호,7047,7389,14436,7218
20240702,5호선,청구,4117,3844,7961,3980.5
20240702,5호선,동대문역사문화공원(DDP),3485,3930,7415,3707.5
20240702,5호선,을지로4가,6833,6694,13527,6763.5
20240702,5호선,종로3가,12828,13112,25940,12970
20240702,5호선,광화문(세종문화회관),35238,36820,72058,36029
20240702,5호선,서대문,23797,23788,47585,23792.5
20240702,5호선,충정로(경기대입구),5504,5575,11079,5539.5
20240702,5호선,애오개,7667,7578,15245,7622.5
20240702,5호선,공덕,16010,16850,32860,16430
20240702,5호선,마포,16423,16584,33007,16503.5
20240702,5호선,여의나루,10729,13133,23862,11931
20240702,5호선,여의도,34589,35794,70383,35191.5
20240702,5호선,신길,5324,5474,10798,5399
20240702,5호선,영등포시장,11627,11742,23369,11684.5
20240702,5호선,영등포구청,4985,4947,9932,4966
20240702,5호선,양평,8514,8534,17048,8524
20240702,5호선,오목교(목동운동장앞),21892,22914,44806,22403
20240702,5호선,목동,16931,18413,35344,17672
20240702,5호선,신정(은행정),14125,11861,25986,12993
20240702,5호선,까치산,28435,27485,55920,27960
20240702,5호선,화곡,29086,27162,56248,28124
20240702,5호선,우장산,15516,15294,30810,15405
20240702,5호선,발산,23817,24381,48198,24099
20240702,5호선,마곡,13428,13576,27004,13502
20240702,5호선,송정,6411,5964,12375,6187.5
20240702,5호선,김포공항,10159,7359,17518,8759
20240702,5호선,개화산,6334,6028,12362,6181
20240702,5호선,방화,7124,6899,14023,7011.5
20240702,4호선,남태령,1352,1251,2603,1301.5
20240702,4호선,사당,25106,21827,46933,23466.5
20240702,4호선,총신대입구(이수),19016,20442,39458,19729
20240702,4호선,동작(현충원),1103,1211,2314,1157
20240702,4호선,이촌(국립중앙박물관),9374,10140,19514,9757
20240702,4호선,신용산,19984,21245,41229,20614.5
20240702,4호선,삼각지,6137,6901,13038,6519
20240702,4호선,숙대입구(갈월),14247,14114,28361,14180.5
20240702,4호선,서울역,13648,20837,34485,17242.5
20240702,4호선,회현(남대문시장),26651,27527,54178,27089
20240702,4호선,명동,29466,31173,60639,30319.5
20240702,4호선,충무로,32320,32579,64899,32449.5
20240702,4호선,동대문역사문화공원(DDP),18311,16098,34409,17204.5
20240702,4호선,동대문,19304,19765,39069,19534.5
20240702,4호선,혜화,33111,33331,66442,33221
20240702,4호선,한성대입구(삼선교),13470,13020,26490,13245
20240702,4호선,성신여대입구(돈암),20592,20173,40765,20382.5
20240702,4호선,길음,21468,21458,42926,21463
20240702,4호선,미아사거리,26396,25976,52372,26186
20240702,4호선,미아(서울사이버대학),15234,14803,30037,15018.5
20240702,4호선,수유(강북구청),32823,33278,66101,33050.5
20240702,4호선,쌍문,29660,27802,57462,28731
20240702,4호선,창동,25571,26782,52353,26176.5
20240702,4호선,노원,28015,31072,59087,29543.5
20240702,4호선,상계,19683,18490,38173,19086.5
20240702,4호선,당고개,9338,8200,17538,8769
20240702,3호선,오금,7148,6392,13540,6770
20240702,3호선,경찰병원,8417,8539,16956,8478
20240702,3호선,가락시장,9510,9081,18591,9295.5
20240702,3호선,수서,18630,18682,37312,18656
20240702,3호선,일원,12372,12012,24384,12192
20240702,3호선,대청,11787,10992,22779,11389.5
20240702,3호선,학여울,2118,2171,4289,2144.5
20240702,3호선,대치,12414,12498,24912,12456
20240702,3호선,도곡,6312,6167,12479,6239.5
20240702,3호선,매봉,13902,13310,27212,13606
20240702,3호선,양재(서초구청),40019,42993,83012,41506
20240702,3호선,남부터미널(예술의전당),30258,31132,61390,30695
20240702,3호선,교대(법원.검찰청),17685,10838,28523,14261.5
20240702,3호선,고속터미널,43138,39700,82838,41419
20240702,3호선,잠원,5713,5319,11032,5516
20240702,3호선,신사,28445,29707,58152,29076
20240702,3호선,압구정,32943,34775,67718,33859
20240702,3호선,옥수,8824,9119,17943,8971.5
20240702,3호선,금호,8238,7688,15926,7963
20240702,3호선,약수,13095,12778,25873,12936.5
20240702,3호선,동대입구,8742,9355,18097,9048.5
20240702,3호선,충무로,8,0,8,4
20240702,3호선,을지로3가,12495,12389,24884,12442
20240702,3호선,종로3가,11167,11957,23124,11562
20240702,3호선,안국,25181,25430,50611,25305.5
20240702,3호선,경복궁(정부서울청사),21328,20678,42006,21003
20240702,3호선,독립문,8096,8044,16140,8070
20240702,3호선,무악재,4663,4536,9199,4599.5
20240702,3호선,홍제,17740,16936,34676,17338
20240702,3호선,녹번,15971,14643,30614,15307
20240702,3호선,불광,16444,17542,33986,16993
20240702,3호선,연신내,33826,32478,66304,33152
20240702,3호선,구파발,22715,21969,44684,22342
20240702,3호선,지축,7948,7894,15842,7921
20240702,2호선,용두(동대문구청),2523,2563,5086,2543
20240702,2호선,신정네거리,10292,10686,20978,10489
20240702,2호선,양천구청,7234,7650,14884,7442
20240702,2호선,도림천,1505,1570,3075,1537.5
20240702,2호선,신설동,3317,3267,6584,3292
20240702,2호선,신답,1763,1984,3747,1873.5
20240702,2호선,용답,2885,2905,5790,2895
20240702,2호선,충정로(경기대입구),11336,11941,23277,11638.5
20240702,2호선,아현,11267,10585,21852,10926
20240702,2호선,이대,15656,17450,33106,16553
20240702,2호선,신촌,35675,36664,72339,36169.5
20240702,2호선,홍대입구,59982,63206,123188,61594
20240702,2호선,합정,30904,32375,63279,31639.5
20240702,2호선,당산,18062,21297,39359,19679.5
20240702,2호선,영등포구청,23992,24537,48529,24264.5
20240702,2호선,문래,24697,25232,49929,24964.5
20240702,2호선,신도림,50518,48431,98949,49474.5
20240702,2호선,대림(구로구청),24088,24561,48649,24324.5
20240702,2호선,구로디지털단지,60336,60053,120389,60194.5
20240702,2호선,신대방,25577,24961,50538,25269
20240702,2호선,신림,54483,52621,107104,53552
20240702,2호선,봉천,24975,23674,48649,24324.5
20240702,2호선,서울대입구(관악구청),46190,45475,91665,45832.5
20240702,2호선,낙성대(강감찬),28481,27490,55971,27985.5
20240702,2호선,사당,38609,41534,80143,40071.5
20240702,2호선,방배,16376,16883,33259,16629.5
20240702,2호선,서초,23219,22870,46089,23044.5
20240702,2호선,교대(법원.검찰청),33664,39706,73370,36685
20240702,2호선,강남,83675,81196,164871,82435.5
20240702,2호선,역삼,60904,68495,129399,64699.5
20240702,2호선,선릉,64077,56346,120423,60211.5
20240702,2호선,삼성(무역센터),58635,60033,118668,59334
20240702,2호선,종합운동장,7893,8902,16795,8397.5
20240702,2호선,잠실새내,24398,23423,47821,23910.5
20240702,2호선,잠실(송파구청),74845,74556,149401,74700.5
20240702,2호선,잠실나루,16703,16138,32841,16420.5
20240702,2호선,강변(동서울터미널),27756,25844,53600,26800
20240702,2호선,구의(광진구청),26149,25367,51516,25758
20240702,2호선,건대입구,32331,34339,66670,33335
20240702,2호선,성수,41660,44987,86647,43323.5
20240702,2호선,뚝섬,24362,26170,50532,25266
20240702,2호선,한양대,10879,11494,22373,11186.5
20240702,2호선,왕십리(성동구청),15439,13814,29253,14626.5
20240702,2호선,상왕십리,15333,15200,30533,15266.5
20240702,2호선,신당,14548,14959,29507,14753.5
20240702,2호선,동대문역사문화공원(DDP),13530,15572,29102,14551
20240702,2호선,을지로4가,14471,14447,28918,14459
20240702,2호선,을지로3가,27166,26570,53736,26868
20240702,2호선,을지로입구,51861,54258,106119,53059.5
20240702,2호선,시청,29228,28419,57647,28823.5
20240702,1호선,동묘앞,6380,6506,12886,6443
20240702,1호선,청량리(서울시립대입구),20070,19204,39274,19637
20240702,1호선,제기동,14178,13845,28023,14011.5
20240702,1호선,신설동,14199,13849,28048,14024
20240702,1호선,동대문,10326,9844,20170,10085
20240702,1호선,종로5가,22597,21815,44412,22206
20240702,1호선,종로3가,21365,19594,40959,20479.5
20240702,1호선,종각,41918,41277,83195,41597.5
20240702,1호선,시청,27476,27452,54928,27464
20240702,1호선,서울역,53186,49621,102807,51403.5
20240702,분당선,복정,5,0,5,2.5
20240702,중앙선,용문,1558,1539,3097,1548.5
20240702,중앙선,원덕,300,322,622,311
20240703,공항철도 1호선,운서,9644,10126,19770,9885
20240703,7호선,사가정,17683,17899,35582,17791
20240703,중앙선,용문,1870,1843,3713,1856.5
20240703,중앙선,지평,54,86,140,70
20240703,중앙선,신원,182,174,356,178
20240703,중앙선,국수,785,765,1550,775
20240703,중앙선,아신,513,512,1025,512.5
20240703,중앙선,오빈,320,357,677,338.5
20240703,중앙선,양평,3731,3760,7491,3745.5
20240703,중앙선,원덕,380,381,761,380.5
20240703,3호선,도곡,6867,6517,13384,6692
20240703,분당선,복정,6,0,6,3
20240703,중앙선,양수,2046,2047,4093,2046.5
20240703,중앙선,운길산,659,636,1295,647.5
20240703,중앙선,팔당,811,870,1681,840.5
20240703,중앙선,도심,2660,2164,4824,2412
20240703,중앙선,덕소,5702,5619,11321,5660.5
20240703,중앙선,양정,639,543,1182,591
20240703,중앙선,도농,12367,11177,23544,11772
20240703,중앙선,구리,14331,14462,28793,14396.5
20240703,중앙선,양원,3574,3517,7091,3545.5
20240703,중앙선,망우,8098,7825,15923,7961.5
20240703,중앙선,상봉,6351,6379,12730,6365
20240703,중앙선,중랑,5966,5594,11560,5780
20240703,중앙선,회기,26854,25571,52425,26212.5
20240703,장항선,신창(순천향대),1213,1245,2458,1229
20240703,장항선,온양온천,4199,4183,8382,4191
20240703,장항선,배방,1288,1276,2564,1282
20240703,장항선,탕정,1768,1603,3371,1685.5
20240703,장항선,아산,3435,3284,6719,3359.5
20240703,장항선,쌍용(나사렛대),2453,2312,4765,2382.5
20240703,장항선,봉명,1569,1593,3162,1581
20240703,일산선,대화,16140,12690,28830,14415
20240703,일산선,주엽,10775,10961,21736,10868
20240703,일산선,정발산,8127,8160,16287,8143.5
20240703,일산선,마두,8869,9018,17887,8943.5
20240703,일산선,백석,10863,11008,21871,10935.5
20240703,일산선,대곡,3309,2492,5801,2900.5
20240703,일산선,화정,18880,19359,38239,19119.5
20240703,일산선,원당,12043,11417,23460,11730
20240703,일산선,삼송,20799,20129,40928,20464
20240703,일산선,지축,3,0,3,1.5
20240703,일산선,원흥,12522,12054,24576,12288
20240703,우이신설선,신설동,2720,2566,5286,2643
20240703,우이신설선,보문,1778,1779,3557,1778.5
20240703,우이신설선,성신여대입구(돈암),3900,4167,8067,4033.5
20240703,우이신설선,정릉,5091,4684,9775,4887.5
20240703,우이신설선,북한산보국문,6693,6409,13102,6551
20240703,우이신설선,솔샘,6643,6395,13038,6519
20240703,우이신설선,삼양사거리,2868,2886,5754,2877
20240703,우이신설선,삼양,2282,2428,4710,2355
20240703,우이신설선,화계,3931,3706,7637,3818.5
20240703,우이신설선,가오리,4794,4837,9631,4815.5
20240703,우이신설선,4.19민주묘지,3450,3183,6633,3316.5
20240703,우이신설선,솔밭공원,2993,2802,5795,2897.5
20240703,우이신설선,북한산우이,2938,2629,5567,2783.5
20240703,안산선,수리산,4547,3758,8305,4152.5
20240703,안산선,오이도,8126,8074,16200,8100
20240703,안산선,정왕,9398,9489,18887,9443.5
20240703,안산선,신길온천,2202,2030,4232,2116
20240703,안산선,안산,12757,11556,24313,12156.5
20240703,안산선,초지,5363,5294,10657,5328.5
20240703,안산선,고잔,9822,9463,19285,9642.5
20240703,안산선,중앙,19638,20429,40067,20033.5
20240703,안산선,한대앞,9725,9793,19518,9759
20240703,안산선,상록수,15972,16238,32210,16105
20240703,안산선,반월,4869,4761,9630,4815
20240703,안산선,대야미,5346,4833,10179,5089.5
20240703,안산선,산본,17837,18780,36617,18308.5
20240703,신림선,관악산(서울대),3154,3209,6363,3181.5
20240703,신림선,서울대벤처타운,10520,9627,20147,10073.5
20240703,신림선,서원,3967,3406,7373,3686.5
20240703,신림선,신림,2020,2669,4689,2344.5
20240703,신림선,당곡,5355,5159,10514,5257
20240703,신림선,보라매병원,8718,9361,18079,9039.5
20240703,신림선,보라매공원,2697,2823,5520,2760
20240703,신림선,보라매,4795,4340,9135,4567.5
20240703,신림선,서울지방병무청,3538,3874,7412,3706
20240703,신림선,대방,3215,2622,5837,2918.5
20240703,신림선,샛강,3429,3845,7274,3637
20240703,수인선,인천,1127,1742,2869,1434.5
20240703,수인선,신포,2053,2154,4207,2103.5
20240703,수인선,숭의,4773,4434,9207,4603.5
20240703,수인선,인하대,7152,6638,13790,6895
20240703,수인선,송도,2753,2504,5257,2628.5
20240703,수인선,연수,5156,5098,10254,5127
20240703,수인선,원인재,4816,4923,9739,4869.5
20240703,수인선,남동인더스파크,2590,2929,5519,2759.5
20240703,수인선,호구포,4389,4511,8900,4450
20240703,수인선,인천논현,5944,6332,12276,6138
20240703,수인선,소래포구,4951,4606,9557,4778.5
20240703,수인선,월곶,3650,3275,6925,3462.5
20240703,수인선,달월,143,85,228,114
20240703,수인선,사리,5421,4630,10051,5025.5
20240703,수인선,야목,456,392,848,424
20240703,수인선,어천,1394,1366,2760,1380
20240703,수인선,오목천,4229,3786,8015,4007.5
20240703,수인선,고색,6073,5673,11746,5873
20240703,서해선,부천종합운동장,2753,2412,5165,2582.5
20240703,서해선,원종,5120,5105,10225,5112.5
20240703,서해선,김포공항,2940,3969,6909,3454.5
20240703,분당선,매교,5971,5805,11776,5888
20240703,분당선,수원시청,14819,15886,30705,15352.5
20240703,분당선,매탄권선,6008,5937,11945,5972.5
20240703,분당선,망포,17012,16277,33289,16644.5
20240703,분당선,영통,9571,9845,19416,9708
20240703,분당선,청명,5120,4922,10042,5021
20240703,분당선,상갈,5841,5537,11378,5689
20240703,분당선,기흥,11148,10159,21307,10653.5
20240703,분당선,신갈,5272,4983,10255,5127.5
20240703,분당선,구성,7043,6962,14005,7002.5
20240703,분당선,죽전,13873,15347,29220,14610
20240703,분당선,보정,2873,2617,5490,2745
20240703,분당선,이매,6561,6170,12731,6365.5
20240703,분당선,오리,12974,11064,24038,12019
20240703,분당선,미금,17174,17779,34953,17476.5
20240703,분당선,정자,20530,21474,42004,21002
20240703,분당선,수내,16001,16188,32189,16094.5
20240703,분당선,서현,26795,27493,54288,27144
20240703,분당선,야탑,27896,29479,57375,28687.5
20240703,분당선,모란,21015,21192,42207,21103.5
20240703,분당선,태평,14046,13397,27443,13721.5
20240703,분당선,가천대,8260,8539,16799,8399.5
20240703,분당선,선정릉,8724,9162,17886,8943
20240703,분당선,강남구청,10996,12726,23722,11861
20240703,분당선,압구정로데오,19944,21843,41787,20893.5
20240703,분당선,서울숲,13406,13766,27172,13586
20240703,분당선,수원,8126,7424,15550,7775
20240703,분당선,수서,17653,18146,35799,17899.5
20240703,분당선,대모산입구,6803,6451,13254,6627
20240703,분당선,개포동,5343,5411,10754,5377
20240703,분당선,구룡,4606,4581,9187,4593.5
20240703,분당선,도곡,8723,8854,17577,8788.5
20240703,분당선,한티,16897,18142,35039,17519.5
20240703,분당선,선릉,15287,23483,38770,19385
20240703,과천선,범계,29407,29194,58601,29300.5
20240703,과천선,평촌,19816,19280,39096,19548
20240703,과천선,인덕원,27974,28796,56770,28385
20240703,과천선,정부과천청사,13875,14417,28292,14146
20240703,과천선,과천,7222,6622,13844,6922
20240703,과천선,대공원,4509,4472,8981,4490.5
20240703,과천선,경마공원,1766,1766,3532,1766
20240703,과천선,선바위,8278,7494,15772,7886
20240703,공항철도 1호선,영종,4238,4312,8550,4275
20240703,공항철도 1호선,인천공항2터미널,6593,5726,12319,6159.5
20240703,공항철도 1호선,인천공항1터미널,14392,13799,28191,14095.5
20240703,1호선,서울역,55340,52457,107797,53898.5
20240703,1호선,시청,28639,29145,57784,28892
20240703,1호선,종각,43891,43765,87656,43828
20240703,1호선,종로3가,27635,25366,53001,26500.5
20240703,1호선,종로5가,25648,25526,51174,25587
20240703,1호선,동대문,11830,11365,23195,11597.5
20240703,1호선,신설동,15528,14960,30488,15244
20240703,1호선,제기동,18013,18430,36443,18221.5
20240703,1호선,청량리(서울시립대입구),23871,23141,47012,23506
20240703,1호선,동묘앞,9500,9814,19314,9657
20240703,2호선,시청,30735,29392,60127,30063.5
20240703,2호선,을지로입구,54790,56515,111305,55652.5
20240703,2호선,을지로3가,28705,28867,57572,28786
20240703,2호선,을지로4가,15883,15995,31878,15939
20240703,2호선,동대문역사문화공원(DDP),15529,18122,33651,16825.5
20240703,2호선,신당,16014,16540,32554,16277
20240703,2호선,상왕십리,16165,16049,32214,16107
20240703,2호선,왕십리(성동구청),17107,15492,32599,16299.5
20240703,2호선,한양대,11100,11805,22905,11452.5
20240703,2호선,뚝섬,27020,28542,55562,27781
20240703,2호선,성수,46950,51630,98580,49290
20240703,2호선,건대입구,37542,39461,77003,38501.5
20240703,2호선,구의(광진구청),27417,26564,53981,26990.5
20240703,2호선,강변(동서울터미널),30459,28561,59020,29510
20240703,2호선,잠실나루,17392,16927,34319,17159.5
20240703,2호선,잠실(송파구청),82398,82009,164407,82203.5
20240703,2호선,잠실새내,26798,26330,53128,26564
20240703,2호선,종합운동장,21162,22685,43847,21923.5
20240703,2호선,삼성(무역센터),61438,62897,124335,62167.5
20240703,2호선,선릉,68053,59901,127954,63977
20240703,2호선,역삼,60362,69454,129816,64908
20240703,2호선,강남,91908,89610,181518,90759
20240703,2호선,교대(법원.검찰청),35876,42851,78727,39363.5
20240703,2호선,서초,24056,24111,48167,24083.5
20240703,2호선,방배,17677,17970,35647,17823.5
20240703,2호선,사당,42579,45955,88534,44267
20240703,2호선,낙성대(강감찬),30389,29706,60095,30047.5
20240703,2호선,서울대입구(관악구청),50464,48868,99332,49666
20240703,2호선,봉천,27091,25341,52432,26216
20240703,2호선,신림,59109,57039,116148,58074
20240703,2호선,신대방,27628,26773,54401,27200.5
20240703,2호선,구로디지털단지,64107,63732,127839,63919.5
20240703,2호선,대림(구로구청),27262,27538,54800,27400
20240703,2호선,신도림,54576,53226,107802,53901
20240703,2호선,문래,26187,26739,52926,26463
20240703,2호선,영등포구청,25531,26100,51631,25815.5
20240703,2호선,당산,20108,23635,43743,21871.5
20240703,2호선,합정,33903,36269,70172,35086
20240703,2호선,홍대입구,70518,76439,146957,73478.5
20240703,2호선,신촌,40176,40881,81057,40528.5
20240703,2호선,이대,16962,18847,35809,17904.5
20240703,2호선,아현,12170,11217,23387,11693.5
20240703,2호선,충정로(경기대입구),11679,12378,24057,12028.5
20240703,2호선,용답,3163,3120,6283,3141.5
20240703,2호선,신답,1861,2038,3899,1949.5
20240703,2호선,신설동,3561,3571,7132,3566
20240703,2호선,도림천,1508,1618,3126,1563
20240703,2호선,양천구청,7693,8104,15797,7898.5
20240703,2호선,신정네거리,11181,11566,22747,11373.5
20240703,2호선,용두(동대문구청),2725,2782,5507,2753.5
20240703,3호선,지축,8426,8363,16789,8394.5
20240703,3호선,구파발,23632,22700,46332,23166
20240703,3호선,연신내,37088,34994,72082,36041
20240703,3호선,불광,18040,19284,37324,18662
20240703,3호선,녹번,17100,15602,32702,16351
20240703,3호선,홍제,19483,18244,37727,18863.5
20240703,3호선,무악재,5021,4823,9844,4922
20240703,3호선,독립문,8532,8662,17194,8597
20240703,3호선,경복궁(정부서울청사),26899,27316,54215,27107.5
20240703,3호선,안국,29339,30231,59570,29785
20240703,3호선,종로3가,12062,13093,25155,12577.5
20240703,3호선,을지로3가,13367,13215,26582,13291
20240703,3호선,충무로,13,0,13,6.5
20240703,3호선,동대입구,9411,10223,19634,9817
20240703,3호선,약수,14355,13884,28239,14119.5
20240703,3호선,금호,8883,8177,17060,8530
20240703,3호선,옥수,9838,9992,19830,9915
20240703,3호선,압구정,34498,36726,71224,35612
20240703,3호선,신사,29809,31181,60990,30495
20240703,3호선,잠원,6005,5504,11509,5754.5
20240703,3호선,고속터미널,45821,42426,88247,44123.5
20240703,3호선,교대(법원.검찰청),19415,11518,30933,15466.5
20240703,3호선,남부터미널(예술의전당),32420,33494,65914,32957
20240703,3호선,양재(서초구청),41827,45165,86992,43496
20240703,3호선,매봉,14809,14453,29262,14631
20240703,3호선,대치,12970,12871,25841,12920.5
20240703,3호선,학여울,2369,2433,4802,2401
20240703,3호선,대청,12537,11665,24202,12101
20240703,3호선,일원,12621,12245,24866,12433
20240703,3호선,수서,19523,19616,39139,19569.5
20240703,3호선,가락시장,10128,9754,19882,9941
20240703,3호선,경찰병원,8649,8639,17288,8644
20240703,3호선,오금,7423,6574,13997,6998.5
20240703,4호선,당고개,10290,8690,18980,9490
20240703,4호선,상계,21232,19715,40947,20473.5
20240703,4호선,노원,31221,34714,65935,32967.5
20240703,4호선,창동,29007,30547,59554,29777
20240703,4호선,쌍문,32121,29514,61635,30817.5
20240703,4호선,수유(강북구청),36304,36579,72883,36441.5
20240703,4호선,미아(서울사이버대학),16657,16326,32983,16491.5
20240703,4호선,미아사거리,29282,28962,58244,29122
20240703,4호선,길음,23636,23144,46780,23390
20240703,4호선,성신여대입구(돈암),22446,21640,44086,22043
20240703,4호선,한성대입구(삼선교),14357,13771,28128,14064
20240703,4호선,혜화,37586,37628,75214,37607
20240703,4호선,동대문,22068,22553,44621,22310.5
20240703,4호선,동대문역사문화공원(DDP),20151,17649,37800,18900
20240703,4호선,충무로,32940,34035,66975,33487.5
20240703,4호선,명동,33266,35154,68420,34210
20240703,4호선,회현(남대문시장),30044,31402,61446,30723
20240703,4호선,서울역,14379,21982,36361,18180.5
20240703,4호선,숙대입구(갈월),15247,15000,30247,15123.5
20240703,4호선,삼각지,6593,7596,14189,7094.5
20240703,4호선,신용산,21675,22788,44463,22231.5
20240703,4호선,이촌(국립중앙박물관),9098,9954,19052,9526
20240703,4호선,동작(현충원),1765,1873,3638,1819
20240703,4호선,총신대입구(이수),21094,22745,43839,21919.5
20240703,4호선,사당,27137,23684,50821,25410.5
20240703,4호선,남태령,1492,1361,2853,1426.5
20240703,5호선,방화,7764,7429,15193,7596.5
20240703,5호선,개화산,6711,6487,13198,6599
20240703,5호선,김포공항,11000,8209,19209,9604.5
20240703,5호선,송정,6870,6415,13285,6642.5
20240703,5호선,마곡,14286,14172,28458,14229
20240703,5호선,발산,25135,25903,51038,25519
20240703,5호선,우장산,16441,16209,32650,16325
20240703,5호선,화곡,31483,29597,61080,30540
20240703,5호선,까치산,30616,29462,60078,30039
20240703,5호선,신정(은행정),14919,12398,27317,13658.5
20240703,5호선,목동,18359,19741,38100,19050
20240703,5호선,오목교(목동운동장앞),23480,24987,48467,24233.5
20240703,5호선,양평,8810,8615,17425,8712.5
20240703,5호선,영등포구청,5460,5325,10785,5392.5
20240703,5호선,영등포시장,12717,12872,25589,12794.5
20240703,5호선,신길,5482,5664,11146,5573
20240703,5호선,여의도,33507,35532,69039,34519.5
20240703,5호선,여의나루,14260,15820,30080,15040
20240703,5호선,마포,16596,17043,33639,16819.5
20240703,5호선,공덕,16735,17562,34297,17148.5
20240703,5호선,애오개,7911,7817,15728,7864
20240703,5호선,충정로(경기대입구),5440,5466,10906,5453
20240703,5호선,서대문,23928,24340,48268,24134
20240703,5호선,광화문(세종문화회관),36934,39383,76317,38158.5
20240703,5호선,종로3가,15937,16439,32376,16188
20240703,5호선,을지로4가,7547,7340,14887,7443.5
20240703,5호선,동대문역사문화공원(DDP),3464,4035,7499,3749.5
20240703,5호선,청구,4363,4130,8493,4246.5
20240703,5호선,신금호,7452,7747,15199,7599.5
20240703,5호선,행당,9209,8010,17219,8609.5
20240703,5호선,왕십리(성동구청),5115,5838,10953,5476.5
20240703,5호선,마장,6435,5889,12324,6162
20240703,5호선,답십리,17864,16132,33996,16998
20240703,5호선,장한평,21922,21720,43642,21821
20240703,5호선,군자(능동),12275,13494,25769,12884.5
20240703,5호선,아차산(어린이대공원후문),15710,15079,30789,15394.5
20240703,5호선,광나루(장신대),14560,13544,28104,14052
20240703,5호선,천호(풍납토성),20865,20657,41522,20761
20240703,5호선,강동,20109,19662,39771,19885.5
20240703,5호선,길동,9012,9288,18300,9150
20240703,5호선,굽은다리(강동구민회관앞),11023,10559,21582,10791
20240703,5호선,명일,9934,10332,20266,10133
20240703,5호선,고덕,12776,12053,24829,12414.5
20240703,5호선,상일동,16569,15604,32173,16086.5
20240703,5호선,둔촌동,9710,9800,19510,9755
20240703,5호선,올림픽공원(한국체대),6220,4980,11200,5600
20240703,5호선,방이,8120,8510,16630,8315
20240703,5호선,오금,4256,4328,8584,4292
20240703,5호선,개롱,7474,7601,15075,7537.5
20240703,5호선,거여,11282,11099,22381,11190.5
20240703,5호선,마천,8491,7671,16162,8081
20240703,5호선,강일,6645,6168,12813,6406.5
20240703,5호선,미사,19660,19959,39619,19809.5
20240703,5호선,하남풍산,5094,5001,10095,5047.5
20240703,5호선,하남시청(덕풍·신장),9104,8521,17625,8812.5
20240703,5호선,하남검단산,7354,7058,14412,7206
20240703,6호선,응암,19789,19382,39171,19585.5
20240703,6호선,역촌,4123,4822,8945,4472.5
20240703,6호선,불광,5161,4977,10138,5069
20240703,6호선,독바위,3077,3215,6292,3146
20240703,6호선,연신내,3,0,3,1.5
20240703,6호선,구산,9222,6934,16156,8078
20240703,6호선,새절(신사),14096,13008,27104,13552
20240703,6호선,증산(명지대앞),10867,10791,21658,10829
20240703,6호선,디지털미디어시티,16505,18227,34732,17366
20240703,6호선,월드컵경기장(성산),4867,4940,9807,4903.5
20240703,6호선,마포구청,16231,14555,30786,15393
20240703,6호선,망원,16020,16711,32731,16365.5
20240703,6호선,합정,14155,13761,27916,13958
20240703,6호선,상수,9764,10880,20644,10322
20240703,6호선,광흥창(서강),10669,10406,21075,10537.5
20240703,6호선,대흥(서강대앞),10209,10745,20954,10477
20240703,6호선,공덕,21694,20957,42651,21325.5
20240703,6호선,효창공원앞,8115,7349,15464,7732
20240703,6호선,삼각지,8682,7652,16334,8167
20240703,6호선,녹사평(용산구청),5479,5446,10925,5462.5
20240703,6호선,이태원,11202,12019,23221,11610.5
20240703,6호선,한강진,12039,13663,25702,12851
20240703,6호선,버티고개,2376,2369,4745,2372.5
20240703,6호선,약수,4055,3924,7979,3989.5
20240703,6호선,청구,4450,4395,8845,4422.5
20240703,6호선,신당,9273,9783,19056,9528
20240703,6호선,동묘앞,8712,8691,17403,8701.5
20240703,6호선,창신,3953,3309,7262,3631
20240703,6호선,보문,8829,8215,17044,8522
20240703,6호선,안암(고대병원앞),12565,12609,25174,12587
20240703,6호선,고려대(종암),9328,8899,18227,9113.5
20240703,6호선,월곡(동덕여대),12885,12619,25504,12752
20240703,6호선,상월곡(한국과학기술연구원),7000,6292,13292,6646
20240703,6호선,돌곶이,11227,10181,21408,10704
20240703,6호선,석계,13700,13964,27664,13832
20240703,6호선,태릉입구,5971,6614,12585,6292.5
20240703,6호선,화랑대(서울여대입구),13152,10272,23424,11712
20240703,6호선,봉화산(서울의료원),10114,9367,19481,9740.5
20240703,7호선,장암,3094,1302,4396,2198
20240703,7호선,도봉산,9565,10714,20279,10139.5
20240703,7호선,수락산,13343,13267,26610,13305
20240703,7호선,마들,14546,13824,28370,14185
20240703,7호선,노원,26879,27738,54617,27308.5
20240703,7호선,중계,17006,15735,32741,16370.5
20240703,7호선,하계,20482,19106,39588,19794
20240703,7호선,공릉(서울과학기술대),13085,13096,26181,13090.5
20240703,7호선,태릉입구,9387,8709,18096,9048
20240703,7호선,먹골,11192,10933,22125,11062.5
20240703,7호선,중화,11570,11467,23037,11518.5
20240703,7호선,상봉,18650,17972,36622,18311
20240703,7호선,면목,16183,15740,31923,15961.5
20240703,7호선,용마산(용마폭포공원),6350,6284,12634,6317
20240703,7호선,중곡,12417,11396,23813,11906.5
20240703,7호선,군자(능동),16700,13402,30102,15051
20240703,7호선,어린이대공원(세종대),14885,14841,29726,14863
20240703,7호선,건대입구,14427,14716,29143,14571.5
20240703,7호선,자양(뚝섬한강공원),10037,9593,19630,9815
20240703,7호선,청담,21504,23505,45009,22504.5
20240703,7호선,강남구청,18266,20171,38437,19218.5
20240703,7호선,학동,27186,28645,55831,27915.5
20240703,7호선,논현,21255,21492,42747,21373.5
20240703,7호선,반포,7078,6748,13826,6913
20240703,7호선,고속터미널,16732,15285,32017,16008.5
20240703,7호선,내방,16854,16838,33692,16846
20240703,7호선,이수,18235,17377,35612,17806
20240703,7호선,남성,12714,11885,24599,12299.5
20240703,7호선,숭실대입구(살피재),14006,14072,28078,14039
20240703,7호선,상도,12636,12323,24959,12479.5
20240703,7호선,장승배기,10472,10122,20594,10297
20240703,7호선,신대방삼거리,16039,15657,31696,15848
20240703,7호선,보라매,7298,7617,14915,7457.5
20240703,7호선,신풍,12435,11620,24055,12027.5
20240703,7호선,대림(구로구청),9410,9475,18885,9442.5
20240703,7호선,남구로,16622,17299,33921,16960.5
20240703,7호선,가산디지털단지,51372,51988,103360,51680
20240703,7호선,철산,23265,23597,46862,23431
20240703,7호선,광명사거리,21714,21518,43232,21616
20240703,7호선,천왕,13243,12650,25893,12946.5
20240703,7호선,온수(성공회대입구),10864,9716,20580,10290
20240703,8호선,암사,21030,18393,39423,19711.5
20240703,8호선,천호(풍납토성),16501,19042,35543,17771.5
20240703,8호선,강동구청,11929,12218,24147,12073.5
20240703,8호선,몽촌토성(평화의문),7440,7472,14912,7456
20240703,8호선,잠실(송파구청),17552,20162,37714,18857
20240703,8호선,석촌,8961,10223,19184,9592
20240703,8호선,송파,10806,10438,21244,10622
20240703,8호선,가락시장,8591,9632,18223,9111.5
20240703,8호선,문정,25274,26575,51849,25924.5
20240703,8호선,장지,19172,17564,36736,18368
20240703,8호선,복정,10357,8645,19002,9501
20240703,8호선,산성,6929,7138,14067,7033.5
20240703,8호선,남한산성입구(성남법원.검찰청),14481,13000,27481,13740.5
20240703,8호선,단대오거리,12895,12605,25500,12750
20240703,8호선,신흥,5604,5906,11510,5755
20240703,8호선,수진,6324,5958,12282,6141
20240703,8호선,모란,5079,4011,9090,4545
20240703,8호선,남위례,8451,8456,16907,8453.5
20240703,9호선,개화,3126,2082,5208,2604
20240703,9호선,김포공항,6870,10359,17229,8614.5
20240703,9호선,공항시장,3436,3558,6994,3497
20240703,9호선,신방화,7896,7739,15635,7817.5
20240703,9호선,마곡나루(서울식물원),15451,15711,31162,15581
20240703,9호선,양천향교,11396,11561,22957,11478.5
20240703,9호선,가양,24602,24123,48725,24362.5
20240703,9호선,증미,9392,9128,18520,9260
20240703,9호선,등촌,13913,13211,27124,13562
20240703,9호선,염창,19443,18825,38268,19134
20240703,9호선,신목동,5375,4763,10138,5069
20240703,9호선,선유도,10242,9580,19822,9911
20240703,9호선,당산,21641,21262,42903,21451.5
20240703,9호선,국회의사당,20502,20946,41448,20724
20240703,9호선,여의도,34906,34307,69213,34606.5
20240703,9호선,샛강,7429,7478,14907,7453.5
20240703,9호선,노량진,26647,26008,52655,26327.5
20240703,9호선,노들,5470,4471,9941,4970.5
20240703,9호선,흑석(중앙대입구),9996,10190,20186,10093
20240703,9호선,동작(현충원),1911,1689,3600,1800
20240703,9호선,구반포,1438,1438,2876,1438
20240703,9호선,신반포,4811,4660,9471,4735.5
20240703,9호선,고속터미널,15042,19251,34293,17146.5
20240703,9호선,사평,4537,4385,8922,4461
20240703,9호선,신논현,33517,33584,67101,33550.5
20240703,9호선2~3단계,언주,12965,13414,26379,13189.5
20240703,9호선2~3단계,선정릉,11556,12393,23949,11974.5
20240703,9호선2~3단계,삼성중앙,9085,9545,18630,9315
20240703,9호선2~3단계,봉은사,22697,23497,46194,23097
20240703,9호선2~3단계,종합운동장,5451,5724,11175,5587.5
20240703,9호선2~3단계,삼전,9060,8421,17481,8740.5
20240703,9호선2~3단계,석촌고분,7984,7816,15800,7900
20240703,9호선2~3단계,석촌,10569,9427,19996,9998
20240703,9호선2~3단계,송파나루,6109,6594,12703,6351.5
20240703,9호선2~3단계,한성백제,3379,3039,6418,3209
20240703,9호선2~3단계,올림픽공원(한국체대),5741,6130,11871,5935.5
20240703,9호선2~3단계,둔촌오륜,1505,1512,3017,1508.5
20240703,9호선2~3단계,중앙보훈병원,13728,12128,25856,12928
20240703,경강선,판교,6225,6146,12371,6185.5
20240703,경강선,이매,1169,1044,2213,1106.5
20240703,경강선,삼동,2746,2578,5324,2662
20240703,경강선,경기광주,8427,8076,16503,8251.5
20240703,경강선,초월,3752,3522,7274,3637
20240703,경강선,곤지암,2348,2255,4603,2301.5
20240703,경강선,신둔도예촌,1498,1392,2890,1445
20240703,경강선,이천,2878,3084,5962,2981
20240703,경강선,부발,2260,2252,4512,2256
20240703,경강선,세종대왕릉,327,335,662,331
20240703,경강선,여주,2696,2637,5333,2666.5
20240703,경강선,성남,948,866,1814,907
20240703,경부선,서울역,8103,2986,11089,5544.5
20240703,경부선,남영,10674,10966,21640,10820
20240703,경부선,용산,39072,39659,78731,39365.5
20240703,경부선,노량진,8088,8109,16197,8098.5
20240703,경부선,대방,11758,12717,24475,12237.5
20240703,경부선,영등포,41812,42766,84578,42289
20240703,경부선,신도림,4432,4658,9090,4545
20240703,경부선,신길,9670,8122,17792,8896
20240703,경부선,구로,19065,19184,38249,19124.5
20240703,경부선,가산디지털단지,19722,22551,42273,21136.5
20240703,경부선,금천구청,12185,12405,24590,12295
20240703,경부선,석수,9278,8477,17755,8877.5
20240703,경부선,관악,7847,7682,15529,7764.5
20240703,경부선,안양,22437,22092,44529,22264.5
20240703,경부선,명학,9603,9321,18924,9462
20240703,경부선,금정,30077,30363,60440,30220
20240703,경부선,군포,7840,7758,15598,7799
20240703,경부선,의왕,9818,9685,19503,9751.5
20240703,경부선,성균관대,15721,15453,31174,15587
20240703,경부선,화서,12292,11939,24231,12115.5
20240703,경부선,수원,35426,37340,72766,36383
20240703,경부선,독산,19474,20261,39735,19867.5
20240703,경부선,세류,3685,3473,7158,3579
20240703,경부선,병점,15107,15079,30186,15093
20240703,경부선,세마,3561,3465,7026,3513
20240703,경부선,오산대,3964,3636,7600,3800
20240703,경부선,오산,10297,10553,20850,10425
20240703,경부선,진위,1948,1799,3747,1873.5
20240703,경부선,송탄,4708,4471,9179,4589.5
20240703,경부선,서정리,8380,7852,16232,8116
20240703,경부선,평택지제,4196,4198,8394,4197
20240703,경부선,평택,12695,11985,24680,12340
20240703,경부선,성환,3994,4059,8053,4026.5
20240703,경부선,직산,1042,1016,2058,1029
20240703,경부선,두정,6675,6763,13438,6719
20240703,경부선,천안,5571,5640,11211,5605.5
20240703,경부선,당정,6561,6292,12853,6426.5
20240703,경부선,서동탄,1650,1416,3066,1533
20240703,경부선,광명,3759,3231,6990,3495
20240703,경원선,이촌(국립중앙박물관),4368,3406,7774,3887
20240703,경원선,서빙고,2380,2157,4537,2268.5
20240703,경원선,한남,4265,4064,8329,4164.5
20240703,경원선,옥수,41,25,66,33
20240703,경원선,응봉,2057,1790,3847,1923.5
20240703,경원선,왕십리(성동구청),17819,17772,35591,17795.5
20240703,경원선,청량리(서울시립대입구),15455,16656,32111,16055.5
20240703,경원선,외대앞,9668,9256,18924,9462
20240703,경원선,신이문,9391,8712,18103,9051.5
20240703,경원선,석계,7728,8863,16591,8295.5
20240703,경원선,광운대,8751,8147,16898,8449
20240703,경원선,월계,7278,6857,14135,7067.5
20240703,경원선,녹천,5130,4248,9378,4689
20240703,경원선,방학,10831,10535,21366,10683
20240703,경원선,도봉,6435,6244,12679,6339.5
20240703,경원선,도봉산,7534,4774,12308,6154
20240703,경원선,망월사,8036,8172,16208,8104
20240703,경원선,회룡,14066,13715,27781,13890.5
20240703,경원선,의정부,19621,20124,39745,19872.5
20240703,경원선,가능,6999,6801,13800,6900
20240703,경원선,녹양,4663,4566,9229,4614.5
20240703,경원선,양주,7475,7207,14682,7341
20240703,경원선,덕계,6368,5880,12248,6124
20240703,경원선,덕정,6421,6149,12570,6285
20240703,경원선,지행,6867,6902,13769,6884.5
20240703,경원선,동두천중앙,3212,3068,6280,3140
20240703,경원선,보산,2019,1519,3538,1769
20240703,경원선,동두천,1844,1694,3538,1769
20240703,경원선,소요산,1488,1473,2961,1480.5
20240703,경원선,청산,156,133,289,144.5
20240703,경원선,전곡,1078,1008,2086,1043
20240703,경원선,연천,1032,1082,2114,1057
20240703,경의선,서울역,5135,6502,11637,5818.5
20240703,경의선,신촌,1192,1481,2673,1336.5
20240703,경의선,효창공원앞,3552,4046,7598,3799
20240703,경의선,공덕,4696,3908,8604,4302
20240703,경의선,서강대,2369,2332,4701,2350.5
20240703,경의선,홍대입구,2153,2661,4814,2407
20240703,경의선,가좌,6471,6102,12573,6286.5
20240703,경의선,디지털미디어시티,2998,2812,5810,2905
20240703,경의선,수색,3953,4037,7990,3995
20240703,경의선,한국항공대,2418,2251,4669,2334.5
20240703,경의선,강매,3834,3177,7011,3505.5
20240703,경의선,행신,8863,8771,17634,8817
20240703,경의선,능곡,5317,5028,10345,5172.5
20240703,경의선,곡산,776,800,1576,788
20240703,경의선,백마,8340,8114,16454,8227
20240703,경의선,풍산,6736,6379,13115,6557.5
20240703,경의선,일산,12866,12592,25458,12729
20240703,경의선,탄현,8577,8218,16795,8397.5
20240703,경의선,야당,9704,9926,19630,9815
20240703,경의선,운정,8668,8154,16822,8411
20240703,경의선,금릉,6006,5793,11799,5899.5
20240703,경의선,금촌,6886,6680,13566,6783
20240703,경의선,월롱,2274,1889,4163,2081.5
20240703,경의선,파주,1354,936,2290,1145
20240703,경의선,문산,5493,5288,10781,5390.5
20240703,경의선,임진강,12,12,24,12
20240703,경의선,운천,8,6,14,7
20240703,경인선,개봉,23481,23086,46567,23283.5
20240703,경인선,오류동,12811,12071,24882,12441
20240703,경인선,역곡,27555,27549,55104,27552
20240703,경인선,부천,32992,33192,66184,33092
20240703,경인선,송내,28886,28190,57076,28538
20240703,경인선,부평,29989,31616,61605,30802.5
20240703,경인선,백운,8150,7999,16149,8074.5
20240703,경인선,동암,16655,16804,33459,16729.5
20240703,경인선,주안,19654,17757,37411,18705.5
20240703,경인선,제물포,11687,11108,22795,11397.5
20240703,경인선,동인천,14950,13981,28931,14465.5
20240703,경인선,인천,3924,3102,7026,3513
20240703,경인선,구일,11751,12470,24221,12110.5
20240703,경인선,소사,7914,7590,15504,7752
20240703,경인선,부개,9504,8927,18431,9215.5
20240703,경인선,간석,6540,6110,12650,6325
20240703,경인선,도원,3801,3913,7714,3857
20240703,경인선,온수(성공회대입구),6934,6700,13634,6817
20240703,경인선,중동,10139,9567,19706,9853
20240703,경인선,도화,4661,4350,9011,4505.5
20240703,경춘선,신내,3126,2852,5978,2989
20240703,경춘선,갈매,3434,2870,6304,3152
20240703,경춘선,별내,3962,3713,7675,3837.5
20240703,경춘선,퇴계원,3850,3517,7367,3683.5
20240703,경춘선,사릉,2220,2171,4391,2195.5
20240703,경춘선,금곡,1597,1576,3173,1586.5
20240703,경춘선,평내호평,6731,6601,13332,6666
20240703,경춘선,천마산,1639,1559,3198,1599
20240703,경춘선,마석,4193,4147,8340,4170
20240703,경춘선,대성리,830,746,1576,788
20240703,경춘선,청평,1942,1888,3830,1915
20240703,경춘선,상천,257,216,473,236.5
20240703,경춘선,가평,2383,2321,4704,2352
20240703,경춘선,굴봉산,108,72,180,90
20240703,경춘선,백양리,78,55,133,66.5
20240703,경춘선,강촌,383,369,752,376
20240703,경춘선,김유정,289,314,603,301.5
20240703,경춘선,남춘천,2197,2225,4422,2211
20240703,경춘선,춘천,1113,1041,2154,1077
20240703,공항철도 1호선,서울역,12115,11002,23117,11558.5
20240703,공항철도 1호선,공덕,3290,4120,7410,3705
20240703,공항철도 1호선,홍대입구,14228,13877,28105,14052.5
20240703,공항철도 1호선,디지털미디어시티,15981,15102,31083,15541.5
20240703,공항철도 1호선,마곡나루(서울식물원),13895,13119,27014,13507
20240703,공항철도 1호선,김포공항,9873,6254,16127,8063.5
20240703,공항철도 1호선,계양,14460,13717,28177,14088.5
20240703,공항철도 1호선,검암,6871,7065,13936,6968
20240703,공항철도 1호선,청라국제도시,8205,7703,15908,7954
20240703,공항철도 1호선,공항화물청사,2268,2520,4788,2394
20240704,9호선,양천향교,11526,11629,23155,11577.5
20240704,분당선,상갈,5943,5681,11624,5812
20240704,분당선,기흥,11339,10204,21543,10771.5
20240704,분당선,신갈,5373,5200,10573,5286.5
20240704,분당선,수원,8475,7615,16090,8045
20240704,분당선,복정,4,0,4,2
20240704,분당선,수서,18280,19105,37385,18692.5
20240704,분당선,대모산입구,7162,6735,13897,6948.5
20240704,분당선,개포동,5137,5389,10526,5263
20240704,분당선,구룡,4222,4085,8307,4153.5
20240704,분당선,도곡,8813,8909,17722,8861
20240704,분당선,한티,17340,18525,35865,17932.5
20240704,분당선,선릉,15595,23597,39192,19596
20240704,과천선,범계,29513,29442,58955,29477.5
20240704,과천선,평촌,19921,19535,39456,19728
20240704,과천선,인덕원,28313,29170,57483,28741.5
20240704,과천선,정부과천청사,14026,14633,28659,14329.5
20240704,과천선,과천,7364,6784,14148,7074
20240704,과천선,대공원,3917,3944,7861,3930.5
20240704,과천선,경마공원,1416,1403,2819,1409.5
20240704,과천선,선바위,8423,7524,15947,7973.5
20240704,공항철도 1호선,영종,4414,4510,8924,4462
20240704,공항철도 1호선,인천공항2터미널,6993,5631,12624,6312
20240704,공항철도 1호선,인천공항1터미널,15320,13472,28792,14396
20240704,공항철도 1호선,공항화물청사,2341,2501,4842,2421
20240704,공항철도 1호선,운서,9571,10023,19594,9797
20240704,공항철도 1호선,청라국제도시,8385,7995,16380,8190
20240704,공항철도 1호선,검암,7208,7420,14628,7314
20240704,공항철도 1호선,계양,14485,13794,28279,14139.5
20240704,공항철도 1호선,김포공항,10682,6134,16816,8408
20240704,공항철도 1호선,마곡나루(서울식물원),13819,13047,26866,13433
20240704,공항철도 1호선,디지털미디어시티,16747,15755,32502,16251
20240704,공항철도 1호선,홍대입구,14538,14587,29125,14562.5
20240704,공항철도 1호선,공덕,3276,4266,7542,3771
20240704,공항철도 1호선,서울역,13120,11428,24548,12274
20240704,경춘선,춘천,1247,1070,2317,1158.5
20240704,경춘선,남춘천,2454,2561,5015,2507.5
20240704,경춘선,김유정,350,356,706,353
20240704,경춘선,강촌,452,357,809,404.5
20240704,경춘선,백양리,66,120,186,93
20240704,경춘선,굴봉산,132,119,251,125.5
20240704,경춘선,가평,2310,2173,4483,2241.5
20240704,경춘선,상천,261,316,577,288.5
20240704,경춘선,청평,1934,1949,3883,1941.5
20240704,경춘선,대성리,846,814,1660,830
20240704,경춘선,마석,4012,3908,7920,3960
20240704,경춘선,천마산,1645,1483,3128,1564
20240704,경춘선,평내호평,6567,6346,12913,6456.5
20240704,경춘선,금곡,1550,1545,3095,1547.5
20240704,경춘선,사릉,2302,2197,4499,2249.5
20240704,경춘선,퇴계원,3986,3674,7660,3830
20240704,경춘선,별내,3853,3620,7473,3736.5
20240704,경춘선,갈매,3379,2918,6297,3148.5
20240704,경춘선,신내,3027,2770,5797,2898.5
20240704,경인선,도화,4638,4165,8803,4401.5
20240704,경인선,중동,10016,9481,19497,9748.5
20240704,경인선,온수(성공회대입구),6999,6652,13651,6825.5
20240704,경인선,도원,3794,3954,7748,3874
20240704,경인선,간석,6482,6206,12688,6344
20240704,경인선,부개,9508,8979,18487,9243.5
20240704,경인선,소사,8094,7688,15782,7891
20240704,경인선,구일,12191,13185,25376,12688
20240704,경인선,인천,3895,3080,6975,3487.5
20240704,경인선,동인천,14729,13744,28473,14236.5
20240704,경인선,제물포,11326,11051,22377,11188.5
20240704,경인선,주안,19692,17517,37209,18604.5
20240704,경인선,동암,16416,16617,33033,16516.5
20240704,경인선,백운,8104,7848,15952,7976
20240704,경인선,부평,29890,31409,61299,30649.5
20240704,경인선,송내,28724,28368,57092,28546
20240704,경인선,부천,32614,32246,64860,32430
20240704,경인선,역곡,27595,27574,55169,27584.5
20240704,경인선,오류동,12721,12143,24864,12432
20240704,경인선,개봉,23292,23153,46445,23222.5
20240704,경의선,운천,8,5,13,6.5
20240704,경의선,임진강,31,15,46,23
20240704,경의선,문산,5865,5761,11626,5813
20240704,경의선,파주,1316,976,2292,1146
20240704,경의선,월롱,2273,1929,4202,2101
20240704,경의선,금촌,6947,6704,13651,6825.5
20240704,경의선,금릉,6206,5971,12177,6088.5
20240704,경의선,운정,8695,8309,17004,8502
20240704,경의선,야당,9627,9709,19336,9668
20240704,경의선,탄현,8655,8373,17028,8514
20240704,경의선,일산,11747,11605,23352,11676
20240704,경의선,풍산,6873,6644,13517,6758.5
20240704,경의선,백마,8221,8011,16232,8116
20240704,경의선,곡산,764,797,1561,780.5
20240704,경의선,능곡,5227,5014,10241,5120.5
20240704,경의선,행신,8920,8895,17815,8907.5
20240704,경의선,강매,3839,3107,6946,3473
20240704,경의선,한국항공대,2261,2088,4349,2174.5
20240704,경의선,수색,4143,4291,8434,4217
20240704,경의선,디지털미디어시티,3044,2854,5898,2949
20240704,경의선,가좌,6529,6207,12736,6368
20240704,경의선,홍대입구,2170,2677,4847,2423.5
20240704,경의선,서강대,2391,2339,4730,2365
20240704,경의선,공덕,4668,3983,8651,4325.5
20240704,경의선,효창공원앞,3625,4063,7688,3844
20240704,경의선,신촌,1169,1487,2656,1328
20240704,경의선,서울역,5378,6492,11870,5935
20240704,경원선,연천,1183,1185,2368,1184
20240704,경원선,전곡,1166,1140,2306,1153
20240704,경원선,청산,173,139,312,156
20240704,경원선,소요산,1790,1726,3516,1758
20240704,경원선,동두천,1790,1776,3566,1783
20240704,경원선,보산,1971,1647,3618,1809
20240704,경원선,동두천중앙,3305,3185,6490,3245
20240704,경원선,지행,6820,6966,13786,6893
20240704,경원선,덕정,6335,6003,12338,6169
20240704,경원선,덕계,6416,5842,12258,6129
20240704,경원선,양주,7580,7391,14971,7485.5
20240704,경원선,녹양,4702,4446,9148,4574
20240704,경원선,가능,7089,6860,13949,6974.5
20240704,경원선,의정부,20049,20055,40104,20052
20240704,경원선,회룡,14299,14082,28381,14190.5
20240704,경원선,망월사,7909,8058,15967,7983.5
20240704,경원선,도봉산,8133,5202,13335,6667.5
20240704,경원선,도봉,6572,6180,12752,6376
20240704,경원선,방학,10953,10649,21602,10801
20240704,경원선,창동,2,0,2,1
20240704,경원선,녹천,5208,4405,9613,4806.5
20240704,경원선,월계,7472,7029,14501,7250.5
20240704,경원선,광운대,8576,8111,16687,8343.5
20240704,경원선,석계,8027,9336,17363,8681.5
20240704,경원선,신이문,9303,8609,17912,8956
20240704,경원선,외대앞,9726,9397,19123,9561.5
20240704,경원선,청량리(서울시립대입구),16270,17473,33743,16871.5
20240704,경원선,왕십리(성동구청),17744,17736,35480,17740
20240704,경원선,응봉,2069,1800,3869,1934.5
20240704,경원선,옥수,58,46,104,52
20240704,경원선,한남,4329,3968,8297,4148.5
20240704,경원선,서빙고,2386,2117,4503,2251.5
20240704,경원선,이촌(국립중앙박물관),4602,3518,8120,4060
20240704,경부선,광명,3788,3413,7201,3600.5
20240704,경부선,서동탄,1741,1428,3169,1584.5
20240704,경부선,당정,6614,6372,12986,6493
20240704,경부선,천안,5839,5898,11737,5868.5
20240704,경부선,두정,6834,6729,13563,6781.5
20240704,경부선,직산,1071,1069,2140,1070
20240704,경부선,성환,4012,3994,8006,4003
20240704,경부선,평택,12290,12378,24668,12334
20240704,경부선,평택지제,4323,4331,8654,4327
20240704,경부선,서정리,8635,7911,16546,8273
20240704,경부선,송탄,4813,4579,9392,4696
20240704,경부선,진위,1815,1645,3460,1730
20240704,경부선,오산,10141,10197,20338,10169
20240704,경부선,오산대,3900,3676,7576,3788
20240704,경부선,세마,3663,3493,7156,3578
20240704,경부선,병점,15341,15339,30680,15340
20240704,경부선,세류,3549,3288,6837,3418.5
20240704,경부선,독산,19476,20077,39553,19776.5
20240704,경부선,수원,36273,38056,74329,37164.5
20240704,경부선,화서,12527,12268,24795,12397.5
20240704,경부선,성균관대,16137,15828,31965,15982.5
20240704,경부선,의왕,9985,10002,19987,9993.5
20240704,경부선,군포,7814,7738,15552,7776
20240704,경부선,금정,30082,30384,60466,30233
20240704,경부선,명학,9671,9458,19129,9564.5
20240704,경부선,안양,22497,22188,44685,22342.5
20240704,경부선,관악,7969,7584,15553,7776.5
20240704,경부선,석수,9372,8722,18094,9047
20240704,경부선,금천구청,12240,12277,24517,12258.5
20240704,경부선,가산디지털단지,19932,22795,42727,21363.5
20240704,경부선,구로,18796,19100,37896,18948
20240704,경부선,신길,9536,8131,17667,8833.5
20240704,경부선,신도림,4375,4562,8937,4468.5
20240704,경부선,영등포,42419,42737,85156,42578
20240704,경부선,대방,11429,12460,23889,11944.5
20240704,경부선,노량진,8158,8108,16266,8133
20240704,경부선,용산,40074,41107,81181,40590.5
20240704,경부선,남영,10520,11099,21619,10809.5
20240704,경부선,서울역,8858,3289,12147,6073.5
20240704,경강선,성남,1006,971,1977,988.5
20240704,경강선,여주,2856,2815,5671,2835.5
20240704,경강선,세종대왕릉,334,342,676,338
20240704,경강선,부발,2197,2162,4359,2179.5
20240704,경강선,이천,3061,3139,6200,3100
20240704,경강선,신둔도예촌,1618,1501,3119,1559.5
20240704,경강선,곤지암,2283,2296,4579,2289.5
20240704,경강선,초월,3741,3566,7307,3653.5
20240704,경강선,경기광주,8620,8345,16965,8482.5
20240704,경강선,삼동,2885,2630,5515,2757.5
20240704,경강선,이매,1189,1096,2285,1142.5
20240704,경강선,판교,6258,6213,12471,6235.5
20240704,9호선2~3단계,중앙보훈병원,14130,12618,26748,13374
20240704,9호선2~3단계,둔촌오륜,1538,1504,3042,1521
20240704,9호선2~3단계,올림픽공원(한국체대),5798,5982,11780,5890
20240704,9호선2~3단계,한성백제,3522,3128,6650,3325
20240704,9호선2~3단계,송파나루,6258,6788,13046,6523
20240704,9호선2~3단계,석촌,10849,9529,20378,10189
20240704,9호선2~3단계,석촌고분,8081,7862,15943,7971.5
20240704,9호선2~3단계,삼전,9102,8610,17712,8856
20240704,9호선2~3단계,종합운동장,5412,5788,11200,5600
20240704,9호선2~3단계,봉은사,29355,32483,61838,30919
20240704,9호선2~3단계,삼성중앙,9615,9774,19389,9694.5
20240704,9호선2~3단계,선정릉,11430,12465,23895,11947.5
20240704,9호선2~3단계,언주,13498,13790,27288,13644
20240704,9호선,신논현,34828,34776,69604,34802
20240704,9호선,사평,4707,4598,9305,4652.5
20240704,9호선,고속터미널,15624,20263,35887,17943.5
20240704,9호선,신반포,4550,4470,9020,4510
20240704,9호선,구반포,1548,1411,2959,1479.5
20240704,9호선,동작(현충원),1961,1688,3649,1824.5
20240704,9호선,흑석(중앙대입구),9668,9933,19601,9800.5
20240704,9호선,노들,5428,4505,9933,4966.5
20240704,9호선,노량진,27028,26503,53531,26765.5
20240704,9호선,샛강,7516,7723,15239,7619.5
20240704,9호선,여의도,34652,33792,68444,34222
20240704,9호선,국회의사당,19370,20046,39416,19708
20240704,9호선,당산,21944,21524,43468,21734
20240704,9호선,선유도,10435,9951,20386,10193
20240704,9호선,신목동,5170,4600,9770,4885
20240704,9호선,염창,19887,19142,39029,19514.5
20240704,9호선,등촌,14025,13592,27617,13808.5
20240704,9호선,증미,9577,9326,18903,9451.5
20240704,9호선,가양,24865,24183,49048,24524
20240704,9호선,마곡나루(서울식물원),15812,15625,31437,15718.5
20240704,9호선,신방화,7952,7913,15865,7932.5
20240704,9호선,공항시장,3295,3573,6868,3434
20240704,9호선,김포공항,7353,10808,18161,9080.5
20240704,9호선,개화,3283,2169,5452,2726
20240704,8호선,남위례,8348,8311,16659,8329.5
20240704,8호선,모란,6707,5396,12103,6051.5
20240704,8호선,수진,6086,5580,11666,5833
20240704,8호선,신흥,5726,5977,11703,5851.5
20240704,8호선,단대오거리,13312,12867,26179,13089.5
20240704,8호선,남한산성입구(성남법원.검찰청),14569,12952,27521,13760.5
20240704,8호선,산성,7087,7280,14367,7183.5
20240704,8호선,복정,10351,8786,19137,9568.5
20240704,8호선,장지,19285,17758,37043,18521.5
20240704,8호선,문정,25428,26651,52079,26039.5
20240704,8호선,가락시장,8812,9633,18445,9222.5
20240704,8호선,송파,10914,10713,21627,10813.5
20240704,8호선,석촌,8963,10242,19205,9602.5
20240704,8호선,잠실(송파구청),17607,20387,37994,18997
20240704,8호선,몽촌토성(평화의문),7389,7646,15035,7517.5
20240704,8호선,강동구청,11884,12354,24238,12119
20240704,8호선,천호(풍납토성),16586,18687,35273,17636.5
20240704,8호선,암사,21173,18777,39950,19975
20240704,7호선,온수(성공회대입구),10899,9703,20602,10301
20240704,7호선,천왕,13209,12675,25884,12942
20240704,7호선,광명사거리,21819,21249,43068,21534
20240704,7호선,철산,23637,24271,47908,23954
20240704,7호선,가산디지털단지,51027,51657,102684,51342
20240704,7호선,남구로,16462,17359,33821,16910.5
20240704,7호선,대림(구로구청),9414,9517,18931,9465.5
20240704,7호선,신풍,12415,11535,23950,11975
20240704,7호선,보라매,7209,7492,14701,7350.5
20240704,7호선,신대방삼거리,16522,15910,32432,16216
20240704,7호선,장승배기,10319,10127,20446,10223
20240704,7호선,상도,12595,12166,24761,12380.5
20240704,7호선,숭실대입구(살피재),13877,13769,27646,13823
20240704,7호선,남성,12543,11910,24453,12226.5
20240704,7호선,이수,18377,17647,36024,18012
20240704,7호선,내방,16722,16850,33572,16786
20240704,7호선,고속터미널,17289,15451,32740,16370
20240704,7호선,반포,6996,6848,13844,6922
20240704,7호선,논현,20792,21720,42512,21256
20240704,7호선,학동,27181,28532,55713,27856.5
20240704,7호선,강남구청,18465,20486,38951,19475.5
20240704,7호선,청담,21378,23612,44990,22495
20240704,7호선,자양(뚝섬한강공원),9512,9371,18883,9441.5
20240704,7호선,건대입구,14356,14497,28853,14426.5
20240704,7호선,어린이대공원(세종대),15957,15571,31528,15764
20240704,7호선,군자(능동),16835,13416,30251,15125.5
20240704,7호선,중곡,12331,11520,23851,11925.5
20240704,7호선,용마산(용마폭포공원),6308,6168,12476,6238
20240704,7호선,사가정,17597,17727,35324,17662
20240704,7호선,면목,16195,15971,32166,16083
20240704,7호선,상봉,18991,17988,36979,18489.5
20240704,7호선,중화,11327,11259,22586,11293
20240704,7호선,먹골,11179,10998,22177,11088.5
20240704,7호선,태릉입구,9589,8914,18503,9251.5
20240704,7호선,공릉(서울과학기술대),13221,12984,26205,13102.5
20240704,7호선,하계,19915,18775,38690,19345
20240704,7호선,중계,16260,15006,31266,15633
20240704,7호선,노원,26709,27332,54041,27020.5
20240704,7호선,마들,14701,13874,28575,14287.5
20240704,7호선,수락산,13354,13281,26635,13317.5
20240704,7호선,도봉산,9550,11232,20782,10391
20240704,7호선,장암,3054,1256,4310,2155
20240704,6호선,봉화산(서울의료원),10082,9405,19487,9743.5
20240704,6호선,화랑대(서울여대입구),13177,10380,23557,11778.5
20240704,6호선,태릉입구,6069,6739,12808,6404
20240704,6호선,석계,13650,13916,27566,13783
20240704,6호선,돌곶이,11235,10218,21453,10726.5
20240704,6호선,상월곡(한국과학기술연구원),7660,7086,14746,7373
20240704,6호선,월곡(동덕여대),12837,12737,25574,12787
20240704,6호선,고려대(종암),9598,9156,18754,9377
20240704,6호선,안암(고대병원앞),12583,12544,25127,12563.5
20240704,6호선,보문,8813,8136,16949,8474.5
20240704,6호선,창신,3931,3264,7195,3597.5
20240704,6호선,동묘앞,8665,9026,17691,8845.5
20240704,6호선,신당,9261,9762,19023,9511.5
20240704,6호선,청구,4316,4338,8654,4327
20240704,6호선,약수,4094,4088,8182,4091
20240704,6호선,버티고개,2313,2364,4677,2338.5
20240704,6호선,한강진,11262,12996,24258,12129
20240704,6호선,이태원,11105,12284,23389,11694.5
20240704,6호선,녹사평(용산구청),5662,5531,11193,5596.5
20240704,6호선,삼각지,8496,7529,16025,8012.5
20240704,6호선,효창공원앞,8237,7504,15741,7870.5
20240704,6호선,공덕,21565,20948,42513,21256.5
20240704,6호선,대흥(서강대앞),10270,10664,20934,10467
20240704,6호선,광흥창(서강),10574,10355,20929,10464.5
20240704,6호선,상수,10456,11253,21709,10854.5
20240704,6호선,합정,14507,14037,28544,14272
20240704,6호선,망원,16091,17156,33247,16623.5
20240704,6호선,마포구청,16142,14696,30838,15419
20240704,6호선,월드컵경기장(성산),4877,4839,9716,4858
20240704,6호선,디지털미디어시티,16631,18307,34938,17469
20240704,6호선,증산(명지대앞),10766,10831,21597,10798.5
20240704,6호선,새절(신사),14287,13077,27364,13682
20240704,6호선,구산,9402,7096,16498,8249
20240704,6호선,연신내,2,0,2,1
20240704,6호선,독바위,3148,3349,6497,3248.5
20240704,6호선,불광,5254,5022,10276,5138
20240704,6호선,역촌,4258,4856,9114,4557
20240704,6호선,응암,19460,19407,38867,19433.5
20240704,5호선,하남검단산,7451,7023,14474,7237
20240704,5호선,하남시청(덕풍·신장),9480,9093,18573,9286.5
20240704,5호선,하남풍산,5175,5137,10312,5156
20240704,5호선,미사,20178,20465,40643,20321.5
20240704,5호선,강일,6852,6386,13238,6619
20240704,5호선,마천,8486,7597,16083,8041.5
20240704,5호선,거여,11416,11247,22663,11331.5
20240704,5호선,개롱,7601,7723,15324,7662
20240704,5호선,오금,4290,4395,8685,4342.5
20240704,5호선,방이,8350,8663,17013,8506.5
20240704,5호선,올림픽공원(한국체대),6228,4901,11129,5564.5
20240704,5호선,둔촌동,9862,9983,19845,9922.5
20240704,5호선,상일동,16866,15942,32808,16404
20240704,5호선,고덕,12800,12263,25063,12531.5
20240704,5호선,명일,9915,10198,20113,10056.5
20240704,5호선,굽은다리(강동구민회관앞),11435,10777,22212,11106
20240704,5호선,길동,9110,9327,18437,9218.5
20240704,5호선,강동,20170,19767,39937,19968.5
20240704,5호선,천호(풍납토성),20940,20836,41776,20888
20240704,5호선,광나루(장신대),14868,13646,28514,14257
20240704,5호선,아차산(어린이대공원후문),15880,15308,31188,15594
20240704,5호선,군자(능동),12494,13868,26362,13181
20240704,5호선,장한평,21764,21680,43444,21722
20240704,5호선,답십리,17988,16386,34374,17187
20240704,5호선,마장,6570,6122,12692,6346
20240704,5호선,왕십리(성동구청),5038,5859,10897,5448.5
20240704,5호선,행당,9008,8048,17056,8528
20240704,5호선,신금호,7367,7816,15183,7591.5
20240704,5호선,청구,4401,4119,8520,4260
20240704,5호선,동대문역사문화공원(DDP),3467,4304,7771,3885.5
20240704,5호선,을지로4가,7396,7443,14839,7419.5
20240704,5호선,종로3가,16746,17040,33786,16893
20240704,5호선,광화문(세종문화회관),36497,38756,75253,37626.5
20240704,5호선,서대문,24380,24527,48907,24453.5
20240704,5호선,충정로(경기대입구),5412,5643,11055,5527.5
20240704,5호선,애오개,7897,7809,15706,7853
20240704,5호선,공덕,16764,17738,34502,17251
20240704,5호선,마포,16514,16909,33423,16711.5
20240704,5호선,여의나루,12983,14649,27632,13816
20240704,5호선,여의도,33705,35238,68943,34471.5
20240704,5호선,신길,5481,5644,11125,5562.5
20240704,5호선,영등포시장,12547,12848,25395,12697.5
20240704,5호선,영등포구청,5445,5364,10809,5404.5
20240704,5호선,양평,8689,8578,17267,8633.5
20240704,5호선,오목교(목동운동장앞),23724,24791,48515,24257.5
20240704,5호선,목동,18613,19781,38394,19197
20240704,5호선,신정(은행정),14765,12343,27108,13554
20240704,5호선,까치산,30339,29341,59680,29840
20240704,5호선,화곡,31112,29178,60290,30145
20240704,5호선,우장산,16391,16317,32708,16354
20240704,5호선,발산,25191,25679,50870,25435
20240704,5호선,마곡,14126,14220,28346,14173
20240704,5호선,송정,7075,6448,13523,6761.5
20240704,5호선,김포공항,11537,8402,19939,9969.5
20240704,5호선,개화산,6800,6441,13241,6620.5
20240704,5호선,방화,7867,7571,15438,7719
20240704,4호선,남태령,1587,1480,3067,1533.5
20240704,4호선,사당,28072,24527,52599,26299.5
20240704,4호선,총신대입구(이수),21004,22817,43821,21910.5
20240704,4호선,동작(현충원),1571,1710,3281,1640.5
20240704,4호선,이촌(국립중앙박물관),9453,10528,19981,9990.5
20240704,4호선,신용산,21440,23036,44476,22238
20240704,4호선,삼각지,6962,7704,14666,7333
20240704,4호선,숙대입구(갈월),15636,15258,30894,15447
20240704,4호선,서울역,14384,22873,37257,18628.5
20240704,4호선,회현(남대문시장),30688,32187,62875,31437.5
20240704,4호선,명동,32886,35219,68105,34052.5
20240704,4호선,충무로,33534,34805,68339,34169.5
20240704,4호선,동대문역사문화공원(DDP),20508,17824,38332,19166
20240704,4호선,동대문,22560,22816,45376,22688
20240704,4호선,혜화,37140,37278,74418,37209
20240704,4호선,한성대입구(삼선교),14498,14028,28526,14263
20240704,4호선,성신여대입구(돈암),22429,21610,44039,22019.5
20240704,4호선,길음,23440,22999,46439,23219.5
20240704,4호선,미아사거리,29189,28724,57913,28956.5
20240704,4호선,미아(서울사이버대학),16617,15927,32544,16272
20240704,4호선,수유(강북구청),36031,36404,72435,36217.5
20240704,4호선,쌍문,31943,29657,61600,30800
20240704,4호선,창동,28832,30141,58973,29486.5
20240704,4호선,노원,31093,34505,65598,32799
20240704,4호선,상계,21282,19940,41222,20611
20240704,4호선,당고개,10454,8957,19411,9705.5
20240704,3호선,경찰병원,8657,8729,17386,8693
20240704,3호선,가락시장,10361,10067,20428,10214
20240704,3호선,수서,19965,19921,39886,19943
20240704,3호선,일원,12604,12236,24840,12420
20240704,수인선,오목천,4308,3804,8112,4056
20240704,3호선,대청,12738,11849,24587,12293.5
20240704,3호선,학여울,2442,2552,4994,2497
20240704,3호선,대치,12858,12895,25753,12876.5
20240704,3호선,도곡,6821,6733,13554,6777
20240704,3호선,매봉,14791,14196,28987,14493.5
20240704,3호선,양재(서초구청),42737,45929,88666,44333
20240704,3호선,남부터미널(예술의전당),32384,33068,65452,32726
20240704,3호선,교대(법원.검찰청),19585,11676,31261,15630.5
20240704,3호선,고속터미널,47332,43983,91315,45657.5
20240704,3호선,잠원,5745,5529,11274,5637
20240704,3호선,신사,30861,32259,63120,31560
20240704,3호선,압구정,34711,37117,71828,35914
20240704,3호선,옥수,9763,10069,19832,9916
20240704,3호선,금호,8967,8314,17281,8640.5
20240704,3호선,약수,14352,13823,28175,14087.5
20240704,3호선,동대입구,10840,12035,22875,11437.5
20240704,3호선,충무로,8,0,8,4
20240704,3호선,을지로3가,13361,13307,26668,13334
20240704,3호선,종로3가,12364,12913,25277,12638.5
20240704,3호선,안국,28949,30018,58967,29483.5
20240704,3호선,경복궁(정부서울청사),25920,26074,51994,25997
20240704,3호선,독립문,8246,8441,16687,8343.5
20240704,3호선,무악재,5070,4916,9986,4993
20240704,3호선,홍제,19581,18562,38143,19071.5
20240704,3호선,녹번,17119,15786,32905,16452.5
20240704,3호선,불광,18267,19439,37706,18853
20240704,3호선,연신내,37435,35538,72973,36486.5
20240704,3호선,구파발,24875,23710,48585,24292.5
20240704,3호선,지축,8613,8403,17016,8508
20240704,2호선,용두(동대문구청),2808,2895,5703,2851.5
20240704,2호선,신정네거리,10972,11583,22555,11277.5
20240704,2호선,양천구청,7809,8250,16059,8029.5
20240704,2호선,도림천,1529,1723,3252,1626
20240704,2호선,신설동,3764,3627,7391,3695.5
20240704,2호선,신답,1932,2046,3978,1989
20240704,2호선,충정로(경기대입구),12039,12461,24500,12250
20240704,2호선,아현,12171,11569,23740,11870
20240704,2호선,이대,17251,18833,36084,18042
20240704,2호선,신촌,40404,40950,81354,40677
20240704,2호선,홍대입구,72005,76611,148616,74308
20240704,2호선,합정,34583,36807,71390,35695
20240704,2호선,당산,19743,23014,42757,21378.5
20240704,2호선,영등포구청,25186,25867,51053,25526.5
20240704,2호선,문래,26017,26740,52757,26378.5
20240704,2호선,신도림,55303,53648,108951,54475.5
20240704,2호선,대림(구로구청),25976,26281,52257,26128.5
20240704,2호선,구로디지털단지,63565,63261,126826,63413
20240704,2호선,신대방,27292,26438,53730,26865
20240704,2호선,신림,59073,57014,116087,58043.5
20240704,2호선,봉천,27025,25453,52478,26239
20240704,2호선,서울대입구(관악구청),50294,48992,99286,49643
20240704,2호선,낙성대(강감찬),30675,29736,60411,30205.5
20240704,2호선,사당,44222,48157,92379,46189.5
20240704,2호선,방배,17563,18013,35576,17788
20240704,2호선,서초,24731,24230,48961,24480.5
20240704,2호선,교대(법원.검찰청),35754,42981,78735,39367.5
20240704,2호선,강남,93044,89815,182859,91429.5
20240704,2호선,역삼,60941,69576,130517,65258.5
20240704,2호선,선릉,67897,59829,127726,63863
20240704,2호선,삼성(무역센터),72127,72058,144185,72092.5
20240704,2호선,종합운동장,21110,22251,43361,21680.5
20240704,2호선,잠실새내,26685,26004,52689,26344.5
20240704,2호선,잠실(송파구청),84475,84282,168757,84378.5
20240704,2호선,잠실나루,17947,17319,35266,17633
20240704,2호선,강변(동서울터미널),31369,29726,61095,30547.5
20240704,2호선,구의(광진구청),27949,27041,54990,27495
20240704,2호선,건대입구,37467,39207,76674,38337
20240704,2호선,성수,46811,50871,97682,48841
20240704,2호선,뚝섬,27200,28606,55806,27903
20240704,2호선,한양대,11092,11832,22924,11462
20240704,2호선,왕십리(성동구청),17394,15355,32749,16374.5
20240704,2호선,상왕십리,16166,16193,32359,16179.5
20240704,2호선,신당,16155,16623,32778,16389
20240704,2호선,동대문역사문화공원(DDP),15353,17865,33218,16609
20240704,2호선,을지로4가,16038,15811,31849,15924.5
20240704,2호선,을지로3가,28249,27959,56208,28104
20240704,2호선,을지로입구,55328,57029,112357,56178.5
20240704,2호선,시청,30651,29444,60095,30047.5
20240704,1호선,동묘앞,9704,9761,19465,9732.5
20240704,1호선,청량리(서울시립대입구),24355,23850,48205,24102.5
20240704,1호선,제기동,18163,18320,36483,18241.5
20240704,1호선,신설동,15339,15080,30419,15209.5
20240704,1호선,동대문,11858,11590,23448,11724
20240704,1호선,종로5가,26030,25743,51773,25886.5
20240704,1호선,종로3가,27925,25540,53465,26732.5
20240704,1호선,종각,44740,44310,89050,44525
20240704,1호선,시청,29135,29101,58236,29118
20240704,1호선,서울역,58303,54138,112441,56220.5
20240704,중앙선,지평,67,89,156,78
20240704,우이신설선,북한산보국문,6612,6418,13030,6515
20240704,우이신설선,솔샘,6798,6358,13156,6578
20240704,우이신설선,삼양사거리,2873,2991,5864,2932
20240704,우이신설선,삼양,2292,2420,4712,2356
20240704,우이신설선,화계,3870,3736,7606,3803
20240704,우이신설선,가오리,4876,4874,9750,4875
20240704,우이신설선,4.19민주묘지,3403,3176,6579,3289.5
20240704,우이신설선,솔밭공원,2960,2877,5837,2918.5
20240704,3호선,오금,7655,6750,14405,7202.5
20240704,수인선,어천,1486,1396,2882,1441
20240704,분당선,이매,6692,6260,12952,6476
20240704,분당선,보정,2886,2702,5588,2794
20240704,분당선,죽전,14142,15505,29647,14823.5
20240704,분당선,구성,7107,7176,14283,7141.5
20240704,우이신설선,북한산우이,3105,2754,5859,2929.5
20240704,안산선,수리산,4533,3816,8349,4174.5
20240704,안산선,오이도,8224,8152,16376,8188
20240704,안산선,정왕,9097,9440,18537,9268.5
20240704,안산선,신길온천,2129,2003,4132,2066
20240704,안산선,안산,12373,11334,23707,11853.5
20240704,안산선,초지,5425,5446,10871,5435.5
20240704,안산선,고잔,9550,9134,18684,9342
20240704,안산선,중앙,19144,19903,39047,19523.5
20240704,안산선,한대앞,9936,10098,20034,10017
20240704,안산선,상록수,15615,16028,31643,15821.5
20240704,안산선,반월,4751,4690,9441,4720.5
20240704,안산선,대야미,5519,4966,10485,5242.5
20240704,안산선,산본,17897,18669,36566,18283
20240704,신림선,관악산(서울대),3294,3272,6566,3283
20240704,신림선,서울대벤처타운,10460,9597,20057,10028.5
20240704,신림선,서원,3839,3464,7303,3651.5
20240704,신림선,신림,2118,2794,4912,2456
20240704,신림선,당곡,5496,5424,10920,5460
20240704,신림선,보라매병원,8726,9195,17921,8960.5
20240704,신림선,보라매공원,2674,2822,5496,2748
20240704,신림선,보라매,4676,4282,8958,4479
20240704,신림선,서울지방병무청,3601,3904,7505,3752.5
20240704,신림선,대방,3255,2517,5772,2886
20240704,신림선,샛강,3461,3904,7365,3682.5
20240704,수인선,인천,1181,1774,2955,1477.5
20240704,수인선,신포,2023,2050,4073,2036.5
20240704,수인선,숭의,4510,4263,8773,4386.5
20240704,수인선,인하대,6984,6517,13501,6750.5
20240704,수인선,송도,2638,2383,5021,2510.5
20240704,수인선,연수,5040,4929,9969,4984.5
20240704,수인선,원인재,4748,4959,9707,4853.5
20240704,수인선,남동인더스파크,2580,2906,5486,2743
20240704,수인선,호구포,4364,4499,8863,4431.5
20240704,수인선,인천논현,5902,6294,12196,6098
20240704,수인선,소래포구,5121,4681,9802,4901
20240704,수인선,월곶,3585,3250,6835,3417.5
20240704,수인선,달월,129,74,203,101.5
20240704,수인선,사리,5715,4913,10628,5314
20240704,수인선,야목,489,399,888,444
20240704,분당선,오리,13012,11353,24365,12182.5
20240704,분당선,미금,16895,17394,34289,17144.5
20240704,분당선,정자,20759,21809,42568,21284
20240704,분당선,수내,16013,16380,32393,16196.5
20240704,분당선,서현,27098,27575,54673,27336.5
20240704,분당선,야탑,28312,29967,58279,29139.5
20240704,분당선,모란,26365,26992,53357,26678.5
20240704,분당선,태평,14522,13935,28457,14228.5
20240704,분당선,가천대,8378,8639,17017,8508.5
20240704,분당선,선정릉,8993,9400,18393,9196.5
20240704,분당선,강남구청,11169,12873,24042,12021
20240704,분당선,압구정로데오,20420,22365,42785,21392.5
20240704,분당선,서울숲,13637,13870,27507,13753.5
20240704,수인선,고색,6036,5578,11614,5807
20240704,2호선,용답,3120,3136,6256,3128
20240704,우이신설선,정릉,5059,4804,9863,4931.5
20240704,우이신설선,성신여대입구(돈암),3839,4153,7992,3996
20240704,우이신설선,보문,1762,1804,3566,1783
20240704,우이신설선,신설동,2654,2526,5180,2590
20240704,일산선,원흥,12928,12321,25249,12624.5
20240704,일산선,지축,1,0,1,0.5
20240704,일산선,삼송,21201,20477,41678,20839
20240704,일산선,원당,12303,11921,24224,12112
20240704,일산선,화정,19452,19876,39328,19664
20240704,일산선,대곡,3340,2523,5863,2931.5
20240704,일산선,백석,11144,11136,22280,11140
20240704,일산선,마두,9057,9329,18386,9193
20240704,일산선,정발산,7932,7969,15901,7950.5
20240704,일산선,주엽,10965,11140,22105,11052.5
20240704,일산선,대화,21956,19050,41006,20503
20240704,장항선,봉명,1664,1584,3248,1624
20240704,장항선,쌍용(나사렛대),2613,2508,5121,2560.5
20240704,장항선,아산,3607,3450,7057,3528.5
20240704,장항선,탕정,1806,1678,3484,1742
20240704,장항선,배방,1298,1240,2538,1269
20240704,장항선,온양온천,5661,5617,11278,5639
20240704,장항선,신창(순천향대),1308,1245,2553,1276.5
20240704,중앙선,회기,26722,25287,52009,26004.5
20240704,중앙선,중랑,6001,5772,11773,5886.5
20240704,중앙선,상봉,6253,6247,12500,6250
20240704,중앙선,망우,8140,8001,16141,8070.5
20240704,중앙선,양원,3669,3587,7256,3628
20240704,중앙선,구리,14168,14365,28533,14266.5
20240704,중앙선,도농,12256,11248,23504,11752
20240704,중앙선,양정,642,518,1160,580
20240704,중앙선,덕소,5689,5730,11419,5709.5
20240704,중앙선,도심,2647,2158,4805,2402.5
20240704,중앙선,팔당,929,926,1855,927.5
20240704,중앙선,운길산,744,722,1466,733
20240704,중앙선,양수,2266,2302,4568,2284
20240704,중앙선,신원,219,191,410,205
20240704,중앙선,국수,751,772,1523,761.5
20240704,중앙선,아신,596,588,1184,592
20240704,중앙선,오빈,353,349,702,351
20240704,중앙선,양평,3297,3398,6695,3347.5
20240704,중앙선,원덕,414,353,767,383.5
20240704,중앙선,용문,1923,1901,3824,1912
20240704,서해선,부천종합운동장,2804,2324,5128,2564
20240704,서해선,원종,5187,5229,10416,5208
20240704,서해선,김포공항,3195,3970,7165,3582.5
20240704,분당선,매교,6129,6022,12151,6075.5
20240704,분당선,수원시청,14702,15835,30537,15268.5
20240704,분당선,매탄권선,6083,5919,12002,6001
20240704,분당선,망포,17361,16622,33983,16991.5
20240704,분당선,영통,9491,9702,19193,9596.5
20240704,분당선,청명,5070,4805,9875,4937.5
20240705,경의선,수색,3823,3929,7752,3876
20240705,경의선,한국항공대,2312,2139,4451,2225.5
20240705,분당선,상갈,6024,5801,11825,5912.5
20240705,분당선,청명,5649,5029,10678,5339
20240705,분당선,영통,11059,10806,21865,10932.5
20240705,분당선,망포,18588,17340,35928,17964
20240705,분당선,매탄권선,6647,6222,12869,6434.5
20240705,분당선,수원시청,16024,18620,34644,17322
20240705,분당선,매교,6166,6158,12324,6162
20240705,서해선,김포공항,3440,4127,7567,3783.5
20240705,서해선,원종,5415,5422,10837,5418.5
20240705,서해선,부천종합운동장,2992,2404,5396,2698
20240705,수인선,고색,6470,5758,12228,6114
20240705,수인선,오목천,4885,4016,8901,4450.5
20240705,수인선,어천,1633,1456,3089,1544.5
20240705,수인선,야목,482,409,891,445.5
20240705,수인선,사리,6072,4999,11071,5535.5
20240705,수인선,달월,101,70,171,85.5
20240705,수인선,월곶,3262,2988,6250,3125
20240705,수인선,소래포구,5266,4961,10227,5113.5
20240705,수인선,인천논현,6425,6888,13313,6656.5
20240705,수인선,호구포,4475,4516,8991,4495.5
20240705,수인선,남동인더스파크,2518,2880,5398,2699
20240705,수인선,원인재,5063,5062,10125,5062.5
20240705,수인선,연수,5514,5602,11116,5558
20240705,수인선,송도,2881,2579,5460,2730
20240705,수인선,인하대,7286,6855,14141,7070.5
20240705,수인선,숭의,4818,4427,9245,4622.5
20240705,수인선,신포,2260,2279,4539,2269.5
20240705,수인선,인천,1109,1757,2866,1433
20240705,신림선,샛강,3178,3771,6949,3474.5
20240705,신림선,대방,3441,2594,6035,3017.5
20240705,신림선,서울지방병무청,3620,3810,7430,3715
20240705,신림선,보라매,4751,4270,9021,4510.5
20240705,신림선,보라매공원,2573,2783,5356,2678
20240705,신림선,보라매병원,8033,8382,16415,8207.5
20240705,신림선,당곡,5451,5217,10668,5334
20240705,신림선,신림,2191,2914,5105,2552.5
20240705,신림선,서원,3930,3223,7153,3576.5
20240705,신림선,서울대벤처타운,10683,9344,20027,10013.5
20240705,신림선,관악산(서울대),3139,3065,6204,3102
20240705,안산선,산본,18648,19915,38563,19281.5
20240705,안산선,대야미,5764,4973,10737,5368.5
20240705,안산선,반월,4925,4729,9654,4827
20240705,안산선,상록수,16391,16552,32943,16471.5
20240705,안산선,한대앞,10528,10516,21044,10522
20240705,안산선,중앙,20871,22429,43300,21650
20240705,안산선,고잔,9767,9427,19194,9597
20240705,안산선,초지,5554,5563,11117,5558.5
20240705,안산선,안산,13132,12198,25330,12665
20240705,안산선,신길온천,2191,2097,4288,2144
20240705,안산선,정왕,10038,9964,20002,10001
20240705,중앙선,양정,598,559,1157,578.5
20240705,중앙선,도농,12469,11447,23916,11958
20240705,중앙선,구리,15076,15062,30138,15069
20240705,안산선,오이도,8714,8897,17611,8805.5
20240705,안산선,수리산,4660,3772,8432,4216
20240705,우이신설선,북한산우이,3132,2816,5948,2974
20240705,우이신설선,솔밭공원,2992,2805,5797,2898.5
20240705,우이신설선,4.19민주묘지,3352,3129,6481,3240.5
20240705,우이신설선,가오리,4886,4784,9670,4835
20240705,중앙선,양원,3716,3420,7136,3568
20240705,우이신설선,화계,3958,3752,7710,3855
20240705,우이신설선,삼양,2303,2370,4673,2336.5
20240705,우이신설선,삼양사거리,2917,2928,5845,2922.5
20240705,우이신설선,솔샘,6676,6178,12854,6427
20240705,우이신설선,북한산보국문,6908,6399,13307,6653.5
20240705,우이신설선,정릉,5291,4792,10083,5041.5
20240705,우이신설선,성신여대입구(돈암),4179,4584,8763,4381.5
20240705,우이신설선,보문,1794,1767,3561,1780.5
20240705,우이신설선,신설동,2671,2540,5211,2605.5
20240705,일산선,원흥,13141,12387,25528,12764
20240705,일산선,지축,1,0,1,0.5
20240705,일산선,삼송,21959,20952,42911,21455.5
20240705,일산선,원당,12485,11686,24171,12085.5
20240705,일산선,화정,19534,20163,39697,19848.5
20240705,일산선,대곡,3458,2712,6170,3085
20240705,일산선,백석,11626,11788,23414,11707
20240705,일산선,마두,9070,9425,18495,9247.5
20240705,일산선,정발산,8628,9148,17776,8888
20240705,일산선,주엽,11132,11368,22500,11250
20240705,일산선,대화,17695,14697,32392,16196
20240705,장항선,봉명,1607,1501,3108,1554
20240705,장항선,쌍용(나사렛대),2803,2471,5274,2637
20240705,장항선,아산,4308,4420,8728,4364
20240705,장항선,탕정,2120,1902,4022,2011
20240705,장항선,배방,1559,1495,3054,1527
20240705,장항선,온양온천,4779,4811,9590,4795
20240705,장항선,신창(순천향대),1683,1415,3098,1549
20240705,중앙선,회기,28021,26028,54049,27024.5
20240705,중앙선,중랑,6087,5820,11907,5953.5
20240705,중앙선,상봉,6756,6548,13304,6652
20240705,중앙선,망우,8755,8393,17148,8574
20240705,경의선,강매,3755,3097,6852,3426
20240705,경의선,행신,9268,9243,18511,9255.5
20240705,경의선,능곡,5362,5038,10400,5200
20240705,경의선,곡산,735,787,1522,761
20240705,경의선,백마,8540,8307,16847,8423.5
20240705,경의선,풍산,6971,6567,13538,6769
20240705,경의선,일산,12222,12090,24312,12156
20240705,경의선,탄현,8949,8683,17632,8816
20240705,경의선,야당,10471,11127,21598,10799
20240705,경의선,운정,8966,8405,17371,8685.5
20240705,경의선,금릉,6378,6113,12491,6245.5
20240705,경의선,금촌,7575,7346,14921,7460.5
20240705,경의선,월롱,2572,1811,4383,2191.5
20240705,경의선,파주,1456,981,2437,1218.5
20240705,경의선,문산,6104,6166,12270,6135
20240705,경의선,임진강,20,10,30,15
20240705,경의선,운천,3,2,5,2.5
20240705,경인선,개봉,23810,23221,47031,23515.5
20240705,경인선,오류동,12815,11802,24617,12308.5
20240705,경인선,역곡,28396,28193,56589,28294.5
20240705,경인선,부천,34636,35187,69823,34911.5
20240705,경인선,송내,29212,28891,58103,29051.5
20240705,경인선,부평,32445,36044,68489,34244.5
20240705,경인선,백운,8398,8099,16497,8248.5
20240705,경인선,동암,17292,17690,34982,17491
20240705,경인선,주안,20698,18562,39260,19630
20240705,경인선,제물포,11916,11308,23224,11612
20240705,경인선,동인천,15650,14545,30195,15097.5
20240705,경인선,인천,4168,3323,7491,3745.5
20240705,경인선,구일,7081,6901,13982,6991
20240705,경인선,소사,8135,7740,15875,7937.5
20240705,경인선,부개,10006,9193,19199,9599.5
20240705,경인선,간석,6669,6295,12964,6482
20240705,경인선,도원,6887,7123,14010,7005
20240705,경인선,온수(성공회대입구),7200,6766,13966,6983
20240705,경인선,중동,10290,9621,19911,9955.5
20240705,경인선,도화,4781,4431,9212,4606
20240705,경춘선,신내,3064,2771,5835,2917.5
20240705,경춘선,갈매,3437,3056,6493,3246.5
20240705,경춘선,별내,4041,3828,7869,3934.5
20240705,경춘선,퇴계원,3941,3712,7653,3826.5
20240705,경춘선,사릉,2350,2281,4631,2315.5
20240705,경춘선,금곡,1647,1580,3227,1613.5
20240705,경춘선,평내호평,6837,6839,13676,6838
20240705,경춘선,천마산,1585,1488,3073,1536.5
20240705,경춘선,마석,4177,4126,8303,4151.5
20240705,경춘선,대성리,760,1178,1938,969
20240705,경춘선,청평,1985,2215,4200,2100
20240705,경춘선,상천,310,275,585,292.5
20240705,경춘선,가평,2399,2532,4931,2465.5
20240705,경춘선,굴봉산,116,154,270,135
20240705,2호선,을지로입구,55568,57430,112998,56499
20240705,경춘선,백양리,88,65,153,76.5
20240705,경춘선,강촌,329,437,766,383
20240705,경춘선,김유정,383,410,793,396.5
20240705,경춘선,남춘천,2910,2945,5855,2927.5
20240705,경춘선,춘천,1492,1404,2896,1448
20240705,공항철도 1호선,서울역,15569,13949,29518,14759
20240705,공항철도 1호선,공덕,3470,4541,8011,4005.5
20240705,공항철도 1호선,홍대입구,16751,16713,33464,16732
20240705,공항철도 1호선,디지털미디어시티,15876,14799,30675,15337.5
20240705,공항철도 1호선,마곡나루(서울식물원),14266,13099,27365,13682.5
20240705,공항철도 1호선,김포공항,11071,6113,17184,8592
20240705,공항철도 1호선,계양,14883,13999,28882,14441
20240705,공항철도 1호선,검암,7160,7472,14632,7316
20240705,공항철도 1호선,청라국제도시,8650,8217,16867,8433.5
20240705,공항철도 1호선,운서,10297,10496,20793,10396.5
20240705,공항철도 1호선,공항화물청사,2279,2451,4730,2365
20240705,공항철도 1호선,인천공항1터미널,16472,13863,30335,15167.5
20240705,공항철도 1호선,인천공항2터미널,7603,6017,13620,6810
20240705,공항철도 1호선,영종,4444,4723,9167,4583.5
20240705,과천선,선바위,8800,7558,16358,8179
20240705,과천선,경마공원,7705,7747,15452,7726
20240705,과천선,대공원,3485,3613,7098,3549
20240705,과천선,과천,7389,6737,14126,7063
20240705,과천선,정부과천청사,14374,14720,29094,14547
20240705,과천선,인덕원,28914,29310,58224,29112
20240705,과천선,평촌,19793,19198,38991,19495.5
20240705,과천선,범계,31156,31625,62781,31390.5
20240705,분당선,선릉,14797,23016,37813,18906.5
20240705,분당선,한티,17565,18408,35973,17986.5
20240705,분당선,도곡,9053,8735,17788,8894
20240705,분당선,구룡,4379,4079,8458,4229
20240705,분당선,개포동,5378,5415,10793,5396.5
20240705,분당선,대모산입구,6951,6289,13240,6620
20240705,분당선,수서,19244,20634,39878,19939
20240705,분당선,복정,5,0,5,2.5
20240705,분당선,수원,9326,8659,17985,8992.5
20240705,분당선,서울숲,14225,14451,28676,14338
20240705,분당선,압구정로데오,22267,25795,48062,24031
20240705,분당선,강남구청,10929,12710,23639,11819.5
20240705,분당선,선정릉,8749,9238,17987,8993.5
20240705,분당선,가천대,8470,8225,16695,8347.5
20240705,분당선,태평,14604,13601,28205,14102.5
20240705,분당선,모란,21762,22286,44048,22024
20240705,분당선,야탑,28488,30362,58850,29425
20240705,분당선,서현,29215,30032,59247,29623.5
20240705,2호선,시청,30390,29633,60023,30011.5
20240705,1호선,동묘앞,9634,9990,19624,9812
20240705,1호선,청량리(서울시립대입구),25185,24472,49657,24828.5
20240705,1호선,제기동,18026,18054,36080,18040
20240705,1호선,신설동,15959,15494,31453,15726.5
20240705,1호선,동대문,12279,11167,23446,11723
20240705,1호선,종로5가,25656,25446,51102,25551
20240705,중앙선,팔당,1009,1107,2116,1058
20240705,중앙선,도심,2687,2173,4860,2430
20240705,중앙선,덕소,5839,5762,11601,5800.5
20240705,2호선,을지로3가,29090,29415,58505,29252.5
20240705,2호선,을지로4가,16149,16476,32625,16312.5
20240705,2호선,동대문역사문화공원(DDP),16445,18102,34547,17273.5
20240705,2호선,신당,16903,17324,34227,17113.5
20240705,2호선,상왕십리,16567,16186,32753,16376.5
20240705,2호선,왕십리(성동구청),17708,16655,34363,17181.5
20240705,2호선,한양대,11158,11665,22823,11411.5
20240705,2호선,뚝섬,28027,29711,57738,28869
20240705,2호선,성수,48527,53450,101977,50988.5
20240705,2호선,건대입구,40574,44010,84584,42292
20240705,2호선,구의(광진구청),28156,26864,55020,27510
20240705,2호선,강변(동서울터미널),34118,33756,67874,33937
20240705,2호선,잠실나루,17532,16718,34250,17125
20240705,2호선,잠실(송파구청),87685,87140,174825,87412.5
20240705,분당선,수내,16023,16036,32059,16029.5
20240705,분당선,정자,21301,22191,43492,21746
20240705,분당선,미금,17285,17892,35177,17588.5
20240705,분당선,오리,13280,11263,24543,12271.5
20240705,분당선,이매,6955,6335,13290,6645
20240705,분당선,보정,3152,2725,5877,2938.5
20240705,2호선,잠실새내,27077,26568,53645,26822.5
20240705,2호선,종합운동장,8500,8942,17442,8721
20240705,2호선,삼성(무역센터),72022,72068,144090,72045
20240705,2호선,선릉,66551,58480,125031,62515.5
20240705,2호선,역삼,57177,65549,122726,61363
20240705,2호선,강남,96391,95574,191965,95982.5
20240705,2호선,교대(법원.검찰청),36423,44001,80424,40212
20240705,2호선,서초,23646,23054,46700,23350
20240705,분당선,죽전,14794,16245,31039,15519.5
20240705,분당선,구성,7352,7423,14775,7387.5
20240705,2호선,방배,17438,17968,35406,17703
20240705,2호선,사당,46865,51274,98139,49069.5
20240705,2호선,낙성대(강감찬),31522,29303,60825,30412.5
20240705,2호선,서울대입구(관악구청),52844,50264,103108,51554
20240705,2호선,봉천,27490,25085,52575,26287.5
20240705,2호선,신림,61253,58648,119901,59950.5
20240705,2호선,신대방,28178,26640,54818,27409
20240705,2호선,구로디지털단지,64640,64264,128904,64452
20240705,2호선,대림(구로구청),26845,27141,53986,26993
20240705,2호선,신도림,56949,56385,113334,56667
20240705,2호선,문래,26253,27428,53681,26840.5
20240705,2호선,영등포구청,25058,25734,50792,25396
20240705,2호선,당산,20216,23704,43920,21960
20240705,2호선,합정,38118,42561,80679,40339.5
20240705,2호선,홍대입구,79530,91361,170891,85445.5
20240705,2호선,신촌,42870,44452,87322,43661
20240705,2호선,이대,17130,18249,35379,17689.5
20240705,2호선,아현,12761,11456,24217,12108.5
20240705,2호선,충정로(경기대입구),11779,12332,24111,12055.5
20240705,2호선,용답,3310,3182,6492,3246
20240705,2호선,신답,1853,2019,3872,1936
20240705,2호선,신설동,4171,4036,8207,4103.5
20240705,2호선,도림천,1502,1579,3081,1540.5
20240705,2호선,양천구청,7926,8150,16076,8038
20240705,2호선,신정네거리,11461,11695,23156,11578
20240705,2호선,용두(동대문구청),2901,2923,5824,2912
20240705,3호선,지축,8683,8653,17336,8668
20240705,3호선,구파발,24383,23345,47728,23864
20240705,3호선,연신내,38864,36930,75794,37897
20240705,3호선,불광,18346,19617,37963,18981.5
20240705,3호선,녹번,17279,15405,32684,16342
20240705,3호선,홍제,19929,18801,38730,19365
20240705,3호선,무악재,5058,4783,9841,4920.5
20240705,3호선,독립문,8662,8231,16893,8446.5
20240705,3호선,경복궁(정부서울청사),26027,26628,52655,26327.5
20240705,3호선,안국,29665,30937,60602,30301
20240705,3호선,종로3가,12452,14818,27270,13635
20240705,3호선,을지로3가,13708,13890,27598,13799
20240705,3호선,충무로,18,0,18,9
20240705,3호선,동대입구,9994,10866,20860,10430
20240705,3호선,약수,14723,14220,28943,14471.5
20240705,3호선,금호,9095,8395,17490,8745
20240705,3호선,옥수,10264,10313,20577,10288.5
20240705,3호선,압구정,36637,39731,76368,38184
20240705,3호선,신사,32311,34810,67121,33560.5
20240705,3호선,잠원,5846,5445,11291,5645.5
20240705,3호선,고속터미널,54406,55583,109989,54994.5
20240705,3호선,교대(법원.검찰청),20147,11798,31945,15972.5
20240705,3호선,남부터미널(예술의전당),34649,35245,69894,34947
20240705,3호선,양재(서초구청),43045,45927,88972,44486
20240705,3호선,매봉,15367,14684,30051,15025.5
20240705,3호선,도곡,6913,6731,13644,6822
20240705,3호선,대치,13637,13437,27074,13537
20240705,3호선,학여울,2552,2527,5079,2539.5
20240705,3호선,대청,13043,11930,24973,12486.5
20240705,3호선,일원,12628,12021,24649,12324.5
20240705,3호선,수서,21596,21251,42847,21423.5
20240705,3호선,가락시장,10486,10079,20565,10282.5
20240705,3호선,경찰병원,8616,8482,17098,8549
20240705,3호선,오금,7636,6573,14209,7104.5
20240705,4호선,당고개,10583,9198,19781,9890.5
20240705,4호선,상계,21605,19957,41562,20781
20240705,4호선,노원,33270,37995,71265,35632.5
20240705,4호선,창동,30298,31965,62263,31131.5
20240705,4호선,쌍문,33119,30186,63305,31652.5
20240705,4호선,수유(강북구청),37764,38258,76022,38011
20240705,4호선,미아(서울사이버대학),16802,16099,32901,16450.5
20240705,4호선,미아사거리,30284,30024,60308,30154
20240705,4호선,길음,23895,22775,46670,23335
20240705,4호선,성신여대입구(돈암),23938,23298,47236,23618
20240705,4호선,한성대입구(삼선교),15110,14160,29270,14635
20240705,4호선,혜화,38563,38844,77407,38703.5
20240705,4호선,동대문,22554,22342,44896,22448
20240705,4호선,동대문역사문화공원(DDP),20505,17575,38080,19040
20240705,4호선,충무로,33868,35108,68976,34488
20240705,4호선,명동,34859,37404,72263,36131.5
20240705,4호선,회현(남대문시장),29825,31576,61401,30700.5
20240705,4호선,서울역,14642,25526,40168,20084
20240705,4호선,숙대입구(갈월),16195,15774,31969,15984.5
20240705,분당선,기흥,11886,10826,22712,11356
20240705,4호선,삼각지,7744,8782,16526,8263
20240705,4호선,신용산,22904,24780,47684,23842
20240705,4호선,이촌(국립중앙박물관),9770,10574,20344,10172
20240705,4호선,동작(현충원),1757,1880,3637,1818.5
20240705,4호선,총신대입구(이수),22380,24312,46692,23346
20240705,4호선,사당,29750,26345,56095,28047.5
20240705,4호선,남태령,1662,1329,2991,1495.5
20240705,5호선,방화,8206,7760,15966,7983
20240705,5호선,개화산,7022,6661,13683,6841.5
20240705,5호선,김포공항,12247,8586,20833,10416.5
20240705,5호선,송정,7272,6752,14024,7012
20240705,5호선,마곡,13995,14355,28350,14175
20240705,5호선,발산,25578,26907,52485,26242.5
20240705,5호선,우장산,16957,16434,33391,16695.5
20240705,5호선,화곡,31862,29144,61006,30503
20240705,5호선,까치산,31197,29481,60678,30339
20240705,5호선,신정(은행정),15181,12417,27598,13799
20240705,5호선,목동,18827,19934,38761,19380.5
20240705,5호선,오목교(목동운동장앞),23921,25427,49348,24674
20240705,5호선,양평,8713,8242,16955,8477.5
20240705,5호선,영등포구청,5376,5336,10712,5356
20240705,5호선,영등포시장,13035,13066,26101,13050.5
20240705,5호선,신길,5614,5477,11091,5545.5
20240705,5호선,여의도,32396,35182,67578,33789
20240705,5호선,여의나루,15723,17107,32830,16415
20240705,5호선,마포,16668,16973,33641,16820.5
20240705,5호선,공덕,16694,18104,34798,17399
20240705,5호선,애오개,7854,7624,15478,7739
20240705,5호선,충정로(경기대입구),5203,5209,10412,5206
20240705,5호선,서대문,23338,23561,46899,23449.5
20240705,5호선,광화문(세종문화회관),35856,38259,74115,37057.5
20240705,5호선,종로3가,17292,18670,35962,17981
20240705,5호선,을지로4가,7431,7534,14965,7482.5
20240705,5호선,동대문역사문화공원(DDP),3463,4051,7514,3757
20240705,5호선,청구,4358,4195,8553,4276.5
20240705,5호선,신금호,7492,7696,15188,7594
20240705,5호선,행당,9111,7830,16941,8470.5
20240705,5호선,왕십리(성동구청),5036,6106,11142,5571
20240705,5호선,마장,6675,6110,12785,6392.5
20240705,5호선,답십리,18171,16330,34501,17250.5
20240705,5호선,장한평,22118,21587,43705,21852.5
20240705,5호선,군자(능동),12733,14247,26980,13490
20240705,5호선,아차산(어린이대공원후문),15552,15239,30791,15395.5
20240705,5호선,광나루(장신대),15973,14780,30753,15376.5
20240705,5호선,천호(풍납토성),22157,22258,44415,22207.5
20240705,5호선,강동,20310,19527,39837,19918.5
20240705,5호선,길동,9456,9667,19123,9561.5
20240705,5호선,굽은다리(강동구민회관앞),11259,10728,21987,10993.5
20240705,5호선,명일,10407,10516,20923,10461.5
20240705,5호선,고덕,13017,12516,25533,12766.5
20240705,5호선,상일동,17644,16244,33888,16944
20240705,5호선,둔촌동,9965,9904,19869,9934.5
20240705,5호선,올림픽공원(한국체대),6471,5133,11604,5802
20240705,5호선,방이,7767,8098,15865,7932.5
20240705,5호선,오금,4269,4314,8583,4291.5
20240705,5호선,개롱,7334,7448,14782,7391
20240705,5호선,거여,11481,10971,22452,11226
20240705,5호선,마천,8504,7688,16192,8096
20240705,5호선,강일,7178,6431,13609,6804.5
20240705,5호선,미사,21461,21735,43196,21598
20240705,5호선,하남풍산,5248,5256,10504,5252
20240705,5호선,하남시청(덕풍·신장),9642,9119,18761,9380.5
20240705,5호선,하남검단산,7758,7416,15174,7587
20240705,6호선,응암,19913,19323,39236,19618
20240705,6호선,역촌,4159,4627,8786,4393
20240705,6호선,불광,5551,5230,10781,5390.5
20240705,6호선,독바위,3211,3157,6368,3184
20240705,6호선,연신내,1,0,1,0.5
20240705,6호선,구산,9371,7100,16471,8235.5
20240705,6호선,새절(신사),14490,13215,27705,13852.5
20240705,6호선,증산(명지대앞),11081,10708,21789,10894.5
20240705,6호선,디지털미디어시티,16662,17927,34589,17294.5
20240705,6호선,월드컵경기장(성산),4976,5022,9998,4999
20240705,6호선,마포구청,16367,14529,30896,15448
20240705,6호선,망원,16984,18251,35235,17617.5
20240705,6호선,합정,15698,16172,31870,15935
20240705,6호선,상수,11241,13672,24913,12456.5
20240705,6호선,광흥창(서강),10779,10292,21071,10535.5
20240705,6호선,대흥(서강대앞),10415,10612,21027,10513.5
20240705,6호선,공덕,22178,21619,43797,21898.5
20240705,6호선,효창공원앞,8388,7322,15710,7855
20240705,6호선,삼각지,8665,7600,16265,8132.5
20240705,6호선,녹사평(용산구청),6209,6460,12669,6334.5
20240705,6호선,이태원,12875,17380,30255,15127.5
20240705,6호선,한강진,11979,14120,26099,13049.5
20240705,6호선,버티고개,2432,2329,4761,2380.5
20240705,6호선,약수,4076,4139,8215,4107.5
20240705,6호선,청구,4467,4305,8772,4386
20240705,6호선,신당,9509,9147,18656,9328
20240705,6호선,동묘앞,9083,8942,18025,9012.5
20240705,6호선,창신,3955,3124,7079,3539.5
20240705,6호선,보문,8962,8060,17022,8511
20240705,6호선,안암(고대병원앞),12684,12131,24815,12407.5
20240705,6호선,고려대(종암),9415,8838,18253,9126.5
20240705,6호선,월곡(동덕여대),13308,12831,26139,13069.5
20240705,6호선,상월곡(한국과학기술연구원),7245,6244,13489,6744.5
20240705,6호선,돌곶이,11495,10472,21967,10983.5
20240705,6호선,석계,13830,14071,27901,13950.5
20240705,6호선,태릉입구,6200,7018,13218,6609
20240705,6호선,화랑대(서울여대입구),12978,10113,23091,11545.5
20240705,6호선,봉화산(서울의료원),10149,9290,19439,9719.5
20240705,6호선,신내,1,0,1,0.5
20240705,7호선,장암,3075,1329,4404,2202
20240705,7호선,도봉산,9661,11115,20776,10388
20240705,7호선,수락산,13580,13268,26848,13424
20240705,7호선,마들,14871,13681,28552,14276
20240705,7호선,노원,28091,30018,58109,29054.5
20240705,7호선,중계,16226,14470,30696,15348
20240705,7호선,공릉(서울과학기술대),13967,13235,27202,13601
20240705,7호선,태릉입구,10186,9351,19537,9768.5
20240705,7호선,먹골,11432,11257,22689,11344.5
20240705,7호선,중화,11879,11419,23298,11649
20240705,7호선,상봉,19620,19636,39256,19628
20240705,7호선,면목,16804,15804,32608,16304
20240705,7호선,사가정,18142,18122,36264,18132
20240705,7호선,용마산(용마폭포공원),6427,6091,12518,6259
20240705,7호선,중곡,12431,11453,23884,11942
20240705,7호선,군자(능동),17130,13460,30590,15295
20240705,7호선,어린이대공원(세종대),16261,15976,32237,16118.5
20240705,7호선,건대입구,14619,15354,29973,14986.5
20240705,7호선,자양(뚝섬한강공원),11418,10846,22264,11132
20240705,7호선,청담,21254,23588,44842,22421
20240705,7호선,강남구청,18433,20450,38883,19441.5
20240705,7호선,학동,26281,27941,54222,27111
20240705,7호선,논현,21702,22577,44279,22139.5
20240705,7호선,반포,7506,6939,14445,7222.5
20240705,7호선,고속터미널,20152,16492,36644,18322
20240705,7호선,내방,16800,16614,33414,16707
20240705,7호선,이수,19085,18601,37686,18843
20240705,7호선,남성,12812,11958,24770,12385
20240705,7호선,숭실대입구(살피재),14085,13737,27822,13911
20240705,7호선,상도,13108,12246,25354,12677
20240705,7호선,장승배기,10525,10320,20845,10422.5
20240705,7호선,신대방삼거리,16668,15602,32270,16135
20240705,7호선,보라매,7623,7641,15264,7632
20240705,7호선,신풍,12605,11480,24085,12042.5
20240705,7호선,대림(구로구청),9324,9653,18977,9488.5
20240705,7호선,남구로,16194,16906,33100,16550
20240705,7호선,가산디지털단지,49988,50067,100055,50027.5
20240705,7호선,철산,24724,24836,49560,24780
20240705,7호선,광명사거리,22768,22379,45147,22573.5
20240705,7호선,천왕,13407,12654,26061,13030.5
20240705,7호선,온수(성공회대입구),10912,9701,20613,10306.5
20240705,8호선,암사,21463,18478,39941,19970.5
20240705,8호선,천호(풍납토성),17342,19984,37326,18663
20240705,8호선,강동구청,11850,11993,23843,11921.5
20240705,8호선,몽촌토성(평화의문),7493,7590,15083,7541.5
20240705,8호선,잠실(송파구청),18482,22105,40587,20293.5
20240705,8호선,석촌,8892,10605,19497,9748.5
20240705,8호선,송파,10744,10183,20927,10463.5
20240705,8호선,가락시장,8737,9861,18598,9299
20240705,8호선,문정,24821,25840,50661,25330.5
20240705,8호선,장지,19643,17805,37448,18724
20240705,8호선,복정,10565,8751,19316,9658
20240705,8호선,산성,7058,7049,14107,7053.5
20240705,8호선,남한산성입구(성남법원.검찰청),14686,12758,27444,13722
20240705,8호선,단대오거리,13339,12687,26026,13013
20240705,8호선,신흥,5812,5994,11806,5903
20240705,8호선,수진,6114,5587,11701,5850.5
20240705,8호선,모란,5355,4495,9850,4925
20240705,8호선,남위례,8445,8521,16966,8483
20240705,9호선,개화,3200,2101,5301,2650.5
20240705,9호선,김포공항,8224,11063,19287,9643.5
20240705,9호선,공항시장,3452,3553,7005,3502.5
20240705,9호선,신방화,8140,7757,15897,7948.5
20240705,9호선,마곡나루(서울식물원),16231,15994,32225,16112.5
20240705,9호선,양천향교,11614,11456,23070,11535
20240705,9호선,가양,25345,24256,49601,24800.5
20240705,9호선,증미,9133,8625,17758,8879
20240705,9호선,등촌,13955,13161,27116,13558
20240705,9호선,염창,20207,19042,39249,19624.5
20240705,9호선,신목동,5121,4473,9594,4797
20240705,9호선,선유도,10157,9420,19577,9788.5
20240705,9호선,당산,22191,21532,43723,21861.5
20240705,9호선,국회의사당,19853,20460,40313,20156.5
20240705,9호선,여의도,34635,33261,67896,33948
20240705,9호선,샛강,7420,7441,14861,7430.5
20240705,9호선,노량진,27985,27102,55087,27543.5
20240705,9호선,노들,5638,4610,10248,5124
20240705,9호선,흑석(중앙대입구),9348,9639,18987,9493.5
20240705,9호선,동작(현충원),2049,1700,3749,1874.5
20240705,9호선,구반포,1586,1545,3131,1565.5
20240705,9호선,신반포,4959,4706,9665,4832.5
20240705,9호선,고속터미널,17362,24429,41791,20895.5
20240705,9호선,사평,4840,4447,9287,4643.5
20240705,9호선,신논현,37274,37982,75256,37628
20240705,9호선2~3단계,언주,13044,13269,26313,13156.5
20240705,9호선2~3단계,선정릉,11629,12318,23947,11973.5
20240705,9호선2~3단계,삼성중앙,9206,9308,18514,9257
20240705,9호선2~3단계,봉은사,29591,32975,62566,31283
20240705,9호선2~3단계,종합운동장,5493,5489,10982,5491
20240705,9호선2~3단계,삼전,9059,8394,17453,8726.5
20240705,9호선2~3단계,석촌고분,8221,7748,15969,7984.5
20240705,9호선2~3단계,석촌,11218,9841,21059,10529.5
20240705,9호선2~3단계,송파나루,6382,7128,13510,6755
20240705,9호선2~3단계,한성백제,3470,3060,6530,3265
20240705,9호선2~3단계,올림픽공원(한국체대),5935,6359,12294,6147
20240705,9호선2~3단계,둔촌오륜,1650,1470,3120,1560
20240705,9호선2~3단계,중앙보훈병원,13786,11791,25577,12788.5
20240705,경강선,판교,6546,6436,12982,6491
20240705,경강선,이매,1238,1122,2360,1180
20240705,경강선,삼동,2841,2566,5407,2703.5
20240705,경강선,경기광주,9283,8615,17898,8949
20240705,경강선,초월,3950,3660,7610,3805
20240705,경강선,곤지암,2482,2398,4880,2440
20240705,경강선,신둔도예촌,1628,1502,3130,1565
20240705,경강선,이천,3441,3749,7190,3595
20240705,경강선,부발,2842,2445,5287,2643.5
20240705,경강선,세종대왕릉,408,408,816,408
20240705,경강선,여주,3276,3368,6644,3322
20240705,경강선,성남,1109,1013,2122,1061
20240705,경부선,서울역,11585,4225,15810,7905
20240705,경부선,남영,11000,11253,22253,11126.5
20240705,경부선,용산,47657,48658,96315,48157.5
20240705,경부선,노량진,9220,8870,18090,9045
20240705,경부선,대방,11768,12444,24212,12106
20240705,경부선,영등포,46573,48576,95149,47574.5
20240705,분당선,신갈,5440,5255,10695,5347.5
20240705,경부선,신도림,4454,4844,9298,4649
20240705,경부선,신길,9790,8048,17838,8919
20240705,경부선,구로,19187,19883,39070,19535
20240705,경부선,가산디지털단지,19527,22287,41814,20907
20240705,경부선,금천구청,12493,12650,25143,12571.5
20240705,경부선,석수,9433,8541,17974,8987
20240705,경부선,관악,8029,7556,15585,7792.5
20240705,경부선,안양,23480,23494,46974,23487
20240705,경부선,명학,9445,9140,18585,9292.5
20240705,경부선,금정,31312,31697,63009,31504.5
20240705,경부선,군포,7952,7736,15688,7844
20240705,경부선,의왕,10240,10153,20393,10196.5
20240705,경부선,성균관대,16980,16384,33364,16682
20240705,경부선,화서,13407,13319,26726,13363
20240705,경부선,수원,41602,45187,86789,43394.5
20240705,경부선,독산,19663,19811,39474,19737
20240705,경부선,세류,4051,3471,7522,3761
20240705,경부선,병점,16658,16051,32709,16354.5
20240705,경부선,세마,3929,3714,7643,3821.5
20240705,경부선,오산대,4322,3943,8265,4132.5
20240705,경부선,오산,11582,11337,22919,11459.5
20240705,경부선,진위,2150,1737,3887,1943.5
20240705,경부선,송탄,5759,5222,10981,5490.5
20240705,경부선,서정리,10427,8543,18970,9485
20240705,경부선,평택지제,5131,5019,10150,5075
20240705,경부선,평택,14892,14694,29586,14793
20240705,경부선,성환,4854,4399,9253,4626.5
20240705,경부선,직산,1248,1128,2376,1188
20240705,경부선,두정,8163,7760,15923,7961.5
20240705,경부선,천안,6925,7062,13987,6993.5
20240705,경부선,당정,6963,6350,13313,6656.5
20240705,경부선,서동탄,1724,1534,3258,1629
20240705,경부선,광명,4454,4016,8470,4235
20240705,경원선,이촌(국립중앙박물관),4542,3417,7959,3979.5
20240705,경원선,서빙고,2404,2198,4602,2301
20240705,경원선,한남,4355,4284,8639,4319.5
20240705,경원선,옥수,69,41,110,55
20240705,경원선,응봉,2331,1829,4160,2080
20240705,경원선,왕십리(성동구청),19385,19663,39048,19524
20240705,경원선,청량리(서울시립대입구),18890,20313,39203,19601.5
20240705,경원선,외대앞,10031,9513,19544,9772
20240705,경원선,신이문,9467,8558,18025,9012.5
20240705,경원선,석계,8298,9360,17658,8829
20240705,경원선,광운대,8670,8018,16688,8344
20240705,경원선,월계,7461,6809,14270,7135
20240705,경원선,녹천,5120,4150,9270,4635
20240705,경원선,창동,5,0,5,2.5
20240705,경원선,방학,11088,10716,21804,10902
20240705,경원선,도봉,6788,6470,13258,6629
20240705,경원선,도봉산,8093,5203,13296,6648
20240705,경원선,망월사,8073,8016,16089,8044.5
20240705,경원선,회룡,14499,14217,28716,14358
20240705,경원선,의정부,21191,22258,43449,21724.5
20240705,경원선,가능,7069,6836,13905,6952.5
20240705,경원선,녹양,4923,4521,9444,4722
20240705,경원선,양주,8028,7570,15598,7799
20240705,경원선,덕계,6595,6163,12758,6379
20240705,경원선,덕정,6422,5975,12397,6198.5
20240705,경원선,지행,7746,7938,15684,7842
20240705,경원선,동두천중앙,3576,3397,6973,3486.5
20240705,1호선,종로3가,29825,27685,57510,28755
20240705,1호선,종각,44129,44128,88257,44128.5
20240705,1호선,시청,28734,29042,57776,28888
20240705,1호선,서울역,63499,59836,123335,61667.5
20240705,중앙선,지평,69,81,150,75
20240705,중앙선,용문,3307,3473,6780,3390
20240705,중앙선,원덕,362,395,757,378.5
20240705,중앙선,양평,3673,3944,7617,3808.5
20240705,중앙선,오빈,320,366,686,343
20240705,중앙선,아신,537,561,1098,549
20240705,중앙선,국수,794,797,1591,795.5
20240705,중앙선,신원,197,181,378,189
20240705,중앙선,양수,2556,2447,5003,2501.5
20240705,중앙선,운길산,789,733,1522,761
20240705,경원선,보산,1985,1767,3752,1876
20240705,경원선,동두천,1855,1785,3640,1820
20240705,경원선,소요산,1882,1897,3779,1889.5
20240705,경원선,청산,160,127,287,143.5
20240705,경원선,전곡,1289,1299,2588,1294
20240705,경원선,연천,1140,1334,2474,1237
20240705,경의선,서울역,5587,6869,12456,6228
20240705,경의선,신촌,1126,1541,2667,1333.5
20240705,경의선,효창공원앞,3459,3976,7435,3717.5
20240705,7호선,하계,19984,18193,38177,19088.5
20240705,경의선,공덕,4810,4130,8940,4470
20240705,경의선,서강대,2471,2292,4763,2381.5
20240705,경의선,홍대입구,2606,3267,5873,2936.5
20240705,경의선,가좌,6675,6283,12958,6479
20240705,경의선,디지털미디어시티,3192,2923,6115,3057.5
20240706,9호선2~3단계,송파나루,4857,5272,10129,5064.5
20240706,1호선,시청,14799,14738,29537,14768.5
20240706,1호선,종각,22847,22195,45042,22521
20240706,1호선,종로3가,23304,22673,45977,22988.5
20240706,1호선,종로5가,20368,19936,40304,20152
20240706,1호선,동대문,10712,10889,21601,10800.5
20240706,1호선,신설동,10520,9906,20426,10213
20240706,1호선,제기동,15569,15873,31442,15721
20240706,1호선,청량리(서울시립대입구),20761,20550,41311,20655.5
20240706,1호선,동묘앞,11498,11811,23309,11654.5
20240706,2호선,시청,13097,10625,23722,11861
20240706,2호선,을지로입구,32853,32041,64894,32447
20240706,2호선,을지로3가,14468,14109,28577,14288.5
20240706,2호선,을지로4가,9370,9578,18948,9474
20240706,2호선,동대문역사문화공원(DDP),13004,15216,28220,14110
20240706,2호선,신당,12175,12887,25062,12531
20240706,2호선,상왕십리,10519,10003,20522,10261
20240706,2호선,왕십리(성동구청),13018,12507,25525,12762.5
20240706,2호선,한양대,4852,4953,9805,4902.5
20240706,2호선,뚝섬,16524,16447,32971,16485.5
20240706,2호선,성수,30179,33892,64071,32035.5
20240706,2호선,건대입구,35897,38295,74192,37096
20240706,2호선,구의(광진구청),17965,17137,35102,17551
20240706,2호선,강변(동서울터미널),27653,27312,54965,27482.5
20240706,2호선,잠실나루,8586,8209,16795,8397.5
20240706,2호선,잠실(송파구청),74495,72697,147192,73596
20240706,2호선,잠실새내,19982,20133,40115,20057.5
20240706,2호선,종합운동장,8592,9933,18525,9262.5
20240706,2호선,삼성(무역센터),50649,48257,98906,49453
20240706,2호선,선릉,28851,25145,53996,26998
20240706,2호선,역삼,19342,21263,40605,20302.5
20240706,2호선,강남,60319,60769,121088,60544
20240706,2호선,교대(법원.검찰청),16399,20691,37090,18545
20240706,2호선,서초,11646,9797,21443,10721.5
20240706,2호선,방배,9927,10124,20051,10025.5
20240706,2호선,사당,35774,38592,74366,37183
20240706,2호선,낙성대(강감찬),22018,20130,42148,21074
20240706,2호선,서울대입구(관악구청),37324,35493,72817,36408.5
20240706,2호선,봉천,18774,17055,35829,17914.5
20240706,2호선,신림,46679,43996,90675,45337.5
20240706,2호선,신대방,20538,19421,39959,19979.5
20240706,2호선,구로디지털단지,37617,36448,74065,37032.5
20240706,2호선,대림(구로구청),19083,19932,39015,19507.5
20240706,2호선,신도림,45740,45940,91680,45840
20240706,2호선,문래,14154,15074,29228,14614
20240706,2호선,영등포구청,14358,14985,29343,14671.5
20240706,2호선,당산,12029,13090,25119,12559.5
20240706,2호선,합정,31889,37040,68929,34464.5
20240706,2호선,홍대입구,82157,92903,175060,87530
20240706,2호선,신촌,35684,36672,72356,36178
20240706,2호선,이대,12725,13583,26308,13154
20240706,2호선,아현,8477,7768,16245,8122.5
20240706,2호선,충정로(경기대입구),6418,6792,13210,6605
20240706,2호선,용답,2437,2096,4533,2266.5
20240706,2호선,신답,1056,1047,2103,1051.5
20240706,2호선,신설동,3480,3323,6803,3401.5
20240706,2호선,도림천,920,914,1834,917
20240706,2호선,양천구청,4672,4642,9314,4657
20240706,2호선,신정네거리,7519,7391,14910,7455
20240706,2호선,용두(동대문구청),1887,1819,3706,1853
20240706,3호선,지축,5540,5215,10755,5377.5
20240706,3호선,구파발,16928,17223,34151,17075.5
20240706,3호선,연신내,28534,26538,55072,27536
20240706,3호선,불광,13376,14617,27993,13996.5
20240706,3호선,녹번,10762,9299,20061,10030.5
20240706,3호선,홍제,14161,13099,27260,13630
20240706,3호선,무악재,3145,3147,6292,3146
20240706,3호선,독립문,6331,6498,12829,6414.5
20240706,3호선,경복궁(정부서울청사),20621,22164,42785,21392.5
20240706,3호선,안국,21122,22132,43254,21627
20240706,3호선,종로3가,8109,10566,18675,9337.5
20240706,3호선,을지로3가,6744,6851,13595,6797.5
20240706,3호선,충무로,16,0,16,8
20240706,3호선,동대입구,12056,12622,24678,12339
20240706,3호선,약수,9901,9468,19369,9684.5
20240706,3호선,금호,6055,5651,11706,5853
20240706,3호선,옥수,7015,6983,13998,6999
20240706,3호선,압구정,25387,26938,52325,26162.5
20240706,3호선,신사,22746,24284,47030,23515
20240706,3호선,잠원,3950,3694,7644,3822
20240706,3호선,고속터미널,58031,56651,114682,57341
20240706,3호선,교대(법원.검찰청),10214,5271,15485,7742.5
20240706,3호선,남부터미널(예술의전당),22190,21661,43851,21925.5
20240706,3호선,양재(서초구청),20876,22528,43404,21702
20240706,3호선,매봉,7191,6783,13974,6987
20240706,3호선,도곡,3584,3706,7290,3645
20240706,3호선,대치,9697,8733,18430,9215
20240706,3호선,학여울,2644,2927,5571,2785.5
20240706,3호선,대청,6898,6398,13296,6648
20240706,3호선,일원,5880,5693,11573,5786.5
20240706,3호선,수서,15584,14917,30501,15250.5
20240706,3호선,가락시장,6326,6035,12361,6180.5
20240706,3호선,경찰병원,4539,4476,9015,4507.5
20240706,3호선,오금,4473,4184,8657,4328.5
20240706,4호선,당고개,7753,7102,14855,7427.5
20240706,4호선,상계,14652,13243,27895,13947.5
20240706,4호선,노원,24234,27016,51250,25625
20240706,4호선,창동,21554,22453,44007,22003.5
20240706,4호선,쌍문,22449,20055,42504,21252
20240706,4호선,수유(강북구청),27287,26861,54148,27074
20240706,4호선,미아(서울사이버대학),11648,10668,22316,11158
20240706,4호선,미아사거리,22163,21105,43268,21634
20240706,4호선,길음,15327,14446,29773,14886.5
20240706,4호선,성신여대입구(돈암),18220,17241,35461,17730.5
20240706,4호선,한성대입구(삼선교),11090,10640,21730,10865
20240706,4호선,혜화,32742,34299,67041,33520.5
20240706,4호선,동대문,15906,16470,32376,16188
20240706,4호선,동대문역사문화공원(DDP),15575,13469,29044,14522
20240706,4호선,충무로,16710,17661,34371,17185.5
20240706,4호선,명동,28929,32674,61603,30801.5
20240706,4호선,회현(남대문시장),21520,22055,43575,21787.5
20240706,4호선,서울역,7476,19225,26701,13350.5
20240706,4호선,숙대입구(갈월),10895,10642,21537,10768.5
20240706,4호선,삼각지,5712,7429,13141,6570.5
20240706,4호선,신용산,15952,17822,33774,16887
20240706,4호선,이촌(국립중앙박물관),8538,8960,17498,8749
20240706,4호선,동작(현충원),1171,1167,2338,1169
20240706,4호선,총신대입구(이수),15608,16516,32124,16062
20240706,4호선,사당,23444,21474,44918,22459
20240706,4호선,남태령,1217,756,1973,986.5
20240706,5호선,방화,5091,4946,10037,5018.5
20240706,5호선,개화산,4130,3957,8087,4043.5
20240706,5호선,김포공항,9703,7726,17429,8714.5
20240706,5호선,송정,5199,4836,10035,5017.5
20240706,5호선,마곡,7390,7466,14856,7428
20240706,5호선,발산,15967,17177,33144,16572
20240706,5호선,우장산,10504,10197,20701,10350.5
20240706,5호선,화곡,20803,18969,39772,19886
20240706,5호선,까치산,21246,19733,40979,20489.5
20240706,5호선,신정(은행정),9029,7826,16855,8427.5
20240706,5호선,목동,11511,11182,22693,11346.5
20240706,5호선,오목교(목동운동장앞),16909,17046,33955,16977.5
20240706,5호선,양평,4102,3881,7983,3991.5
20240706,5호선,영등포구청,2638,2424,5062,2531
20240706,5호선,영등포시장,9644,9951,19595,9797.5
20240706,5호선,신길,3578,3564,7142,3571
20240706,5호선,여의도,14556,15116,29672,14836
20240706,5호선,여의나루,7823,10186,18009,9004.5
20240706,5호선,마포,8473,8421,16894,8447
20240706,5호선,공덕,8066,8264,16330,8165
20240706,5호선,애오개,3913,3814,7727,3863.5
20240706,5호선,충정로(경기대입구),2172,2090,4262,2131
20240706,5호선,서대문,8494,7882,16376,8188
20240706,5호선,광화문(세종문화회관),18103,18991,37094,18547
20240706,5호선,종로3가,14729,15644,30373,15186.5
20240706,5호선,을지로4가,3669,4111,7780,3890
20240706,5호선,동대문역사문화공원(DDP),1439,1855,3294,1647
20240706,5호선,청구,2506,2564,5070,2535
20240706,5호선,신금호,4421,4759,9180,4590
20240706,5호선,행당,5729,4998,10727,5363.5
20240706,5호선,왕십리(성동구청),3542,4619,8161,4080.5
20240706,5호선,마장,4144,3922,8066,4033
20240706,5호선,답십리,11034,10067,21101,10550.5
20240706,5호선,장한평,12485,12174,24659,12329.5
20240706,5호선,군자(능동),9243,10252,19495,9747.5
20240706,5호선,아차산(어린이대공원후문),11799,11223,23022,11511
20240706,5호선,광나루(장신대),11630,11208,22838,11419
20240706,5호선,천호(풍납토성),18402,17197,35599,17799.5
20240706,5호선,강동,13775,13274,27049,13524.5
20240706,5호선,길동,6706,6743,13449,6724.5
20240706,5호선,굽은다리(강동구민회관앞),8184,7583,15767,7883.5
20240706,5호선,명일,6782,6462,13244,6622
20240706,5호선,고덕,7214,6933,14147,7073.5
20240706,5호선,상일동,9935,9334,19269,9634.5
20240706,5호선,둔촌동,7006,6975,13981,6990.5
20240706,5호선,올림픽공원(한국체대),4484,3872,8356,4178
20240706,5호선,방이,5455,5317,10772,5386
20240706,5호선,오금,2392,2231,4623,2311.5
20240706,5호선,개롱,4505,4720,9225,4612.5
20240706,5호선,거여,6871,6373,13244,6622
20240706,5호선,마천,4972,4863,9835,4917.5
20240706,5호선,강일,4414,3831,8245,4122.5
20240706,5호선,미사,14543,14630,29173,14586.5
20240706,5호선,하남풍산,3137,3234,6371,3185.5
20240706,5호선,하남시청(덕풍·신장),6903,6538,13441,6720.5
20240706,5호선,하남검단산,5919,5861,11780,5890
20240706,6호선,응암,13143,12719,25862,12931
20240706,6호선,역촌,2916,3194,6110,3055
20240706,6호선,불광,4130,3603,7733,3866.5
20240706,6호선,독바위,2063,2114,4177,2088.5
20240706,6호선,연신내,10,0,10,5
20240706,6호선,구산,6097,4687,10784,5392
20240706,6호선,새절(신사),9237,8596,17833,8916.5
20240706,6호선,증산(명지대앞),7528,7256,14784,7392
20240706,6호선,디지털미디어시티,8154,8529,16683,8341.5
20240706,6호선,월드컵경기장(성산),4935,5062,9997,4998.5
20240706,6호선,마포구청,10018,8769,18787,9393.5
20240706,6호선,망원,13673,14817,28490,14245
20240706,6호선,합정,13222,12777,25999,12999.5
20240706,6호선,상수,9945,11463,21408,10704
20240706,6호선,광흥창(서강),5879,5369,11248,5624
20240706,6호선,대흥(서강대앞),5950,5900,11850,5925
20240706,6호선,공덕,11568,11251,22819,11409.5
20240706,6호선,효창공원앞,4934,4245,9179,4589.5
20240706,6호선,삼각지,7333,6086,13419,6709.5
20240706,6호선,녹사평(용산구청),4920,5334,10254,5127
20240706,6호선,이태원,12903,15738,28641,14320.5
20240706,6호선,한강진,10715,13072,23787,11893.5
20240706,6호선,버티고개,1445,1518,2963,1481.5
20240706,6호선,약수,2673,2750,5423,2711.5
20240706,6호선,청구,2624,2333,4957,2478.5
20240706,6호선,신당,6501,6028,12529,6264.5
20240706,6호선,동묘앞,7905,7643,15548,7774
20240706,6호선,창신,2328,1873,4201,2100.5
20240706,6호선,보문,5847,5230,11077,5538.5
20240706,6호선,안암(고대병원앞),7030,6658,13688,6844
20240706,6호선,고려대(종암),5611,5248,10859,5429.5
20240706,6호선,월곡(동덕여대),7617,7141,14758,7379
20240706,6호선,상월곡(한국과학기술연구원),4426,3810,8236,4118
20240706,6호선,돌곶이,6838,6114,12952,6476
20240706,6호선,석계,9186,8963,18149,9074.5
20240706,6호선,태릉입구,4535,4823,9358,4679
20240706,6호선,화랑대(서울여대입구),6842,5658,12500,6250
20240706,6호선,봉화산(서울의료원),5621,5375,10996,5498
20240706,6호선,신내,1,0,1,0.5
20240706,7호선,장암,1824,1292,3116,1558
20240706,7호선,도봉산,6158,7930,14088,7044
20240706,7호선,수락산,9824,9468,19292,9646
20240706,7호선,마들,9518,8749,18267,9133.5
20240706,7호선,노원,20502,21102,41604,20802
20240706,7호선,중계,9950,8897,18847,9423.5
20240706,7호선,하계,12946,11846,24792,12396
20240706,7호선,공릉(서울과학기술대),9112,8877,17989,8994.5
20240706,7호선,태릉입구,7109,6482,13591,6795.5
20240706,7호선,먹골,7867,7575,15442,7721
20240706,7호선,중화,7567,7265,14832,7416
20240706,7호선,상봉,14112,13767,27879,13939.5
20240706,7호선,면목,11011,10229,21240,10620
20240706,7호선,사가정,12234,11997,24231,12115.5
20240706,7호선,용마산(용마폭포공원),4086,3925,8011,4005.5
20240706,7호선,중곡,7605,6916,14521,7260.5
20240706,7호선,군자(능동),11726,8927,20653,10326.5
20240706,7호선,어린이대공원(세종대),11586,11173,22759,11379.5
20240706,7호선,건대입구,11963,12358,24321,12160.5
20240706,7호선,자양(뚝섬한강공원),7757,7654,15411,7705.5
20240706,7호선,청담,11072,12309,23381,11690.5
20240706,7호선,강남구청,10053,11223,21276,10638
20240706,7호선,학동,12571,13078,25649,12824.5
20240706,7호선,논현,11040,12029,23069,11534.5
20240706,7호선,반포,5234,4903,10137,5068.5
20240706,7호선,고속터미널,17020,13080,30100,15050
20240706,7호선,내방,8542,8302,16844,8422
20240706,7호선,이수,13612,12761,26373,13186.5
20240706,7호선,남성,8240,7575,15815,7907.5
20240706,7호선,숭실대입구(살피재),8835,8551,17386,8693
20240706,7호선,상도,8188,7530,15718,7859
20240706,7호선,장승배기,6900,6562,13462,6731
20240706,7호선,신대방삼거리,10813,10141,20954,10477
20240706,7호선,보라매,5321,5238,10559,5279.5
20240706,7호선,신풍,8264,7659,15923,7961.5
20240706,7호선,대림(구로구청),8376,8888,17264,8632
20240706,7호선,남구로,8329,8872,17201,8600.5
20240706,7호선,가산디지털단지,14068,12880,26948,13474
20240706,7호선,철산,16399,16057,32456,16228
20240706,7호선,광명사거리,16319,16316,32635,16317.5
20240706,7호선,천왕,7323,6897,14220,7110
20240706,7호선,온수(성공회대입구),5728,5658,11386,5693
20240706,8호선,암사,13372,12066,25438,12719
20240706,8호선,천호(풍납토성),12515,14595,27110,13555
20240706,8호선,강동구청,6345,6320,12665,6332.5
20240706,8호선,몽촌토성(평화의문),4890,4929,9819,4909.5
20240706,8호선,잠실(송파구청),16745,18582,35327,17663.5
20240706,8호선,석촌,6550,8152,14702,7351
20240706,8호선,송파,7056,7069,14125,7062.5
20240706,8호선,가락시장,5690,5883,11573,5786.5
20240706,8호선,문정,9962,10059,20021,10010.5
20240706,8호선,장지,12988,11569,24557,12278.5
20240706,8호선,복정,6141,5103,11244,5622
20240706,8호선,산성,4782,4825,9607,4803.5
20240706,8호선,남한산성입구(성남법원.검찰청),9185,7849,17034,8517
20240706,8호선,단대오거리,8521,7950,16471,8235.5
20240706,8호선,신흥,4268,4426,8694,4347
20240706,8호선,수진,4493,3986,8479,4239.5
20240706,8호선,모란,4041,3538,7579,3789.5
20240706,8호선,남위례,4942,4886,9828,4914
20240706,9호선,개화,1532,1303,2835,1417.5
20240706,9호선,김포공항,6977,10995,17972,8986
20240706,9호선,공항시장,2374,2520,4894,2447
20240706,9호선,신방화,5218,4901,10119,5059.5
20240706,9호선,마곡나루(서울식물원),9781,9505,19286,9643
20240706,9호선,양천향교,6364,6148,12512,6256
20240706,9호선,가양,15508,15058,30566,15283
20240706,9호선,증미,3813,3478,7291,3645.5
20240706,9호선,등촌,7913,7560,15473,7736.5
20240706,9호선,염창,12855,11776,24631,12315.5
20240706,9호선,신목동,2650,2227,4877,2438.5
20240706,9호선,선유도,4339,4013,8352,4176
20240706,9호선,당산,14024,13137,27161,13580.5
20240706,9호선,국회의사당,6064,6392,12456,6228
20240706,9호선,여의도,16230,15131,31361,15680.5
20240706,9호선,샛강,3270,3062,6332,3166
20240706,9호선,노량진,21348,20770,42118,21059
20240706,9호선,노들,3623,3073,6696,3348
20240706,9호선,흑석(중앙대입구),5981,5923,11904,5952
20240706,9호선,동작(현충원),1280,1214,2494,1247
20240706,9호선,구반포,890,858,1748,874
20240706,9호선,신반포,3063,3061,6124,3062
20240706,9호선,고속터미널,16055,23949,40004,20002
20240706,9호선,사평,2861,2709,5570,2785
20240706,9호선,신논현,28089,28462,56551,28275.5
20240706,9호선2~3단계,언주,7314,7221,14535,7267.5
20240706,9호선2~3단계,선정릉,5207,5771,10978,5489
20240706,9호선2~3단계,삼성중앙,3864,3598,7462,3731
20240706,9호선2~3단계,봉은사,25428,29683,55111,27555.5
20240706,9호선2~3단계,종합운동장,4990,4231,9221,4610.5
20240706,9호선2~3단계,삼전,5914,5275,11189,5594.5
20240706,9호선2~3단계,석촌고분,5403,5173,10576,5288
20240706,9호선2~3단계,석촌,8260,6771,15031,7515.5
20240706,1호선,서울역,44571,42118,86689,43344.5
20240706,9호선2~3단계,한성백제,2214,1904,4118,2059
20240706,9호선2~3단계,올림픽공원(한국체대),7242,7040,14282,7141
20240706,9호선2~3단계,둔촌오륜,874,939,1813,906.5
20240706,9호선2~3단계,중앙보훈병원,6046,5661,11707,5853.5
20240706,경강선,판교,3910,3565,7475,3737.5
20240706,경강선,이매,809,612,1421,710.5
20240706,경강선,삼동,1647,1537,3184,1592
20240706,경강선,경기광주,6017,5550,11567,5783.5
20240706,경강선,초월,2618,2379,4997,2498.5
20240706,경강선,곤지암,1970,2084,4054,2027
20240706,경강선,신둔도예촌,1333,1286,2619,1309.5
20240706,경강선,이천,3347,3440,6787,3393.5
20240706,경강선,부발,2283,2168,4451,2225.5
20240706,경강선,세종대왕릉,348,349,697,348.5
20240706,경강선,여주,2959,3242,6201,3100.5
20240706,경강선,성남,718,703,1421,710.5
20240706,경부선,서울역,10533,3716,14249,7124.5
20240706,경부선,남영,6617,6827,13444,6722
20240706,경부선,용산,47155,50398,97553,48776.5
20240706,경부선,노량진,8226,7643,15869,7934.5
20240706,경부선,대방,6760,7410,14170,7085
20240706,경부선,영등포,47392,48930,96322,48161
20240706,경부선,신도림,3404,3876,7280,3640
20240706,경부선,신길,6281,5245,11526,5763
20240706,경부선,구로,14345,15271,29616,14808
20240706,경부선,가산디지털단지,6651,8227,14878,7439
20240706,경부선,금천구청,8370,8319,16689,8344.5
20240706,경부선,석수,6555,6004,12559,6279.5
20240706,경부선,관악,5872,5787,11659,5829.5
20240706,경부선,안양,18307,18356,36663,18331.5
20240706,경부선,명학,4889,4667,9556,4778
20240706,경부선,금정,20597,20324,40921,20460.5
20240706,경부선,군포,4420,4049,8469,4234.5
20240706,경부선,의왕,6270,5936,12206,6103
20240706,경부선,성균관대,11895,11807,23702,11851
20240706,경부선,화서,13059,12942,26001,13000.5
20240706,경부선,수원,42830,46552,89382,44691
20240706,경부선,독산,9602,9221,18823,9411.5
20240706,경부선,세류,2969,3116,6085,3042.5
20240706,경부선,병점,13840,13284,27124,13562
20240706,경부선,세마,2817,2456,5273,2636.5
20240706,경부선,오산대,3285,3063,6348,3174
20240706,경부선,오산,10459,9762,20221,10110.5
20240706,경부선,진위,1141,1010,2151,1075.5
20240706,경부선,송탄,4949,4726,9675,4837.5
20240706,경부선,서정리,8036,7121,15157,7578.5
20240706,경부선,평택지제,4290,3757,8047,4023.5
20240706,경부선,평택,14921,14656,29577,14788.5
20240706,경부선,성환,3613,3331,6944,3472
20240706,경부선,직산,894,839,1733,866.5
20240706,경부선,두정,6738,6459,13197,6598.5
20240706,경부선,천안,7591,7729,15320,7660
20240706,경부선,당정,4199,3968,8167,4083.5
20240706,경부선,서동탄,1227,1156,2383,1191.5
20240706,경부선,광명,3400,3039,6439,3219.5
20240706,경원선,이촌(국립중앙박물관),3134,2441,5575,2787.5
20240706,경원선,서빙고,1582,1474,3056,1528
20240706,경원선,한남,2578,2634,5212,2606
20240706,경원선,옥수,52,26,78,39
20240706,경원선,응봉,1395,1165,2560,1280
20240706,경원선,왕십리(성동구청),15693,15749,31442,15721
20240706,경원선,청량리(서울시립대입구),17805,19460,37265,18632.5
20240706,경원선,외대앞,7719,7029,14748,7374
20240706,경원선,신이문,6562,5945,12507,6253.5
20240706,경원선,석계,6537,6757,13294,6647
20240706,경원선,광운대,5799,5559,11358,5679
20240706,경원선,월계,4843,4345,9188,4594
20240706,경원선,녹천,3322,2765,6087,3043.5
20240706,경원선,창동,4,0,4,2
20240706,경원선,방학,7768,7559,15327,7663.5
20240706,경원선,도봉,4500,4334,8834,4417
20240706,경원선,도봉산,7378,5049,12427,6213.5
20240706,경원선,망월사,5496,5586,11082,5541
20240706,경원선,회룡,10357,10048,20405,10202.5
20240706,경원선,의정부,17760,18906,36666,18333
20240706,경원선,가능,5157,4821,9978,4989
20240706,경원선,녹양,3487,3344,6831,3415.5
20240706,경원선,양주,6251,6009,12260,6130
20240706,경원선,덕계,4548,4230,8778,4389
20240706,경원선,덕정,4711,4268,8979,4489.5
20240706,경원선,지행,5937,5900,11837,5918.5
20240706,경원선,동두천중앙,2506,2488,4994,2497
20240706,경원선,보산,1414,1502,2916,1458
20240706,경원선,동두천,1427,1445,2872,1436
20240706,경원선,소요산,2338,2211,4549,2274.5
20240706,경원선,청산,133,97,230,115
20240706,경원선,전곡,1435,1172,2607,1303.5
20240706,경원선,연천,1255,1217,2472,1236
20240706,경의선,서울역,1556,1634,3190,1595
20240706,경의선,신촌,413,480,893,446.5
20240706,경의선,효창공원앞,1935,2240,4175,2087.5
20240706,경의선,공덕,3899,2681,6580,3290
20240706,경의선,서강대,1850,1818,3668,1834
20240706,경의선,홍대입구,2809,3513,6322,3161
20240706,경의선,가좌,4283,4156,8439,4219.5
20240706,경의선,디지털미디어시티,2350,2054,4404,2202
20240706,경의선,수색,2108,2007,4115,2057.5
20240706,경의선,한국항공대,1244,1171,2415,1207.5
20240706,경의선,강매,2129,1886,4015,2007.5
20240706,경의선,행신,5767,6011,11778,5889
20240706,경의선,능곡,3703,3511,7214,3607
20240706,경의선,곡산,451,459,910,455
20240706,경의선,백마,5267,4854,10121,5060.5
20240706,경의선,풍산,5044,4885,9929,4964.5
20240706,경의선,일산,7853,7293,15146,7573
20240706,경의선,탄현,5867,5666,11533,5766.5
20240706,경의선,야당,7643,8020,15663,7831.5
20240706,경의선,운정,6243,5385,11628,5814
20240706,경의선,금릉,4568,4353,8921,4460.5
20240706,경의선,금촌,6164,5933,12097,6048.5
20240706,경의선,월롱,1209,1128,2337,1168.5
20240706,경의선,파주,1021,830,1851,925.5
20240706,경의선,문산,5204,4603,9807,4903.5
20240706,경의선,임진강,50,35,85,42.5
20240706,경의선,운천,14,6,20,10
20240706,경인선,개봉,17031,16414,33445,16722.5
20240706,경인선,오류동,9531,8484,18015,9007.5
20240706,경인선,역곡,19753,19363,39116,19558
20240706,경인선,부천,29497,29919,59416,29708
20240706,경인선,송내,19033,18385,37418,18709
20240706,경인선,부평,28479,31170,59649,29824.5
20240706,경인선,백운,6205,5939,12144,6072
20240706,경인선,동암,13153,13339,26492,13246
20240706,경인선,주안,16634,14579,31213,15606.5
20240706,경인선,제물포,7577,7109,14686,7343
20240706,경인선,동인천,12123,11776,23899,11949.5
20240706,경인선,인천,4005,3458,7463,3731.5
20240706,경인선,구일,4568,4228,8796,4398
20240706,경인선,소사,6716,6417,13133,6566.5
20240706,경인선,부개,6725,6275,13000,6500
20240706,경인선,간석,4760,4510,9270,4635
20240706,경인선,도원,2326,2411,4737,2368.5
20240706,경인선,온수(성공회대입구),4916,4432,9348,4674
20240706,경인선,중동,7095,6578,13673,6836.5
20240706,경인선,도화,3354,3050,6404,3202
20240706,경춘선,신내,1690,1401,3091,1545.5
20240706,경춘선,갈매,1918,1741,3659,1829.5
20240706,경춘선,별내,2479,2288,4767,2383.5
20240706,경춘선,퇴계원,2605,2386,4991,2495.5
20240706,경춘선,사릉,1603,1439,3042,1521
20240706,경춘선,금곡,1096,998,2094,1047
20240706,경춘선,평내호평,4532,4351,8883,4441.5
20240706,경춘선,천마산,1216,1246,2462,1231
20240706,경춘선,마석,3153,2978,6131,3065.5
20240706,경춘선,대성리,1082,1360,2442,1221
20240706,경춘선,청평,1920,2077,3997,1998.5
20240706,경춘선,상천,211,288,499,249.5
20240706,경춘선,가평,2156,2867,5023,2511.5
20240706,경춘선,굴봉산,197,166,363,181.5
20240706,경춘선,백양리,85,81,166,83
20240706,경춘선,강촌,554,672,1226,613
20240706,경춘선,김유정,380,472,852,426
20240706,경춘선,남춘천,2878,2994,5872,2936
20240706,경춘선,춘천,1556,1435,2991,1495.5
20240706,공항철도 1호선,서울역,13803,13696,27499,13749.5
20240706,공항철도 1호선,공덕,2358,3627,5985,2992.5
20240706,공항철도 1호선,홍대입구,18115,17247,35362,17681
20240706,공항철도 1호선,디지털미디어시티,7088,6573,13661,6830.5
20240706,공항철도 1호선,마곡나루(서울식물원),5575,5950,11525,5762.5
20240706,공항철도 1호선,김포공항,8727,4960,13687,6843.5
20240706,공항철도 1호선,계양,9547,8700,18247,9123.5
20240706,공항철도 1호선,검암,4366,4727,9093,4546.5
20240706,공항철도 1호선,청라국제도시,5235,5067,10302,5151
20240706,공항철도 1호선,운서,8674,9154,17828,8914
20240706,공항철도 1호선,공항화물청사,1174,1233,2407,1203.5
20240706,공항철도 1호선,인천공항1터미널,15138,13276,28414,14207
20240706,공항철도 1호선,인천공항2터미널,6875,5603,12478,6239
20240706,공항철도 1호선,영종,3905,3990,7895,3947.5
20240706,과천선,선바위,5118,4256,9374,4687
20240706,과천선,경마공원,11984,11847,23831,11915.5
20240706,과천선,대공원,3846,4035,7881,3940.5
20240706,과천선,과천,5070,4566,9636,4818
20240706,과천선,정부과천청사,6939,6759,13698,6849
20240706,과천선,인덕원,17508,17374,34882,17441
20240706,과천선,평촌,9579,8971,18550,9275
20240706,과천선,범계,22915,22727,45642,22821
20240706,분당선,선릉,5703,8953,14656,7328
20240706,분당선,한티,13077,12709,25786,12893
20240706,분당선,도곡,5273,4709,9982,4991
20240706,분당선,구룡,2835,2350,5185,2592.5
20240706,분당선,개포동,3254,3169,6423,3211.5
20240706,분당선,대모산입구,4206,3908,8114,4057
20240706,분당선,수서,13597,14574,28171,14085.5
20240706,분당선,복정,16,0,16,8
20240706,분당선,수원,7855,7263,15118,7559
20240706,분당선,서울숲,9260,9198,18458,9229
20240706,분당선,압구정로데오,18046,20666,38712,19356
20240706,분당선,강남구청,5375,6557,11932,5966
20240706,분당선,선정릉,3370,3362,6732,3366
20240706,분당선,가천대,5464,5507,10971,5485.5
20240706,분당선,태평,10662,10016,20678,10339
20240706,분당선,모란,16212,16591,32803,16401.5
20240706,분당선,야탑,18224,19317,37541,18770.5
20240706,분당선,서현,19284,19338,38622,19311
20240706,분당선,수내,8823,8417,17240,8620
20240706,분당선,정자,10875,11086,21961,10980.5
20240706,분당선,미금,10646,10880,21526,10763
20240706,분당선,오리,8105,6851,14956,7478
20240706,분당선,이매,4626,4455,9081,4540.5
20240706,분당선,보정,1796,1660,3456,1728
20240706,분당선,죽전,9776,10837,20613,10306.5
20240706,분당선,구성,4916,5002,9918,4959
20240706,분당선,신갈,3046,3041,6087,3043.5
20240706,분당선,기흥,7331,6936,14267,7133.5
20240706,분당선,상갈,4099,4085,8184,4092
20240706,분당선,청명,3267,3172,6439,3219.5
20240706,분당선,영통,7609,7370,14979,7489.5
20240706,분당선,망포,10754,9634,20388,10194
20240706,분당선,매탄권선,4143,3764,7907,3953.5
20240706,분당선,수원시청,12709,14238,26947,13473.5
20240706,분당선,매교,3583,3479,7062,3531
20240706,서해선,김포공항,3096,3956,7052,3526
20240706,서해선,원종,4233,4068,8301,4150.5
20240706,서해선,부천종합운동장,1891,1454,3345,1672.5
20240706,수인선,고색,3101,2983,6084,3042
20240706,수인선,오목천,3144,2650,5794,2897
20240706,수인선,어천,1375,1129,2504,1252
20240706,수인선,야목,333,303,636,318
20240706,수인선,사리,4222,3453,7675,3837.5
20240706,수인선,달월,49,47,96,48
20240706,수인선,월곶,2430,2230,4660,2330
20240706,수인선,소래포구,4710,4670,9380,4690
20240706,수인선,인천논현,4672,4794,9466,4733
20240706,수인선,호구포,2685,2552,5237,2618.5
20240706,수인선,남동인더스파크,952,919,1871,935.5
20240706,수인선,원인재,3720,3848,7568,3784
20240706,수인선,연수,4402,4488,8890,4445
20240706,수인선,송도,2028,1918,3946,1973
20240706,수인선,인하대,4554,4218,8772,4386
20240706,수인선,숭의,3014,2647,5661,2830.5
20240706,수인선,신포,1485,1527,3012,1506
20240706,수인선,인천,1017,1769,2786,1393
20240706,신림선,샛강,1077,1374,2451,1225.5
20240706,신림선,대방,2544,1799,4343,2171.5
20240706,신림선,서울지방병무청,2092,2287,4379,2189.5
20240706,신림선,보라매,2756,2516,5272,2636
20240706,신림선,보라매공원,1495,1508,3003,1501.5
20240706,신림선,보라매병원,3671,3717,7388,3694
20240706,신림선,당곡,3706,3394,7100,3550
20240706,신림선,신림,1619,2058,3677,1838.5
20240706,신림선,서원,2790,2393,5183,2591.5
20240706,신림선,서울대벤처타운,8068,7055,15123,7561.5
20240706,신림선,관악산(서울대),2784,2893,5677,2838.5
20240706,안산선,산본,13736,14471,28207,14103.5
20240706,안산선,대야미,4124,3549,7673,3836.5
20240706,안산선,반월,3644,3420,7064,3532
20240706,안산선,상록수,12479,12491,24970,12485
20240706,안산선,한대앞,7394,7415,14809,7404.5
20240706,안산선,중앙,17302,18045,35347,17673.5
20240706,안산선,고잔,6728,6627,13355,6677.5
20240706,안산선,초지,3764,3825,7589,3794.5
20240706,안산선,안산,10604,11588,22192,11096
20240706,안산선,신길온천,1856,1664,3520,1760
20240706,안산선,정왕,7648,7700,15348,7674
20240706,안산선,오이도,7201,7208,14409,7204.5
20240706,안산선,수리산,3036,2510,5546,2773
20240706,우이신설선,북한산우이,3696,3909,7605,3802.5
20240706,우이신설선,솔밭공원,2119,1889,4008,2004
20240706,우이신설선,4.19민주묘지,2572,2284,4856,2428
20240706,우이신설선,가오리,3589,3271,6860,3430
20240706,우이신설선,화계,2789,2576,5365,2682.5
20240706,우이신설선,삼양,1598,1703,3301,1650.5
20240706,우이신설선,삼양사거리,2176,2099,4275,2137.5
20240706,우이신설선,솔샘,4125,3676,7801,3900.5
20240706,우이신설선,북한산보국문,5116,4256,9372,4686
20240706,우이신설선,정릉,3821,3091,6912,3456
20240706,우이신설선,성신여대입구(돈암),3229,3741,6970,3485
20240706,우이신설선,보문,1350,1311,2661,1330.5
20240706,우이신설선,신설동,1612,1539,3151,1575.5
20240706,일산선,원흥,8164,7742,15906,7953
20240706,일산선,지축,3,0,3,1.5
20240706,일산선,삼송,14896,14300,29196,14598
20240706,일산선,원당,8549,8186,16735,8367.5
20240706,일산선,화정,13824,14335,28159,14079.5
20240706,일산선,대곡,2160,2043,4203,2101.5
20240706,일산선,백석,8186,8405,16591,8295.5
20240706,일산선,마두,5667,5618,11285,5642.5
20240706,일산선,정발산,6794,7180,13974,6987
20240706,일산선,주엽,7656,7601,15257,7628.5
20240706,일산선,대화,13966,14103,28069,14034.5
20240706,장항선,봉명,895,832,1727,863.5
20240706,장항선,쌍용(나사렛대),2061,1950,4011,2005.5
20240706,장항선,아산,3854,3457,7311,3655.5
20240706,장항선,탕정,1534,1398,2932,1466
20240706,장항선,배방,1282,1226,2508,1254
20240706,중앙선,구리,10605,10793,21398,10699
20240706,중앙선,양원,2056,1975,4031,2015.5
20240706,중앙선,망우,6775,6545,13320,6660
20240706,중앙선,상봉,5031,4826,9857,4928.5
20240706,중앙선,중랑,4521,4381,8902,4451
20240706,중앙선,회기,20284,18555,38839,19419.5
20240706,장항선,신창(순천향대),1124,1075,2199,1099.5
20240706,장항선,온양온천,4709,4683,9392,4696
20240706,중앙선,지평,51,64,115,57.5
20240706,중앙선,용문,1875,2192,4067,2033.5
20240706,중앙선,원덕,348,373,721,360.5
20240706,중앙선,양평,3005,3224,6229,3114.5
20240706,중앙선,오빈,271,311,582,291
20240706,중앙선,아신,470,495,965,482.5
20240706,중앙선,국수,582,606,1188,594
20240706,중앙선,신원,168,163,331,165.5
20240706,중앙선,양수,2293,2373,4666,2333
20240706,중앙선,운길산,794,819,1613,806.5
20240706,중앙선,팔당,970,1009,1979,989.5
20240706,중앙선,도심,1643,1387,3030,1515
20240706,중앙선,덕소,4470,4425,8895,4447.5
20240706,중앙선,양정,491,412,903,451.5
20240706,중앙선,도농,7529,7152,14681,7340.5
20240707,중앙선,양수,2688,2425,5113,2556.5
20240707,중앙선,운길산,993,976,1969,984.5
20240707,중앙선,팔당,1141,1146,2287,1143.5
20240707,중앙선,도심,1365,1178,2543,1271.5
20240707,중앙선,덕소,3501,3452,6953,3476.5
20240707,중앙선,양정,422,339,761,380.5
20240707,중앙선,도농,5898,5858,11756,5878
20240707,중앙선,구리,7981,8243,16224,8112
20240707,중앙선,양원,1671,1648,3319,1659.5
20240707,중앙선,망우,5462,5528,10990,5495
20240707,중앙선,상봉,4180,4219,8399,4199.5
20240707,중앙선,중랑,3671,3496,7167,3583.5
20240707,중앙선,회기,16148,16077,32225,16112.5
20240707,장항선,신창(순천향대),935,1081,2016,1008
20240707,장항선,온양온천,3433,3559,6992,3496
20240707,장항선,배방,861,955,1816,908
20240707,장항선,탕정,950,1048,1998,999
20240707,장항선,아산,3642,2316,5958,2979
20240707,장항선,쌍용(나사렛대),1302,1391,2693,1346.5
20240707,장항선,봉명,563,548,1111,555.5
20240707,일산선,대화,12510,11373,23883,11941.5
20240707,일산선,주엽,5947,5837,11784,5892
20240707,일산선,정발산,5894,5756,11650,5825
20240707,일산선,마두,4001,4012,8013,4006.5
20240707,일산선,백석,6414,6222,12636,6318
20240707,일산선,대곡,1824,1618,3442,1721
20240707,일산선,화정,11526,11615,23141,11570.5
20240707,일산선,원당,6641,6313,12954,6477
20240707,일산선,삼송,11766,11804,23570,11785
20240707,일산선,지축,1,0,1,0.5
20240707,일산선,원흥,6476,6282,12758,6379
20240707,우이신설선,신설동,1608,1523,3131,1565.5
20240707,우이신설선,보문,1145,1201,2346,1173
20240707,우이신설선,성신여대입구(돈암),2765,3096,5861,2930.5
20240707,우이신설선,정릉,3217,2754,5971,2985.5
20240707,우이신설선,북한산보국문,4323,3892,8215,4107.5
20240707,우이신설선,솔샘,3222,3122,6344,3172
20240707,우이신설선,삼양사거리,1870,1753,3623,1811.5
20240707,우이신설선,삼양,1363,1415,2778,1389
20240707,우이신설선,화계,2666,2474,5140,2570
20240707,우이신설선,가오리,2735,2640,5375,2687.5
20240707,우이신설선,4.19민주묘지,2408,2120,4528,2264
20240707,우이신설선,솔밭공원,1808,1765,3573,1786.5
20240707,우이신설선,북한산우이,4268,4253,8521,4260.5
20240707,안산선,수리산,2380,2149,4529,2264.5
20240707,안산선,오이도,5732,5629,11361,5680.5
20240707,안산선,정왕,6459,6868,13327,6663.5
20240707,안산선,신길온천,1603,1370,2973,1486.5
20240707,안산선,안산,11373,10332,21705,10852.5
20240707,안산선,초지,2863,2778,5641,2820.5
20240707,안산선,고잔,5487,5453,10940,5470
20240707,안산선,중앙,12799,12954,25753,12876.5
20240707,안산선,한대앞,5966,5828,11794,5897
20240707,안산선,상록수,9499,9424,18923,9461.5
20240707,안산선,반월,2747,2644,5391,2695.5
20240707,안산선,대야미,3097,2868,5965,2982.5
20240707,안산선,산본,10068,10611,20679,10339.5
20240707,신림선,관악산(서울대),3865,4152,8017,4008.5
20240707,신림선,서울대벤처타운,6469,6216,12685,6342.5
20240707,신림선,서원,2121,2153,4274,2137
20240707,신림선,신림,1461,1819,3280,1640
20240707,신림선,당곡,2928,3043,5971,2985.5
20240707,신림선,보라매병원,2633,2744,5377,2688.5
20240707,신림선,보라매공원,1239,1331,2570,1285
20240707,신림선,보라매,2396,2160,4556,2278
20240707,신림선,서울지방병무청,1772,2093,3865,1932.5
20240707,신림선,대방,1725,1459,3184,1592
20240707,신림선,샛강,991,1137,2128,1064
20240707,수인선,인천,996,1520,2516,1258
20240707,수인선,신포,1266,1213,2479,1239.5
20240707,수인선,숭의,2320,2197,4517,2258.5
20240707,수인선,인하대,3510,3429,6939,3469.5
20240707,수인선,송도,1634,1563,3197,1598.5
20240707,수인선,연수,3757,3609,7366,3683
20240707,수인선,원인재,2924,3020,5944,2972
20240707,수인선,남동인더스파크,652,687,1339,669.5
20240707,수인선,호구포,2187,2237,4424,2212
20240707,수인선,인천논현,3222,3379,6601,3300.5
20240707,수인선,소래포구,3877,3686,7563,3781.5
20240707,수인선,월곶,1906,1841,3747,1873.5
20240707,수인선,달월,59,49,108,54
20240707,수인선,사리,3065,2634,5699,2849.5
20240707,수인선,야목,272,223,495,247.5
20240707,수인선,어천,986,1131,2117,1058.5
20240707,수인선,오목천,2098,2063,4161,2080.5
20240707,수인선,고색,2129,2226,4355,2177.5
20240707,서해선,부천종합운동장,1401,1160,2561,1280.5
20240707,서해선,원종,3055,3127,6182,3091
20240707,서해선,김포공항,2859,3384,6243,3121.5
20240707,분당선,매교,2543,2634,5177,2588.5
20240707,분당선,수원시청,8620,8534,17154,8577
20240707,분당선,매탄권선,3074,2951,6025,3012.5
20240707,분당선,망포,7018,7617,14635,7317.5
20240707,분당선,영통,5656,5588,11244,5622
20240707,분당선,청명,2398,2543,4941,2470.5
20240707,분당선,상갈,2965,3143,6108,3054
20240707,분당선,기흥,5410,5152,10562,5281
20240707,분당선,신갈,2189,2310,4499,2249.5
20240707,분당선,구성,3599,3766,7365,3682.5
20240707,분당선,죽전,7783,8961,16744,8372
20240707,분당선,보정,1263,1254,2517,1258.5
20240707,분당선,이매,3731,3875,7606,3803
20240707,분당선,오리,5723,4985,10708,5354
20240707,분당선,미금,8234,8471,16705,8352.5
20240707,분당선,정자,7869,8081,15950,7975
20240707,분당선,수내,6380,6332,12712,6356
20240707,분당선,서현,14804,14872,29676,14838
20240707,분당선,야탑,14034,14288,28322,14161
20240707,분당선,모란,11616,12160,23776,11888
20240707,분당선,태평,8385,7770,16155,8077.5
20240707,분당선,가천대,4494,4889,9383,4691.5
20240707,분당선,선정릉,2140,2264,4404,2202
20240707,분당선,강남구청,3197,3912,7109,3554.5
20240707,분당선,압구정로데오,10675,11114,21789,10894.5
20240707,분당선,서울숲,7483,7388,14871,7435.5
20240707,분당선,수원,6254,5660,11914,5957
20240707,분당선,복정,5,0,5,2.5
20240707,분당선,수서,10617,10769,21386,10693
20240707,분당선,대모산입구,3048,3026,6074,3037
20240707,분당선,개포동,2716,2747,5463,2731.5
20240707,분당선,구룡,1964,2083,4047,2023.5
20240707,분당선,도곡,3586,3558,7144,3572
20240707,분당선,한티,9993,10135,20128,10064
20240707,분당선,선릉,3199,4916,8115,4057.5
20240707,과천선,범계,16606,16127,32733,16366.5
20240707,과천선,평촌,6628,6447,13075,6537.5
20240707,과천선,인덕원,13416,13702,27118,13559
20240707,과천선,정부과천청사,5013,5113,10126,5063
20240707,과천선,과천,4156,3880,8036,4018
20240707,과천선,대공원,4148,4203,8351,4175.5
20240707,과천선,경마공원,14576,14350,28926,14463
20240707,과천선,선바위,4021,3446,7467,3733.5
20240707,공항철도 1호선,영종,3295,3151,6446,3223
20240707,공항철도 1호선,인천공항2터미널,6300,5766,12066,6033
20240707,공항철도 1호선,인천공항1터미널,14574,14973,29547,14773.5
20240707,공항철도 1호선,공항화물청사,997,1040,2037,1018.5
20240707,공항철도 1호선,운서,7736,8421,16157,8078.5
20240707,공항철도 1호선,청라국제도시,4259,4106,8365,4182.5
20240707,공항철도 1호선,검암,3705,3823,7528,3764
20240707,공항철도 1호선,계양,7451,7067,14518,7259
20240707,공항철도 1호선,김포공항,8438,4579,13017,6508.5
20240707,공항철도 1호선,마곡나루(서울식물원),3966,4357,8323,4161.5
20240707,공항철도 1호선,디지털미디어시티,4041,4242,8283,4141.5
20240707,공항철도 1호선,홍대입구,16318,14441,30759,15379.5
20240707,공항철도 1호선,공덕,1825,2602,4427,2213.5
20240707,공항철도 1호선,서울역,14204,12456,26660,13330
20240707,경춘선,춘천,1750,1438,3188,1594
20240707,경춘선,김유정,417,398,815,407.5
20240707,경춘선,강촌,832,504,1336,668
20240707,경춘선,백양리,114,71,185,92.5
20240707,경춘선,굴봉산,234,165,399,199.5
20240707,경춘선,가평,2994,2122,5116,2558
20240707,경춘선,상천,513,397,910,455
20240707,경춘선,청평,2141,1718,3859,1929.5
20240707,경춘선,대성리,1320,599,1919,959.5
20240707,경춘선,마석,2778,2671,5449,2724.5
20240707,경춘선,천마산,1087,1027,2114,1057
20240707,경춘선,평내호평,3588,3447,7035,3517.5
20240707,경춘선,금곡,914,846,1760,880
20240707,경춘선,사릉,1273,1296,2569,1284.5
20240707,경춘선,퇴계원,2109,1991,4100,2050
20240707,경춘선,별내,2120,2019,4139,2069.5
20240707,경춘선,갈매,1643,1411,3054,1527
20240707,경춘선,신내,1374,1334,2708,1354
20240707,경인선,도화,2594,2442,5036,2518
20240707,경인선,중동,5658,5287,10945,5472.5
20240707,경인선,온수(성공회대입구),4281,4014,8295,4147.5
20240707,경인선,도원,1898,1962,3860,1930
20240707,경인선,간석,3506,3423,6929,3464.5
20240707,경인선,부개,5295,5027,10322,5161
20240707,경인선,소사,5190,4908,10098,5049
20240707,경인선,구일,3534,3548,7082,3541
20240707,경인선,인천,4093,3361,7454,3727
20240707,경인선,동인천,9835,9471,19306,9653
20240707,경인선,제물포,5646,5535,11181,5590.5
20240707,경인선,주안,12704,11006,23710,11855
20240707,경인선,동암,10252,9983,20235,10117.5
20240707,경인선,백운,4679,4676,9355,4677.5
20240707,경인선,부평,23248,22808,46056,23028
20240707,경인선,송내,13893,13630,27523,13761.5
20240707,경인선,부천,23530,23275,46805,23402.5
20240707,경인선,역곡,14648,14505,29153,14576.5
20240707,경인선,오류동,7295,6979,14274,7137
20240707,경인선,개봉,12577,12643,25220,12610
20240707,경의선,운천,11,6,17,8.5
20240707,경의선,임진강,105,113,218,109
20240707,경의선,문산,4050,4494,8544,4272
20240707,경의선,파주,798,821,1619,809.5
20240707,경의선,월롱,874,1236,2110,1055
20240707,경의선,금촌,4638,5078,9716,4858
20240707,경의선,금릉,3506,3395,6901,3450.5
20240707,경의선,운정,4417,4314,8731,4365.5
20240707,경의선,야당,6422,6409,12831,6415.5
20240707,경의선,탄현,4854,4520,9374,4687
20240707,경의선,일산,6319,5979,12298,6149
20240707,경의선,풍산,4392,4215,8607,4303.5
20240707,경의선,백마,4114,4123,8237,4118.5
20240707,경의선,곡산,416,430,846,423
20240707,경의선,능곡,2913,2813,5726,2863
20240707,경의선,행신,5100,4924,10024,5012
20240707,경의선,강매,1660,1485,3145,1572.5
20240707,경의선,한국항공대,984,1062,2046,1023
20240707,경의선,수색,1331,1423,2754,1377
20240707,경의선,디지털미디어시티,1727,1705,3432,1716
20240707,경의선,가좌,3169,3281,6450,3225
20240707,경의선,홍대입구,2510,3088,5598,2799
20240707,경의선,서강대,1579,1474,3053,1526.5
20240707,경의선,공덕,2616,1930,4546,2273
20240707,경의선,효창공원앞,1523,1802,3325,1662.5
20240707,경의선,신촌,345,434,779,389.5
20240707,경의선,서울역,1278,1227,2505,1252.5
20240707,경원선,연천,1586,1598,3184,1592
20240707,경원선,전곡,1278,1234,2512,1256
20240707,경원선,청산,153,131,284,142
20240707,경원선,소요산,2937,2992,5929,2964.5
20240707,경원선,동두천,1156,1282,2438,1219
20240707,경원선,보산,1294,1620,2914,1457
20240707,경원선,동두천중앙,2163,2116,4279,2139.5
20240707,경원선,지행,4904,5125,10029,5014.5
20240707,경원선,덕정,3969,4184,8153,4076.5
20240707,경원선,덕계,3821,3433,7254,3627
20240707,경원선,양주,5512,5296,10808,5404
20240707,경원선,녹양,2875,2724,5599,2799.5
20240707,경원선,가능,4167,4039,8206,4103
20240707,경원선,의정부,15205,15034,30239,15119.5
20240707,경원선,회룡,8601,8526,17127,8563.5
20240707,경원선,망월사,4974,5020,9994,4997
20240707,경원선,도봉산,9142,6448,15590,7795
20240707,경원선,도봉,3820,3646,7466,3733
20240707,경원선,방학,6714,6440,13154,6577
20240707,경원선,창동,2,0,2,1
20240707,경원선,녹천,2680,2432,5112,2556
20240707,경원선,월계,4041,3819,7860,3930
20240707,경원선,광운대,4868,4865,9733,4866.5
20240707,경원선,석계,4873,5314,10187,5093.5
20240707,경원선,신이문,5058,4820,9878,4939
20240707,경원선,외대앞,5236,5185,10421,5210.5
20240707,경원선,청량리(서울시립대입구),16510,15032,31542,15771
20240707,경원선,왕십리(성동구청),12205,12348,24553,12276.5
20240707,경원선,응봉,1191,1083,2274,1137
20240707,경원선,옥수,62,34,96,48
20240707,경원선,한남,1769,1760,3529,1764.5
20240707,경원선,서빙고,2185,2286,4471,2235.5
20240707,경원선,이촌(국립중앙박물관),2730,2321,5051,2525.5
20240707,경부선,광명,3577,2511,6088,3044
20240707,경부선,서동탄,859,903,1762,881
20240707,경부선,당정,3275,3191,6466,3233
20240707,경부선,천안,6316,6211,12527,6263.5
20240707,경부선,두정,5188,5785,10973,5486.5
20240707,경부선,직산,685,801,1486,743
20240707,경부선,성환,2775,3068,5843,2921.5
20240707,경부선,평택,12350,13074,25424,12712
20240707,경부선,평택지제,3372,3037,6409,3204.5
20240707,경부선,서정리,5493,7182,12675,6337.5
20240707,경부선,송탄,3836,4418,8254,4127
20240707,경부선,진위,1033,1073,2106,1053
20240707,경부선,오산,8251,8770,17021,8510.5
20240707,경부선,오산대,2378,2291,4669,2334.5
20240707,경부선,세마,2090,1964,4054,2027
20240707,경부선,병점,10135,11080,21215,10607.5
20240707,경부선,세류,2332,2256,4588,2294
20240707,경부선,독산,6817,6971,13788,6894
20240707,경부선,수원,37404,36411,73815,36907.5
20240707,경부선,화서,10234,9785,20019,10009.5
20240707,경부선,성균관대,8880,9166,18046,9023
20240707,경부선,의왕,4526,4554,9080,4540
20240707,경부선,군포,3051,2998,6049,3024.5
20240707,경부선,금정,15780,16185,31965,15982.5
20240707,경부선,명학,3498,3371,6869,3434.5
20240707,경부선,안양,14215,13715,27930,13965
20240707,경부선,관악,5347,4969,10316,5158
20240707,경부선,석수,5128,5040,10168,5084
20240707,경부선,금천구청,6424,6266,12690,6345
20240707,경부선,가산디지털단지,4992,6705,11697,5848.5
20240707,경부선,구로,11125,11425,22550,11275
20240707,경부선,신길,5097,4569,9666,4833
20240707,경부선,신도림,2386,2904,5290,2645
20240707,경부선,영등포,38753,36965,75718,37859
20240707,경부선,대방,5388,6363,11751,5875.5
20240707,경부선,노량진,5705,5583,11288,5644
20240707,경부선,용산,43319,38541,81860,40930
20240707,경부선,남영,5353,5821,11174,5587
20240707,경부선,서울역,11049,3146,14195,7097.5
20240707,경강선,성남,607,567,1174,587
20240707,경강선,여주,2716,2615,5331,2665.5
20240707,경강선,세종대왕릉,327,281,608,304
20240707,경강선,부발,1701,2078,3779,1889.5
20240707,경강선,이천,2515,2737,5252,2626
20240707,경강선,신둔도예촌,1016,1013,2029,1014.5
20240707,경강선,곤지암,1716,1853,3569,1784.5
20240707,경강선,초월,1844,1799,3643,1821.5
20240707,경강선,경기광주,4348,4529,8877,4438.5
20240707,경강선,삼동,1146,1181,2327,1163.5
20240707,경강선,이매,738,538,1276,638
20240707,경강선,판교,3197,2813,6010,3005
20240707,9호선2~3단계,중앙보훈병원,4578,4359,8937,4468.5
20240707,9호선2~3단계,둔촌오륜,827,874,1701,850.5
20240707,9호선2~3단계,올림픽공원(한국체대),4958,4955,9913,4956.5
20240707,9호선2~3단계,한성백제,1787,1679,3466,1733
20240707,9호선2~3단계,송파나루,3615,3810,7425,3712.5
20240707,9호선2~3단계,석촌,5682,4938,10620,5310
20240707,9호선2~3단계,석촌고분,3821,3956,7777,3888.5
20240707,9호선2~3단계,삼전,4131,4176,8307,4153.5
20240707,9호선2~3단계,종합운동장,4021,3335,7356,3678
20240707,9호선2~3단계,봉은사,16184,17331,33515,16757.5
20240707,9호선2~3단계,삼성중앙,2470,2400,4870,2435
20240707,9호선2~3단계,선정릉,3370,3904,7274,3637
20240707,9호선2~3단계,언주,4779,4777,9556,4778
20240707,9호선,신논현,17868,17153,35021,17510.5
20240707,9호선,사평,2251,2274,4525,2262.5
20240707,9호선,고속터미널,13073,18925,31998,15999
20240707,9호선,신반포,2577,2546,5123,2561.5
20240707,9호선,구반포,361,401,762,381
20240707,9호선,동작(현충원),1172,1075,2247,1123.5
20240707,9호선,흑석(중앙대입구),4412,4593,9005,4502.5
20240707,9호선,노들,3059,2666,5725,2862.5
20240707,9호선,노량진,15579,16411,31990,15995
20240707,9호선,샛강,2350,2249,4599,2299.5
20240707,9호선,여의도,12653,10879,23532,11766
20240707,9호선,국회의사당,7031,6549,13580,6790
20240707,9호선,당산,10282,10093,20375,10187.5
20240707,9호선,선유도,3326,3272,6598,3299
20240707,9호선,신목동,2205,2072,4277,2138.5
20240707,9호선,염창,9459,9250,18709,9354.5
20240707,9호선,등촌,5926,6127,12053,6026.5
20240707,9호선,증미,2869,2914,5783,2891.5
20240707,9호선,가양,13104,12459,25563,12781.5
20240707,9호선,양천향교,4828,5175,10003,5001.5
20240707,9호선,마곡나루(서울식물원),6707,6715,13422,6711
20240707,9호선,신방화,4010,4252,8262,4131
20240707,9호선,공항시장,1945,2202,4147,2073.5
20240707,9호선,김포공항,6209,9828,16037,8018.5
20240707,9호선,개화,1275,1114,2389,1194.5
20240707,8호선,남위례,3562,3580,7142,3571
20240707,8호선,모란,2857,2388,5245,2622.5
20240707,8호선,수진,3755,3585,7340,3670
20240707,8호선,신흥,3367,3440,6807,3403.5
20240707,8호선,단대오거리,6084,5949,12033,6016.5
20240707,8호선,남한산성입구(성남법원.검찰청),6898,6156,13054,6527
20240707,8호선,산성,3487,3715,7202,3601
20240707,8호선,복정,5339,4930,10269,5134.5
20240707,8호선,장지,9760,9270,19030,9515
20240707,8호선,문정,6804,6974,13778,6889
20240707,8호선,가락시장,3517,4355,7872,3936
20240707,8호선,송파,5044,5345,10389,5194.5
20240707,8호선,석촌,4589,5797,10386,5193
20240707,8호선,잠실(송파구청),13270,13862,27132,13566
20240707,8호선,몽촌토성(평화의문),3757,3826,7583,3791.5
20240707,8호선,강동구청,5175,5370,10545,5272.5
20240707,8호선,천호(풍납토성),9474,10591,20065,10032.5
20240707,8호선,암사,9755,9307,19062,9531
20240707,7호선,온수(성공회대입구),4423,4416,8839,4419.5
20240707,7호선,천왕,5605,5525,11130,5565
20240707,7호선,광명사거리,12495,12534,25029,12514.5
20240707,7호선,철산,11040,11097,22137,11068.5
20240707,7호선,가산디지털단지,10211,9426,19637,9818.5
20240707,7호선,남구로,7035,7105,14140,7070
20240707,7호선,대림(구로구청),9440,8790,18230,9115
20240707,7호선,신풍,6667,6323,12990,6495
20240707,7호선,보라매,4055,4305,8360,4180
20240707,7호선,신대방삼거리,8409,8261,16670,8335
20240707,7호선,장승배기,5130,5247,10377,5188.5
20240707,7호선,상도,6335,6262,12597,6298.5
20240707,7호선,숭실대입구(살피재),6559,6722,13281,6640.5
20240707,7호선,남성,6640,6745,13385,6692.5
20240707,7호선,이수,9669,9365,19034,9517
20240707,7호선,내방,5759,5929,11688,5844
20240707,7호선,고속터미널,14330,9739,24069,12034.5
20240707,7호선,반포,3642,3487,7129,3564.5
20240707,7호선,논현,6111,6583,12694,6347
20240707,7호선,학동,7373,7718,15091,7545.5
20240707,7호선,강남구청,5589,6124,11713,5856.5
20240707,7호선,청담,7075,7626,14701,7350.5
20240707,7호선,자양(뚝섬한강공원),7288,7090,14378,7189
20240707,7호선,건대입구,8398,8629,17027,8513.5
20240707,7호선,어린이대공원(세종대),8440,8553,16993,8496.5
20240707,7호선,군자(능동),9159,7010,16169,8084.5
20240707,7호선,중곡,5736,5518,11254,5627
20240707,7호선,용마산(용마폭포공원),3469,3763,7232,3616
20240707,7호선,사가정,9465,9267,18732,9366
20240707,7호선,면목,8250,8106,16356,8178
20240707,7호선,상봉,11013,10370,21383,10691.5
20240707,7호선,중화,6098,5908,12006,6003
20240707,7호선,먹골,6102,5992,12094,6047
20240707,7호선,태릉입구,5565,5194,10759,5379.5
20240707,7호선,공릉(서울과학기술대),7172,7251,14423,7211.5
20240707,7호선,하계,10197,9660,19857,9928.5
20240707,7호선,중계,8171,7778,15949,7974.5
20240707,7호선,노원,15574,15797,31371,15685.5
20240707,7호선,마들,6578,6239,12817,6408.5
20240707,7호선,수락산,8526,8359,16885,8442.5
20240707,7호선,도봉산,5581,7970,13551,6775.5
20240707,7호선,장암,1757,1247,3004,1502
20240707,6호선,신내,1,0,1,0.5
20240707,6호선,봉화산(서울의료원),4521,4535,9056,4528
20240707,6호선,화랑대(서울여대입구),6260,5379,11639,5819.5
20240707,6호선,태릉입구,3598,3873,7471,3735.5
20240707,6호선,석계,6981,7332,14313,7156.5
20240707,6호선,돌곶이,6643,6373,13016,6508
20240707,6호선,상월곡(한국과학기술연구원),3692,3466,7158,3579
20240707,6호선,월곡(동덕여대),5843,5783,11626,5813
20240707,6호선,고려대(종암),4263,4310,8573,4286.5
20240707,6호선,안암(고대병원앞),5529,5848,11377,5688.5
20240707,6호선,보문,4649,4516,9165,4582.5
20240707,6호선,창신,1957,1765,3722,1861
20240707,6호선,동묘앞,7691,7554,15245,7622.5
20240707,6호선,신당,5144,5598,10742,5371
20240707,6호선,청구,2030,1854,3884,1942
20240707,6호선,약수,2016,1987,4003,2001.5
20240707,6호선,버티고개,1121,1240,2361,1180.5
20240707,6호선,한강진,8717,9553,18270,9135
20240707,6호선,이태원,10807,9238,20045,10022.5
20240707,6호선,녹사평(용산구청),4066,4073,8139,4069.5
20240707,6호선,삼각지,5257,4470,9727,4863.5
20240707,6호선,효창공원앞,3750,3325,7075,3537.5
20240707,6호선,공덕,8121,8048,16169,8084.5
20240707,6호선,대흥(서강대앞),4488,4756,9244,4622
20240707,6호선,광흥창(서강),4923,4750,9673,4836.5
20240707,6호선,상수,8053,8411,16464,8232
20240707,6호선,합정,10545,9846,20391,10195.5
20240707,6호선,망원,10913,11533,22446,11223
20240707,6호선,마포구청,7510,7285,14795,7397.5
20240707,6호선,월드컵경기장(성산),4177,4136,8313,4156.5
20240707,6호선,디지털미디어시티,6194,6668,12862,6431
20240707,6호선,증산(명지대앞),5937,6002,11939,5969.5
20240707,6호선,새절(신사),7160,6886,14046,7023
20240707,6호선,구산,4743,3857,8600,4300
20240707,6호선,연신내,1,0,1,0.5
20240707,6호선,독바위,1616,2018,3634,1817
20240707,6호선,불광,3543,3057,6600,3300
20240707,6호선,역촌,2230,2601,4831,2415.5
20240707,6호선,응암,10384,10534,20918,10459
20240707,5호선,하남검단산,5382,5454,10836,5418
20240707,5호선,하남시청(덕풍·신장),5078,4851,9929,4964.5
20240707,5호선,하남풍산,3064,2887,5951,2975.5
20240707,5호선,미사,10841,11102,21943,10971.5
20240707,5호선,강일,3590,3253,6843,3421.5
20240707,5호선,마천,4107,4174,8281,4140.5
20240707,5호선,거여,5021,4979,10000,5000
20240707,5호선,개롱,3366,3618,6984,3492
20240707,5호선,오금,1885,1808,3693,1846.5
20240707,5호선,방이,4494,4316,8810,4405
20240707,5호선,올림픽공원(한국체대),3107,2770,5877,2938.5
20240707,5호선,둔촌동,5463,5461,10924,5462
20240707,5호선,상일동,7487,7560,15047,7523.5
20240707,5호선,고덕,5226,5252,10478,5239
20240707,5호선,명일,5997,6132,12129,6064.5
20240707,5호선,굽은다리(강동구민회관앞),6442,6090,12532,6266
20240707,5호선,길동,5029,4911,9940,4970
20240707,5호선,강동,10122,10574,20696,10348
20240707,5호선,천호(풍납토성),14553,13437,27990,13995
20240707,5호선,광나루(장신대),9698,9488,19186,9593
20240707,5호선,아차산(어린이대공원후문),10673,10459,21132,10566
20240707,5호선,군자(능동),6740,7727,14467,7233.5
20240707,5호선,장한평,9235,9182,18417,9208.5
20240707,5호선,답십리,8386,7682,16068,8034
20240707,5호선,마장,3126,2958,6084,3042
20240707,5호선,왕십리(성동구청),2755,3449,6204,3102
20240707,5호선,행당,4260,3932,8192,4096
20240707,5호선,신금호,3349,3641,6990,3495
20240707,5호선,청구,1955,2040,3995,1997.5
20240707,5호선,동대문역사문화공원(DDP),1216,1463,2679,1339.5
20240707,5호선,을지로4가,2015,2212,4227,2113.5
20240707,5호선,종로3가,10717,9915,20632,10316
20240707,5호선,광화문(세종문화회관),13666,13768,27434,13717
20240707,5호선,서대문,5644,5643,11287,5643.5
20240707,5호선,충정로(경기대입구),1692,1719,3411,1705.5
20240707,5호선,애오개,3015,3131,6146,3073
20240707,5호선,공덕,5359,5600,10959,5479.5
20240707,5호선,마포,5367,5526,10893,5446.5
20240707,5호선,여의나루,7863,9910,17773,8886.5
20240707,5호선,여의도,11511,10840,22351,11175.5
20240707,5호선,신길,2697,2854,5551,2775.5
20240707,5호선,영등포시장,6510,7045,13555,6777.5
20240707,5호선,영등포구청,1882,1763,3645,1822.5
20240707,5호선,양평,3072,3154,6226,3113
20240707,5호선,오목교(목동운동장앞),12376,12425,24801,12400.5
20240707,5호선,목동,8431,8918,17349,8674.5
20240707,5호선,신정(은행정),6783,6125,12908,6454
20240707,5호선,까치산,16255,15878,32133,16066.5
20240707,5호선,화곡,15410,14456,29866,14933
20240707,5호선,우장산,7624,7973,15597,7798.5
20240707,5호선,발산,11091,11564,22655,11327.5
20240707,5호선,마곡,4541,4709,9250,4625
20240707,5호선,송정,3908,3831,7739,3869.5
20240707,5호선,김포공항,9371,6973,16344,8172
20240707,5호선,개화산,3166,3171,6337,3168.5
20240707,5호선,방화,4223,4194,8417,4208.5
20240707,4호선,남태령,928,702,1630,815
20240707,4호선,사당,17013,16549,33562,16781
20240707,4호선,총신대입구(이수),11757,12646,24403,12201.5
20240707,4호선,동작(현충원),1065,1071,2136,1068
20240707,4호선,이촌(국립중앙박물관),6883,7325,14208,7104
20240707,4호선,신용산,12581,13395,25976,12988
20240707,4호선,삼각지,4650,5732,10382,5191
20240707,4호선,숙대입구(갈월),9532,8810,18342,9171
20240707,4호선,서울역,6109,16108,22217,11108.5
20240707,4호선,회현(남대문시장),11125,10961,22086,11043
20240707,4호선,명동,26145,28247,54392,27196
20240707,4호선,충무로,11913,12249,24162,12081
20240707,4호선,동대문역사문화공원(DDP),13631,12306,25937,12968.5
20240707,4호선,동대문,9447,10440,19887,9943.5
20240707,4호선,혜화,26812,27298,54110,27055
20240707,4호선,한성대입구(삼선교),8746,8962,17708,8854
20240707,4호선,성신여대입구(돈암),14268,14032,28300,14150
20240707,4호선,길음,11827,11749,23576,11788
20240707,4호선,미아사거리,17312,16785,34097,17048.5
20240707,4호선,미아(서울사이버대학),8843,8511,17354,8677
20240707,4호선,수유(강북구청),22142,21010,43152,21576
20240707,4호선,쌍문,17617,16145,33762,16881
20240707,4호선,창동,17164,17711,34875,17437.5
20240707,4호선,노원,19004,20262,39266,19633
20240707,4호선,상계,11461,10597,22058,11029
20240707,4호선,당고개,6633,6267,12900,6450
20240707,3호선,오금,3126,3046,6172,3086
20240707,3호선,경찰병원,3276,3376,6652,3326
20240707,3호선,가락시장,4201,4371,8572,4286
20240707,3호선,수서,11728,11851,23579,11789.5
20240707,3호선,일원,4434,4690,9124,4562
20240707,3호선,대청,5013,5072,10085,5042.5
20240707,3호선,학여울,1018,1070,2088,1044
20240707,3호선,대치,6089,5664,11753,5876.5
20240707,3호선,도곡,2571,2622,5193,2596.5
20240707,3호선,매봉,5000,4970,9970,4985
20240707,3호선,양재(서초구청),14741,16686,31427,15713.5
20240707,3호선,남부터미널(예술의전당),14808,15264,30072,15036
20240707,3호선,교대(법원.검찰청),6087,3298,9385,4692.5
20240707,3호선,고속터미널,49073,44739,93812,46906
20240707,3호선,잠원,2695,2738,5433,2716.5
20240707,3호선,신사,13468,13254,26722,13361
20240707,3호선,압구정,15918,16409,32327,16163.5
20240707,3호선,옥수,5343,5603,10946,5473
20240707,3호선,금호,4721,4548,9269,4634.5
20240707,3호선,약수,7744,7625,15369,7684.5
20240707,3호선,동대입구,9548,9817,19365,9682.5
20240707,3호선,충무로,4,0,4,2
20240707,3호선,을지로3가,5186,4846,10032,5016
20240707,3호선,종로3가,5923,6654,12577,6288.5
20240707,3호선,안국,16614,16573,33187,16593.5
20240707,3호선,경복궁(정부서울청사),14948,15307,30255,15127.5
20240707,3호선,독립문,4973,5470,10443,5221.5
20240707,3호선,무악재,2310,2593,4903,2451.5
20240707,3호선,홍제,10699,10431,21130,10565
20240707,3호선,녹번,7955,7226,15181,7590.5
20240707,3호선,불광,10628,11921,22549,11274.5
20240707,3호선,연신내,21469,20531,42000,21000
20240707,3호선,구파발,13944,14242,28186,14093
20240707,3호선,지축,4340,4164,8504,4252
20240707,2호선,용두(동대문구청),1432,1339,2771,1385.5
20240707,2호선,신정네거리,5815,5880,11695,5847.5
20240707,2호선,양천구청,3520,3752,7272,3636
20240707,2호선,도림천,610,720,1330,665
20240707,2호선,신설동,3570,3627,7197,3598.5
20240707,2호선,신답,871,885,1756,878
20240707,2호선,용답,1847,1917,3764,1882
20240707,2호선,충정로(경기대입구),4388,4896,9284,4642
20240707,2호선,이대,9116,10339,19455,9727.5
20240707,2호선,신촌,27610,27410,55020,27510
20240707,2호선,홍대입구,68883,70120,139003,69501.5
20240707,2호선,합정,25298,27084,52382,26191
20240707,2호선,당산,8647,9536,18183,9091.5
20240707,2호선,문래,10044,10661,20705,10352.5
20240707,2호선,신도림,33604,33231,66835,33417.5
20240707,2호선,대림(구로구청),16592,17186,33778,16889
20240707,2호선,구로디지털단지,27516,26829,54345,27172.5
20240707,2호선,신대방,16719,16343,33062,16531
20240707,2호선,신림,36120,35439,71559,35779.5
20240707,2호선,봉천,13789,13428,27217,13608.5
20240707,2호선,서울대입구(관악구청),27959,28233,56192,28096
20240707,2호선,낙성대(강감찬),17187,18009,35196,17598
20240707,2호선,사당,25522,27190,52712,26356
20240707,2호선,방배,7422,7690,15112,7556
20240707,2호선,서초,15110,14122,29232,14616
20240707,2호선,교대(법원.검찰청),10770,12859,23629,11814.5
20240707,2호선,강남,35564,34256,69820,34910
20240707,2호선,역삼,12617,13545,26162,13081
20240707,2호선,선릉,16326,14303,30629,15314.5
20240707,2호선,삼성(무역센터),32645,30082,62727,31363.5
20240707,2호선,종합운동장,8583,9555,18138,9069
20240707,2호선,잠실새내,13591,13714,27305,13652.5
20240707,2호선,잠실(송파구청),57887,54699,112586,56293
20240707,2호선,잠실나루,5859,6187,12046,6023
20240707,2호선,강변(동서울터미널),22401,21342,43743,21871.5
20240707,2호선,구의(광진구청),12911,12877,25788,12894
20240707,2호선,건대입구,27611,28097,55708,27854
20240707,2호선,성수,24675,26878,51553,25776.5
20240707,2호선,뚝섬,13585,13212,26797,13398.5
20240707,2호선,한양대,3046,3212,6258,3129
20240707,2호선,왕십리(성동구청),9697,9494,19191,9595.5
20240707,2호선,상왕십리,7895,8014,15909,7954.5
20240707,2호선,신당,9688,10212,19900,9950
20240707,2호선,동대문역사문화공원(DDP),10852,13172,24024,12012
20240707,2호선,을지로4가,5593,5629,11222,5611
20240707,2호선,을지로3가,12158,11697,23855,11927.5
20240707,2호선,을지로입구,25608,24257,49865,24932.5
20240707,2호선,시청,8892,7060,15952,7976
20240707,1호선,동묘앞,13953,14013,27966,13983
20240707,1호선,청량리(서울시립대입구),16124,16160,32284,16142
20240707,1호선,제기동,10824,11519,22343,11171.5
20240707,1호선,신설동,9024,8928,17952,8976
20240707,1호선,동대문,11000,11850,22850,11425
20240707,1호선,종로5가,11739,10958,22697,11348.5
20240707,1호선,종로3가,15279,14185,29464,14732
20240707,1호선,종각,15037,13569,28606,14303
20240707,1호선,시청,10102,9788,19890,9945
20240707,1호선,서울역,36886,34911,71797,35898.5
20240707,2호선,영등포구청,9422,9797,19219,9609.5
20240707,경춘선,남춘천,3295,3405,6700,3350
20240707,중앙선,신원,175,139,314,157
20240707,중앙선,국수,535,494,1029,514.5
20240707,중앙선,아신,491,480,971,485.5
20240707,중앙선,오빈,316,272,588,294
20240707,중앙선,양평,2705,2512,5217,2608.5
20240707,중앙선,원덕,345,274,619,309.5
20240707,중앙선,용문,2130,1831,3961,1980.5
20240707,중앙선,지평,68,55,123,61.5
20240707,2호선,아현,6413,6286,12699,6349.5
20240708,경춘선,신내,2952,2664,5616,2808
20240708,2호선,용답,2945,2967,5912,2956
20240708,5호선,방이,7488,7779,15267,7633.5
20240708,9호선,양천향교,10772,11152,21924,10962
20240708,수인선,남동인더스파크,2521,2837,5358,2679
20240708,수인선,원인재,4205,4327,8532,4266
20240708,1호선,서울역,53830,50948,104778,52389
20240708,1호선,시청,25882,26016,51898,25949
20240708,1호선,종각,42199,41516,83715,41857.5
20240708,1호선,종로3가,24397,22742,47139,23569.5
20240708,1호선,종로5가,23393,22779,46172,23086
20240708,1호선,동대문,10757,10312,21069,10534.5
20240708,1호선,신설동,14503,14242,28745,14372.5
20240708,1호선,제기동,15486,15442,30928,15464
20240708,1호선,청량리(서울시립대입구),21160,20379,41539,20769.5
20240708,1호선,동묘앞,6892,7028,13920,6960
20240708,2호선,시청,27723,26834,54557,27278.5
20240708,2호선,을지로입구,47899,50154,98053,49026.5
20240708,2호선,을지로3가,26964,26576,53540,26770
20240708,2호선,을지로4가,15015,14762,29777,14888.5
20240708,2호선,동대문역사문화공원(DDP),13717,15778,29495,14747.5
20240708,2호선,신당,14407,14849,29256,14628
20240708,2호선,상왕십리,15189,15111,30300,15150
20240708,2호선,왕십리(성동구청),15622,14027,29649,14824.5
20240708,2호선,한양대,9882,11090,20972,10486
20240708,2호선,뚝섬,24284,25810,50094,25047
20240708,2호선,성수,43387,46613,90000,45000
20240708,2호선,건대입구,33245,35081,68326,34163
20240708,2호선,구의(광진구청),26048,25366,51414,25707
20240708,2호선,강변(동서울터미널),29755,27511,57266,28633
20240708,2호선,잠실나루,16394,16067,32461,16230.5
20240708,2호선,잠실(송파구청),72277,71795,144072,72036
20240708,2호선,잠실새내,24457,23622,48079,24039.5
20240708,2호선,종합운동장,8004,8551,16555,8277.5
20240708,2호선,삼성(무역센터),56987,58177,115164,57582
20240708,2호선,선릉,64337,57061,121398,60699
20240708,2호선,역삼,59564,67224,126788,63394
20240708,2호선,강남,86440,84457,170897,85448.5
20240708,2호선,교대(법원.검찰청),33831,40260,74091,37045.5
20240708,2호선,서초,22939,22417,45356,22678
20240708,2호선,방배,16099,16505,32604,16302
20240708,2호선,사당,38318,41161,79479,39739.5
20240708,2호선,낙성대(강감찬),28110,27824,55934,27967
20240708,2호선,서울대입구(관악구청),46939,45949,92888,46444
20240708,2호선,봉천,25252,23973,49225,24612.5
20240708,2호선,신림,54740,52674,107414,53707
20240708,2호선,신대방,25398,24820,50218,25109
20240708,2호선,구로디지털단지,60316,60046,120362,60181
20240708,2호선,대림(구로구청),24859,25209,50068,25034
20240708,2호선,신도림,49061,46993,96054,48027
20240708,2호선,문래,25076,25631,50707,25353.5
20240708,2호선,영등포구청,24240,24612,48852,24426
20240708,2호선,당산,17822,21335,39157,19578.5
20240708,2호선,합정,30518,32122,62640,31320
20240708,2호선,홍대입구,63408,66733,130141,65070.5
20240708,2호선,신촌,37593,38336,75929,37964.5
20240708,2호선,이대,15673,17425,33098,16549
20240708,2호선,아현,11297,10639,21936,10968
20240708,2호선,충정로(경기대입구),11222,11661,22883,11441.5
20240708,2호선,신답,1707,1965,3672,1836
20240708,2호선,신설동,3490,3423,6913,3456.5
20240708,2호선,도림천,1471,1627,3098,1549
20240708,2호선,양천구청,7552,8049,15601,7800.5
20240708,2호선,신정네거리,10593,11037,21630,10815
20240708,2호선,용두(동대문구청),2591,2739,5330,2665
20240708,3호선,지축,7871,7901,15772,7886
20240708,3호선,구파발,22376,21495,43871,21935.5
20240708,3호선,연신내,34139,32545,66684,33342
20240708,3호선,불광,16640,17682,34322,17161
20240708,3호선,녹번,15934,14832,30766,15383
20240708,3호선,홍제,17917,17213,35130,17565
20240708,3호선,무악재,4674,4551,9225,4612.5
20240708,3호선,독립문,7368,7452,14820,7410
20240708,3호선,경복궁(정부서울청사),22345,22253,44598,22299
20240708,3호선,안국,25707,26023,51730,25865
20240708,3호선,종로3가,11631,12564,24195,12097.5
20240708,3호선,을지로3가,12523,12395,24918,12459
20240708,3호선,충무로,6,0,6,3
20240708,3호선,동대입구,8470,9008,17478,8739
20240708,3호선,약수,13398,13200,26598,13299
20240708,3호선,금호,8356,7921,16277,8138.5
20240708,3호선,옥수,9038,9353,18391,9195.5
20240708,3호선,압구정,31565,33711,65276,32638
20240708,3호선,신사,28972,30132,59104,29552
20240708,3호선,잠원,5412,5101,10513,5256.5
20240708,3호선,고속터미널,43509,40237,83746,41873
20240708,3호선,교대(법원.검찰청),17907,11052,28959,14479.5
20240708,3호선,남부터미널(예술의전당),30187,30779,60966,30483
20240708,3호선,양재(서초구청),39844,42876,82720,41360
20240708,3호선,매봉,13802,13290,27092,13546
20240708,3호선,도곡,6543,6552,13095,6547.5
20240708,3호선,대치,12997,12947,25944,12972
20240708,3호선,학여울,2116,2164,4280,2140
20240708,3호선,대청,11939,11124,23063,11531.5
20240708,3호선,일원,12069,11791,23860,11930
20240708,3호선,수서,18902,19035,37937,18968.5
20240708,3호선,가락시장,9298,8995,18293,9146.5
20240708,3호선,경찰병원,8370,8491,16861,8430.5
20240708,3호선,오금,7111,6182,13293,6646.5
20240708,4호선,당고개,9638,8138,17776,8888
20240708,4호선,상계,19897,18567,38464,19232
20240708,4호선,노원,28175,31004,59179,29589.5
20240708,4호선,창동,26116,27487,53603,26801.5
20240708,4호선,쌍문,29996,28074,58070,29035
20240708,4호선,수유(강북구청),33552,33982,67534,33767
20240708,4호선,미아(서울사이버대학),15644,15159,30803,15401.5
20240708,4호선,미아사거리,26129,25592,51721,25860.5
20240708,4호선,길음,21264,21206,42470,21235
20240708,4호선,성신여대입구(돈암),20647,20633,41280,20640
20240708,4호선,한성대입구(삼선교),13306,12980,26286,13143
20240708,4호선,혜화,30430,30457,60887,30443.5
20240708,4호선,동대문,20314,20951,41265,20632.5
20240708,4호선,동대문역사문화공원(DDP),18349,16337,34686,17343
20240708,4호선,충무로,31320,31732,63052,31526
20240708,4호선,명동,30816,32280,63096,31548
20240708,4호선,회현(남대문시장),27088,27635,54723,27361.5
20240708,4호선,서울역,13666,20950,34616,17308
20240708,4호선,숙대입구(갈월),14353,14052,28405,14202.5
20240708,4호선,삼각지,5814,6402,12216,6108
20240708,4호선,신용산,20525,21667,42192,21096
20240708,4호선,이촌(국립중앙박물관),8481,9416,17897,8948.5
20240708,4호선,동작(현충원),1163,1248,2411,1205.5
20240708,4호선,총신대입구(이수),19692,21096,40788,20394
20240708,4호선,사당,24807,21640,46447,23223.5
20240708,4호선,남태령,1320,1270,2590,1295
20240708,5호선,방화,7430,7298,14728,7364
20240708,5호선,개화산,6457,6142,12599,6299.5
20240708,5호선,김포공항,10246,7448,17694,8847
20240708,5호선,송정,6627,6310,12937,6468.5
20240708,5호선,마곡,13448,13362,26810,13405
20240708,5호선,발산,23647,24220,47867,23933.5
20240708,5호선,우장산,15486,15414,30900,15450
20240708,5호선,화곡,29597,27755,57352,28676
20240708,5호선,까치산,28693,27928,56621,28310.5
20240708,5호선,신정(은행정),14205,11910,26115,13057.5
20240708,5호선,목동,17223,18798,36021,18010.5
20240708,5호선,오목교(목동운동장앞),21960,23098,45058,22529
20240708,5호선,양평,8640,8675,17315,8657.5
20240708,5호선,영등포구청,4949,5048,9997,4998.5
20240708,5호선,영등포시장,11744,11972,23716,11858
20240708,5호선,신길,5127,5476,10603,5301.5
20240708,5호선,여의도,32955,33689,66644,33322
20240708,5호선,여의나루,10571,12620,23191,11595.5
20240708,5호선,마포,16125,16435,32560,16280
20240708,5호선,공덕,15997,16897,32894,16447
20240708,5호선,애오개,7439,7419,14858,7429
20240708,5호선,충정로(경기대입구),5226,5384,10610,5305
20240708,5호선,서대문,23010,23046,46056,23028
20240708,5호선,광화문(세종문화회관),34313,35795,70108,35054
20240708,5호선,종로3가,13981,13751,27732,13866
20240708,5호선,을지로4가,6948,6808,13756,6878
20240708,5호선,동대문역사문화공원(DDP),3673,4008,7681,3840.5
20240708,5호선,청구,4167,3879,8046,4023
20240708,5호선,신금호,6826,7378,14204,7102
20240708,5호선,행당,8526,7703,16229,8114.5
20240708,5호선,왕십리(성동구청),4577,5197,9774,4887
20240708,5호선,마장,5981,5609,11590,5795
20240708,5호선,답십리,16722,15429,32151,16075.5
20240708,5호선,장한평,20285,20292,40577,20288.5
20240708,5호선,군자(능동),11275,12392,23667,11833.5
20240708,5호선,아차산(어린이대공원후문),14457,14276,28733,14366.5
20240708,5호선,광나루(장신대),13248,12364,25612,12806
20240708,5호선,천호(풍납토성),17479,17260,34739,17369.5
20240708,5호선,강동,19261,19016,38277,19138.5
20240708,5호선,길동,8638,8798,17436,8718
20240708,5호선,굽은다리(강동구민회관앞),9917,9649,19566,9783
20240708,5호선,명일,9230,9503,18733,9366.5
20240708,5호선,고덕,11562,11099,22661,11330.5
20240708,5호선,상일동,15550,14850,30400,15200
20240708,5호선,둔촌동,9038,9032,18070,9035
20240708,5호선,올림픽공원(한국체대),5611,4618,10229,5114.5
20240708,5호선,오금,3990,4107,8097,4048.5
20240708,5호선,개롱,7076,7314,14390,7195
20240708,5호선,거여,10857,10781,21638,10819
20240708,5호선,마천,8044,7061,15105,7552.5
20240708,5호선,강일,6253,5887,12140,6070
20240708,5호선,미사,17996,18341,36337,18168.5
20240708,5호선,하남풍산,4710,4658,9368,4684
20240708,5호선,하남시청(덕풍·신장),8414,8075,16489,8244.5
20240708,5호선,하남검단산,6334,6124,12458,6229
20240708,6호선,응암,18132,18191,36323,18161.5
20240708,6호선,역촌,3954,4612,8566,4283
20240708,6호선,불광,4839,4647,9486,4743
20240708,6호선,독바위,3009,3086,6095,3047.5
20240708,6호선,연신내,2,0,2,1
20240708,6호선,구산,8703,6813,15516,7758
20240708,6호선,새절(신사),13298,12327,25625,12812.5
20240708,6호선,증산(명지대앞),10033,10155,20188,10094
20240708,6호선,디지털미디어시티,15838,17415,33253,16626.5
20240708,6호선,월드컵경기장(성산),3759,3902,7661,3830.5
20240708,6호선,마포구청,15197,13877,29074,14537
20240708,6호선,망원,14206,15253,29459,14729.5
20240708,6호선,합정,12858,12377,25235,12617.5
20240708,6호선,상수,9250,9912,19162,9581
20240708,6호선,광흥창(서강),10074,9703,19777,9888.5
20240708,6호선,대흥(서강대앞),9375,9844,19219,9609.5
20240708,6호선,공덕,20516,20252,40768,20384
20240708,6호선,효창공원앞,7550,6858,14408,7204
20240708,6호선,삼각지,6555,6164,12719,6359.5
20240708,6호선,녹사평(용산구청),4604,4569,9173,4586.5
20240708,6호선,이태원,9610,9845,19455,9727.5
20240708,6호선,한강진,7400,8803,16203,8101.5
20240708,6호선,버티고개,2278,2266,4544,2272
20240708,6호선,약수,3880,3733,7613,3806.5
20240708,6호선,청구,4041,4091,8132,4066
20240708,6호선,신당,8651,9241,17892,8946
20240708,6호선,동묘앞,7888,8212,16100,8050
20240708,6호선,창신,3798,3194,6992,3496
20240708,6호선,보문,8097,7704,15801,7900.5
20240708,6호선,안암(고대병원앞),12173,12366,24539,12269.5
20240708,6호선,고려대(종암),8690,8481,17171,8585.5
20240708,6호선,월곡(동덕여대),12145,12055,24200,12100
20240708,6호선,상월곡(한국과학기술연구원),6708,6065,12773,6386.5
20240708,6호선,돌곶이,10694,9911,20605,10302.5
20240708,6호선,석계,13044,13461,26505,13252.5
20240708,6호선,태릉입구,5640,6268,11908,5954
20240708,6호선,화랑대(서울여대입구),12317,9725,22042,11021
20240708,6호선,봉화산(서울의료원),9525,8811,18336,9168
20240708,7호선,장암,2858,1039,3897,1948.5
20240708,7호선,도봉산,8699,9750,18449,9224.5
20240708,7호선,수락산,12397,12342,24739,12369.5
20240708,7호선,마들,13652,12883,26535,13267.5
20240708,7호선,노원,23758,24626,48384,24192
20240708,7호선,중계,15503,14475,29978,14989
20240708,7호선,하계,18776,17694,36470,18235
20240708,7호선,공릉(서울과학기술대),12381,12280,24661,12330.5
20240708,7호선,태릉입구,8825,8242,17067,8533.5
20240708,7호선,먹골,10615,10581,21196,10598
20240708,7호선,중화,10909,10878,21787,10893.5
20240708,7호선,상봉,17565,16804,34369,17184.5
20240708,7호선,면목,15529,15187,30716,15358
20240708,7호선,사가정,16337,16575,32912,16456
20240708,7호선,용마산(용마폭포공원),5986,5815,11801,5900.5
20240708,7호선,중곡,11710,11139,22849,11424.5
20240708,7호선,군자(능동),15532,12538,28070,14035
20240708,7호선,어린이대공원(세종대),13963,13747,27710,13855
20240708,7호선,건대입구,12985,13277,26262,13131
20240708,7호선,자양(뚝섬한강공원),7650,7504,15154,7577
20240708,7호선,청담,20320,22045,42365,21182.5
20240708,7호선,강남구청,17147,18743,35890,17945
20240708,7호선,학동,26354,27189,53543,26771.5
20240708,7호선,논현,20002,20535,40537,20268.5
20240708,7호선,반포,6519,6295,12814,6407
20240708,7호선,고속터미널,16891,14413,31304,15652
20240708,7호선,내방,16064,16093,32157,16078.5
20240708,7호선,이수,16863,16428,33291,16645.5
20240708,7호선,남성,11910,11509,23419,11709.5
20240708,7호선,숭실대입구(살피재),13040,13209,26249,13124.5
20240708,7호선,상도,11817,11572,23389,11694.5
20240708,7호선,장승배기,9661,9598,19259,9629.5
20240708,7호선,신대방삼거리,15300,14793,30093,15046.5
20240708,7호선,보라매,6915,7209,14124,7062
20240708,7호선,신풍,11673,11103,22776,11388
20240708,7호선,대림(구로구청),9194,9165,18359,9179.5
20240708,7호선,남구로,16446,17205,33651,16825.5
20240708,7호선,가산디지털단지,51430,51238,102668,51334
20240708,7호선,철산,22019,22440,44459,22229.5
20240708,7호선,광명사거리,20050,19577,39627,19813.5
20240708,7호선,천왕,12362,11980,24342,12171
20240708,7호선,온수(성공회대입구),10301,9226,19527,9763.5
20240708,7호선,까치울,1,0,1,0.5
20240708,8호선,암사,19695,17618,37313,18656.5
20240708,8호선,천호(풍납토성),14815,16464,31279,15639.5
20240708,8호선,강동구청,11022,11626,22648,11324
20240708,8호선,몽촌토성(평화의문),7050,7197,14247,7123.5
20240708,8호선,잠실(송파구청),15995,18161,34156,17078
20240708,8호선,석촌,8350,9486,17836,8918
20240708,8호선,송파,10469,10394,20863,10431.5
20240708,8호선,가락시장,8062,8805,16867,8433.5
20240708,8호선,문정,25030,26317,51347,25673.5
20240708,8호선,장지,17752,16474,34226,17113
20240708,8호선,복정,9438,8193,17631,8815.5
20240708,8호선,산성,6425,6519,12944,6472
20240708,8호선,남한산성입구(성남법원.검찰청),13387,12278,25665,12832.5
20240708,8호선,단대오거리,12108,11991,24099,12049.5
20240708,8호선,신흥,5156,5352,10508,5254
20240708,8호선,수진,5855,5261,11116,5558
20240708,8호선,모란,4743,3595,8338,4169
20240708,8호선,남위례,7539,7612,15151,7575.5
20240708,9호선,개화,3098,2049,5147,2573.5
20240708,9호선,김포공항,6809,9489,16298,8149
20240708,9호선,공항시장,3246,3544,6790,3395
20240708,9호선,신방화,7743,7736,15479,7739.5
20240708,9호선,마곡나루(서울식물원),14738,14333,29071,14535.5
20240708,9호선,가양,23364,23218,46582,23291
20240708,9호선,증미,9198,8976,18174,9087
20240708,9호선,등촌,13230,12836,26066,13033
20240708,9호선,염창,18553,17867,36420,18210
20240708,9호선,신목동,4706,4366,9072,4536
20240708,9호선,선유도,9769,9377,19146,9573
20240708,9호선,당산,20203,19944,40147,20073.5
20240708,9호선,국회의사당,18804,19356,38160,19080
20240708,9호선,여의도,33571,32291,65862,32931
20240708,9호선,샛강,7273,7414,14687,7343.5
20240708,9호선,노량진,25870,25304,51174,25587
20240708,9호선,노들,4949,4226,9175,4587.5
20240708,9호선,흑석(중앙대입구),9104,9381,18485,9242.5
20240708,9호선,동작(현충원),1669,1418,3087,1543.5
20240708,9호선,구반포,1301,1283,2584,1292
20240708,9호선,신반포,4156,4029,8185,4092.5
20240708,9호선,고속터미널,13835,18179,32014,16007
20240708,9호선,사평,4437,4323,8760,4380
20240708,9호선,신논현,31539,31279,62818,31409
20240708,9호선2~3단계,언주,12865,13235,26100,13050
20240708,9호선2~3단계,선정릉,10734,11564,22298,11149
20240708,9호선2~3단계,삼성중앙,8847,9342,18189,9094.5
20240708,9호선2~3단계,봉은사,20570,21551,42121,21060.5
20240708,9호선2~3단계,종합운동장,5073,5033,10106,5053
20240708,9호선2~3단계,삼전,8550,8097,16647,8323.5
20240708,9호선2~3단계,석촌고분,7599,7526,15125,7562.5
20240708,9호선2~3단계,석촌,9760,8738,18498,9249
20240708,9호선2~3단계,송파나루,5801,6274,12075,6037.5
20240708,9호선2~3단계,한성백제,3191,2921,6112,3056
20240708,9호선2~3단계,올림픽공원(한국체대),5271,5614,10885,5442.5
20240708,9호선2~3단계,둔촌오륜,1549,1387,2936,1468
20240708,9호선2~3단계,중앙보훈병원,13150,11714,24864,12432
20240708,경강선,판교,6168,6022,12190,6095
20240708,경강선,이매,1145,1003,2148,1074
20240708,경강선,삼동,2620,2455,5075,2537.5
20240708,경강선,경기광주,7963,7645,15608,7804
20240708,경강선,초월,3480,3438,6918,3459
20240708,경강선,곤지암,2088,2025,4113,2056.5
20240708,경강선,신둔도예촌,1428,1384,2812,1406
20240708,경강선,이천,2727,2810,5537,2768.5
20240708,경강선,부발,2109,2078,4187,2093.5
20240708,경강선,세종대왕릉,276,267,543,271.5
20240708,경강선,여주,2542,2476,5018,2509
20240708,경강선,성남,972,869,1841,920.5
20240708,경부선,서울역,8891,3428,12319,6159.5
20240708,경부선,남영,9955,10410,20365,10182.5
20240708,경부선,용산,38202,38877,77079,38539.5
20240708,경부선,노량진,7347,7413,14760,7380
20240708,경부선,대방,11034,11995,23029,11514.5
20240708,경부선,영등포,37157,37799,74956,37478
20240708,경부선,신도림,3687,3965,7652,3826
20240708,경부선,신길,8895,7649,16544,8272
20240708,경부선,구로,18024,18066,36090,18045
20240708,경부선,가산디지털단지,18648,21751,40399,20199.5
20240708,경부선,금천구청,11284,11557,22841,11420.5
20240708,경부선,석수,8683,7960,16643,8321.5
20240708,경부선,관악,7207,7016,14223,7111.5
20240708,경부선,안양,20781,20616,41397,20698.5
20240708,경부선,명학,9139,9088,18227,9113.5
20240708,경부선,금정,28078,28292,56370,28185
20240708,경부선,군포,7452,7485,14937,7468.5
20240708,경부선,의왕,9190,9269,18459,9229.5
20240708,경부선,성균관대,14791,14782,29573,14786.5
20240708,경부선,화서,11120,10681,21801,10900.5
20240708,경부선,수원,32657,34010,66667,33333.5
20240708,경부선,독산,18397,19428,37825,18912.5
20240708,경부선,세류,3283,2970,6253,3126.5
20240708,경부선,병점,14027,13750,27777,13888.5
20240708,경부선,세마,3248,3133,6381,3190.5
20240708,경부선,오산대,3423,3181,6604,3302
20240708,경부선,오산,9264,9512,18776,9388
20240708,경부선,진위,1807,1656,3463,1731.5
20240708,경부선,송탄,4167,4117,8284,4142
20240708,경부선,서정리,7538,7365,14903,7451.5
20240708,경부선,평택지제,4125,3949,8074,4037
20240708,경부선,평택,10951,10751,21702,10851
20240708,경부선,성환,3588,3658,7246,3623
20240708,경부선,직산,951,888,1839,919.5
20240708,경부선,두정,5969,6093,12062,6031
20240708,경부선,천안,4937,5203,10140,5070
20240708,경부선,당정,5988,5785,11773,5886.5
20240708,경부선,서동탄,1557,1264,2821,1410.5
20240708,경부선,광명,3891,3291,7182,3591
20240708,경원선,이촌(국립중앙박물관),4068,3252,7320,3660
20240708,경원선,서빙고,2138,1982,4120,2060
20240708,경원선,한남,4011,3913,7924,3962
20240708,경원선,옥수,50,49,99,49.5
20240708,경원선,응봉,1947,1693,3640,1820
20240708,경원선,왕십리(성동구청),16039,16238,32277,16138.5
20240708,경원선,청량리(서울시립대입구),14260,15053,29313,14656.5
20240708,경원선,외대앞,8894,8806,17700,8850
20240708,경원선,신이문,8807,8212,17019,8509.5
20240708,경원선,석계,7139,8301,15440,7720
20240708,경원선,광운대,8050,7748,15798,7899
20240708,경원선,월계,6729,6419,13148,6574
20240708,경원선,녹천,4746,4047,8793,4396.5
20240708,경원선,창동,3,0,3,1.5
20240708,경원선,방학,10074,9770,19844,9922
20240708,경원선,도봉,6097,5813,11910,5955
20240708,경원선,도봉산,6202,3799,10001,5000.5
20240708,경원선,망월사,7198,7381,14579,7289.5
20240708,경원선,회룡,12815,12597,25412,12706
20240708,경원선,의정부,17679,17616,35295,17647.5
20240708,경원선,가능,6400,6352,12752,6376
20240708,경원선,녹양,4315,4160,8475,4237.5
20240708,경원선,양주,6962,6546,13508,6754
20240708,경원선,덕계,6015,5458,11473,5736.5
20240708,경원선,덕정,6008,5649,11657,5828.5
20240708,경원선,지행,6311,6382,12693,6346.5
20240708,경원선,동두천중앙,3023,2932,5955,2977.5
20240708,경원선,보산,1522,1342,2864,1432
20240708,경원선,동두천,1755,1586,3341,1670.5
20240708,경원선,소요산,1151,1099,2250,1125
20240708,경원선,청산,162,108,270,135
20240708,경원선,전곡,1100,881,1981,990.5
20240708,경원선,연천,1016,830,1846,923
20240708,경의선,서울역,4908,6348,11256,5628
20240708,경의선,신촌,1089,1348,2437,1218.5
20240708,경의선,효창공원앞,3383,3912,7295,3647.5
20240708,경의선,공덕,4458,3602,8060,4030
20240708,경의선,서강대,2225,2218,4443,2221.5
20240708,경의선,홍대입구,1932,2403,4335,2167.5
20240708,경의선,가좌,6146,5812,11958,5979
20240708,경의선,디지털미디어시티,2865,2589,5454,2727
20240708,경의선,수색,3722,3826,7548,3774
20240708,경의선,한국항공대,2084,2005,4089,2044.5
20240708,경의선,강매,3418,2805,6223,3111.5
20240708,경의선,행신,8121,8282,16403,8201.5
20240708,경의선,능곡,4889,4533,9422,4711
20240708,경의선,곡산,727,730,1457,728.5
20240708,경의선,백마,7793,7555,15348,7674
20240708,경의선,풍산,6304,5925,12229,6114.5
20240708,경의선,일산,11407,11244,22651,11325.5
20240708,경의선,탄현,8114,7691,15805,7902.5
20240708,경의선,야당,8921,8833,17754,8877
20240708,경의선,운정,8048,7647,15695,7847.5
20240708,경의선,금릉,5565,5265,10830,5415
20240708,경의선,금촌,6745,6328,13073,6536.5
20240708,경의선,월롱,1992,1827,3819,1909.5
20240708,경의선,파주,1214,830,2044,1022
20240708,경의선,문산,5502,4955,10457,5228.5
20240708,경의선,임진강,7,1,8,4
20240708,경의선,운천,3,4,7,3.5
20240708,경의선,계양,1,0,1,0.5
20240708,경의선,검암,1,0,1,0.5
20240708,경인선,개봉,21426,21411,42837,21418.5
20240708,경인선,오류동,11896,11217,23113,11556.5
20240708,경인선,역곡,25596,25763,51359,25679.5
20240708,경인선,부천,29706,29490,59196,29598
20240708,경인선,송내,27013,26413,53426,26713
20240708,경인선,부평,27813,28483,56296,28148
20240708,경인선,백운,7624,7270,14894,7447
20240708,경인선,동암,15205,15097,30302,15151
20240708,경인선,주안,18107,16204,34311,17155.5
20240708,경인선,제물포,10753,10518,21271,10635.5
20240708,경인선,동인천,13171,12380,25551,12775.5
20240708,경인선,인천,3022,2277,5299,2649.5
20240708,경인선,구일,6555,6428,12983,6491.5
20240708,경인선,소사,7421,7084,14505,7252.5
20240708,경인선,부개,8840,8411,17251,8625.5
20240708,경인선,간석,5901,5662,11563,5781.5
20240708,경인선,도원,3496,3555,7051,3525.5
20240708,경인선,온수(성공회대입구),6563,6166,12729,6364.5
20240708,경인선,중동,9458,9011,18469,9234.5
20240708,경인선,도화,4270,3965,8235,4117.5
20240708,경춘선,갈매,3151,2759,5910,2955
20240708,경춘선,별내,3547,3402,6949,3474.5
20240708,경춘선,퇴계원,3660,3384,7044,3522
20240708,경춘선,사릉,2046,2035,4081,2040.5
20240708,경춘선,금곡,1496,1432,2928,1464
20240708,경춘선,평내호평,6067,5798,11865,5932.5
20240708,경춘선,천마산,1433,1369,2802,1401
20240708,경춘선,마석,3755,3632,7387,3693.5
20240708,경춘선,대성리,549,1068,1617,808.5
20240708,경춘선,청평,1752,1781,3533,1766.5
20240708,경춘선,상천,179,239,418,209
20240708,경춘선,가평,1771,2136,3907,1953.5
20240708,경춘선,굴봉산,89,79,168,84
20240708,경춘선,백양리,33,34,67,33.5
20240708,경춘선,강촌,293,298,591,295.5
20240708,경춘선,김유정,267,268,535,267.5
20240708,경춘선,남춘천,2132,2231,4363,2181.5
20240708,경춘선,춘천,1124,1026,2150,1075
20240708,공항철도 1호선,서울역,12386,11507,23893,11946.5
20240708,공항철도 1호선,공덕,3157,3999,7156,3578
20240708,공항철도 1호선,홍대입구,13168,12589,25757,12878.5
20240708,공항철도 1호선,디지털미디어시티,15407,14424,29831,14915.5
20240708,공항철도 1호선,마곡나루(서울식물원),12367,11725,24092,12046
20240708,공항철도 1호선,김포공항,9823,5901,15724,7862
20240708,공항철도 1호선,계양,13638,12867,26505,13252.5
20240708,공항철도 1호선,검암,6488,6641,13129,6564.5
20240708,공항철도 1호선,청라국제도시,7630,7248,14878,7439
20240708,공항철도 1호선,운서,9135,9409,18544,9272
20240708,공항철도 1호선,공항화물청사,2222,2332,4554,2277
20240708,공항철도 1호선,인천공항1터미널,14363,14426,28789,14394.5
20240708,공항철도 1호선,인천공항2터미널,6673,6301,12974,6487
20240708,공항철도 1호선,영종,4028,4089,8117,4058.5
20240708,과천선,선바위,7625,6718,14343,7171.5
20240708,과천선,경마공원,788,766,1554,777
20240708,과천선,대공원,1255,1349,2604,1302
20240708,과천선,과천,6637,6140,12777,6388.5
20240708,과천선,정부과천청사,13453,13976,27429,13714.5
20240708,과천선,인덕원,25612,26572,52184,26092
20240708,과천선,평촌,18919,18520,37439,18719.5
20240708,과천선,범계,26330,26331,52661,26330.5
20240708,분당선,선릉,15100,22826,37926,18963
20240708,분당선,한티,15298,16686,31984,15992
20240708,분당선,도곡,8448,8493,16941,8470.5
20240708,분당선,구룡,3925,3898,7823,3911.5
20240708,분당선,개포동,4778,4988,9766,4883
20240708,분당선,대모산입구,6364,6142,12506,6253
20240708,분당선,수서,17241,17811,35052,17526
20240708,분당선,복정,2,0,2,1
20240708,분당선,수원,7369,6805,14174,7087
20240708,분당선,서울숲,12028,12177,24205,12102.5
20240708,분당선,압구정로데오,17660,19127,36787,18393.5
20240708,분당선,강남구청,10286,11905,22191,11095.5
20240708,분당선,선정릉,8614,8898,17512,8756
20240708,분당선,가천대,7186,7723,14909,7454.5
20240708,분당선,태평,13200,12610,25810,12905
20240708,분당선,모란,19089,19214,38303,19151.5
20240708,분당선,야탑,25814,27670,53484,26742
20240708,분당선,서현,23937,24501,48438,24219
20240708,분당선,수내,14448,14634,29082,14541
20240708,분당선,정자,19534,20198,39732,19866
20240708,분당선,미금,15575,16219,31794,15897
20240708,분당선,오리,11953,10118,22071,11035.5
20240708,분당선,이매,6065,5497,11562,5781
20240708,분당선,보정,2816,2477,5293,2646.5
20240708,분당선,죽전,12425,14018,26443,13221.5
20240708,분당선,구성,6184,6428,12612,6306
20240708,분당선,신갈,5083,4763,9846,4923
20240708,분당선,기흥,10396,9480,19876,9938
20240708,분당선,상갈,5288,5120,10408,5204
20240708,분당선,청명,4730,4586,9316,4658
20240708,분당선,영통,8640,8752,17392,8696
20240708,분당선,망포,16070,15548,31618,15809
20240708,분당선,매탄권선,5562,5499,11061,5530.5
20240708,분당선,수원시청,13573,14459,28032,14016
20240708,분당선,매교,5538,5483,11021,5510.5
20240708,서해선,김포공항,2764,3628,6392,3196
20240708,서해선,원종,4677,4804,9481,4740.5
20240708,서해선,부천종합운동장,2663,2239,4902,2451
20240708,수인선,고색,5599,5147,10746,5373
20240708,수인선,오목천,3907,3615,7522,3761
20240708,수인선,어천,1415,1334,2749,1374.5
20240708,수인선,야목,369,338,707,353.5
20240708,수인선,사리,4978,4317,9295,4647.5
20240708,수인선,달월,109,54,163,81.5
20240708,수인선,월곶,2621,2322,4943,2471.5
20240708,수인선,소래포구,4303,3940,8243,4121.5
20240708,수인선,인천논현,5333,5726,11059,5529.5
20240708,수인선,호구포,4008,4194,8202,4101
20240708,수인선,연수,4615,4568,9183,4591.5
20240708,수인선,송도,2435,2151,4586,2293
20240708,수인선,인하대,6525,6203,12728,6364
20240708,수인선,숭의,4225,4042,8267,4133.5
20240708,수인선,신포,1803,1767,3570,1785
20240708,수인선,인천,929,1421,2350,1175
20240708,신림선,샛강,3343,3728,7071,3535.5
20240708,신림선,대방,2916,2418,5334,2667
20240708,신림선,서울지방병무청,3397,3764,7161,3580.5
20240708,신림선,보라매,4547,4157,8704,4352
20240708,신림선,보라매공원,2295,2438,4733,2366.5
20240708,신림선,보라매병원,8694,8957,17651,8825.5
20240708,신림선,당곡,5069,4993,10062,5031
20240708,신림선,신림,1980,2711,4691,2345.5
20240708,신림선,서원,3606,3373,6979,3489.5
20240708,신림선,서울대벤처타운,9643,9117,18760,9380
20240708,신림선,관악산(서울대),2434,2413,4847,2423.5
20240708,안산선,산본,15914,16842,32756,16378
20240708,안산선,대야미,4850,4415,9265,4632.5
20240708,안산선,반월,4292,4225,8517,4258.5
20240708,안산선,상록수,14480,14788,29268,14634
20240708,안산선,한대앞,8856,8921,17777,8888.5
20240708,안산선,중앙,17194,17805,34999,17499.5
20240708,안산선,고잔,8951,8306,17257,8628.5
20240708,안산선,초지,5001,5008,10009,5004.5
20240708,안산선,안산,11789,10533,22322,11161
20240708,안산선,신길온천,1928,1697,3625,1812.5
20240708,안산선,정왕,9015,9236,18251,9125.5
20240708,안산선,오이도,7426,7059,14485,7242.5
20240708,안산선,수리산,4061,3408,7469,3734.5
20240708,우이신설선,북한산우이,2601,2350,4951,2475.5
20240708,우이신설선,솔밭공원,2728,2624,5352,2676
20240708,우이신설선,4.19민주묘지,3071,2930,6001,3000.5
20240708,우이신설선,가오리,4641,4739,9380,4690
20240708,우이신설선,화계,3767,3659,7426,3713
20240708,우이신설선,삼양,2164,2258,4422,2211
20240708,우이신설선,삼양사거리,2633,2719,5352,2676
20240708,우이신설선,솔샘,6114,5945,12059,6029.5
20240708,우이신설선,북한산보국문,6128,6092,12220,6110
20240708,우이신설선,정릉,4699,4438,9137,4568.5
20240708,우이신설선,성신여대입구(돈암),3535,3919,7454,3727
20240708,우이신설선,보문,1667,1623,3290,1645
20240708,우이신설선,신설동,2440,2299,4739,2369.5
20240708,일산선,원흥,11523,11056,22579,11289.5
20240708,일산선,지축,3,0,3,1.5
20240708,일산선,삼송,19425,18851,38276,19138
20240708,일산선,원당,11099,10518,21617,10808.5
20240708,일산선,화정,17056,17410,34466,17233
20240708,일산선,대곡,2981,2175,5156,2578
20240708,일산선,백석,9957,10009,19966,9983
20240708,일산선,마두,8314,8555,16869,8434.5
20240708,일산선,정발산,6417,6362,12779,6389.5
20240708,일산선,주엽,10041,9983,20024,10012
20240708,일산선,대화,13593,9925,23518,11759
20240708,장항선,봉명,1494,1460,2954,1477
20240708,장항선,쌍용(나사렛대),2212,2143,4355,2177.5
20240708,장항선,아산,3377,3015,6392,3196
20240708,장항선,탕정,1528,1433,2961,1480.5
20240708,장항선,배방,1090,1080,2170,1085
20240708,장항선,온양온천,3795,3804,7599,3799.5
20240708,장항선,신창(순천향대),1169,1284,2453,1226.5
20240708,중앙선,회기,24523,23622,48145,24072.5
20240708,중앙선,중랑,5521,5448,10969,5484.5
20240708,중앙선,상봉,5740,5775,11515,5757.5
20240708,중앙선,망우,7705,7451,15156,7578
20240708,중앙선,양원,3281,3263,6544,3272
20240708,중앙선,구리,13145,13160,26305,13152.5
20240708,중앙선,도농,11623,10540,22163,11081.5
20240708,중앙선,양정,596,507,1103,551.5
20240708,중앙선,덕소,5327,5201,10528,5264
20240708,중앙선,도심,2491,1986,4477,2238.5
20240708,중앙선,팔당,694,728,1422,711
20240708,중앙선,운길산,538,501,1039,519.5
20240708,중앙선,양수,1830,1852,3682,1841
20240708,중앙선,신원,143,120,263,131.5
20240708,중앙선,국수,685,653,1338,669
20240708,중앙선,아신,474,497,971,485.5
20240708,중앙선,오빈,304,307,611,305.5
20240708,중앙선,양평,3356,3192,6548,3274
20240708,중앙선,원덕,328,312,640,320
20240708,중앙선,용문,1645,1648,3293,1646.5
20240708,중앙선,지평,65,65,130,65
20240709,9호선2~3단계,종합운동장,5507,5552,11059,5529.5
20240709,9호선2~3단계,봉은사,21740,22750,44490,22245
20240709,9호선2~3단계,삼성중앙,9310,9648,18958,9479
20240709,9호선2~3단계,선정릉,11602,12420,24022,12011
20240709,9호선2~3단계,언주,13261,13570,26831,13415.5
20240709,9호선,신논현,33296,33385,66681,33340.5
20240709,9호선,사평,4579,4417,8996,4498
20240709,9호선,고속터미널,14639,18836,33475,16737.5
20240709,9호선,신반포,4526,4356,8882,4441
20240709,9호선,구반포,1467,1372,2839,1419.5
20240709,9호선,동작(현충원),1756,1507,3263,1631.5
20240709,9호선,흑석(중앙대입구),9532,9854,19386,9693
20240709,9호선,노들,5228,4284,9512,4756
20240709,9호선,노량진,26859,26213,53072,26536
20240709,9호선,샛강,7355,7542,14897,7448.5
20240709,9호선,여의도,33915,32677,66592,33296
20240709,9호선,국회의사당,19546,20354,39900,19950
20240709,9호선,당산,21217,20826,42043,21021.5
20240709,9호선,선유도,10202,9745,19947,9973.5
20240709,9호선,신목동,4995,4474,9469,4734.5
20240709,9호선,염창,19449,18671,38120,19060
20240709,9호선,등촌,13669,13100,26769,13384.5
20240709,9호선,증미,9346,9240,18586,9293
20240709,9호선,가양,25155,24561,49716,24858
20240709,9호선,양천향교,11010,11351,22361,11180.5
20240709,9호선,마곡나루(서울식물원),15407,15212,30619,15309.5
20240709,9호선,신방화,7949,7871,15820,7910
20240709,9호선,공항시장,3257,3609,6866,3433
20240709,9호선,김포공항,6826,9774,16600,8300
20240709,9호선,개화,3108,2077,5185,2592.5
20240709,8호선,남위례,8158,8219,16377,8188.5
20240709,8호선,모란,6520,5092,11612,5806
20240709,8호선,수진,5966,5571,11537,5768.5
20240709,8호선,신흥,5554,5809,11363,5681.5
20240709,8호선,단대오거리,13057,12581,25638,12819
20240709,8호선,남한산성입구(성남법원.검찰청),14443,12900,27343,13671.5
20240709,8호선,복정,10378,8866,19244,9622
20240709,8호선,장지,18757,17162,35919,17959.5
20240709,8호선,문정,25481,26803,52284,26142
20240709,8호선,가락시장,8446,9329,17775,8887.5
20240709,8호선,송파,10563,10574,21137,10568.5
20240709,8호선,석촌,8808,10080,18888,9444
20240709,8호선,잠실(송파구청),16898,19312,36210,18105
20240709,8호선,몽촌토성(평화의문),7423,7606,15029,7514.5
20240709,8호선,강동구청,11668,12064,23732,11866
20240709,8호선,천호(풍납토성),16122,18281,34403,17201.5
20240709,8호선,암사,20596,18404,39000,19500
20240709,7호선,온수(성공회대입구),10842,9541,20383,10191.5
20240709,7호선,천왕,12971,12531,25502,12751
20240709,7호선,광명사거리,21064,20869,41933,20966.5
20240709,7호선,철산,23237,23648,46885,23442.5
20240709,7호선,가산디지털단지,51736,51866,103602,51801
20240709,7호선,남구로,16507,17174,33681,16840.5
20240709,7호선,대림(구로구청),9222,9241,18463,9231.5
20240709,7호선,신풍,12516,11803,24319,12159.5
20240709,7호선,보라매,7308,7673,14981,7490.5
20240709,7호선,신대방삼거리,16224,15618,31842,15921
20240709,7호선,장승배기,10105,10069,20174,10087
20240709,7호선,상도,12445,12111,24556,12278
20240709,7호선,숭실대입구(살피재),13625,13825,27450,13725
20240709,7호선,남성,12485,11900,24385,12192.5
20240709,7호선,이수,17774,17289,35063,17531.5
20240709,7호선,내방,16632,16697,33329,16664.5
20240709,7호선,고속터미널,16599,14928,31527,15763.5
20240709,7호선,반포,7052,6627,13679,6839.5
20240709,7호선,논현,21193,21501,42694,21347
20240709,7호선,학동,27145,28102,55247,27623.5
20240709,7호선,강남구청,18423,20311,38734,19367
20240709,7호선,청담,21390,23352,44742,22371
20240709,7호선,자양(뚝섬한강공원),8597,8439,17036,8518
20240709,7호선,건대입구,13684,13998,27682,13841
20240709,7호선,어린이대공원(세종대),14855,14775,29630,14815
20240709,7호선,군자(능동),16541,13013,29554,14777
20240709,7호선,중곡,12040,11387,23427,11713.5
20240709,7호선,용마산(용마폭포공원),6249,5994,12243,6121.5
20240709,7호선,사가정,17244,17365,34609,17304.5
20240709,7호선,면목,15966,15731,31697,15848.5
20240709,7호선,상봉,18583,17816,36399,18199.5
20240709,7호선,중화,11392,11118,22510,11255
20240709,7호선,먹골,11048,10914,21962,10981
20240709,7호선,태릉입구,9271,8682,17953,8976.5
20240709,7호선,공릉(서울과학기술대),12918,12762,25680,12840
20240709,7호선,하계,19212,17955,37167,18583.5
20240709,7호선,중계,15882,14723,30605,15302.5
20240709,7호선,노원,25617,26751,52368,26184
20240709,7호선,마들,14373,13582,27955,13977.5
20240709,7호선,수락산,13205,13150,26355,13177.5
20240709,7호선,도봉산,9309,10739,20048,10024
20240709,7호선,장암,3076,1281,4357,2178.5
20240709,6호선,봉화산(서울의료원),9747,9290,19037,9518.5
20240709,6호선,화랑대(서울여대입구),12701,9953,22654,11327
20240709,6호선,태릉입구,5984,6619,12603,6301.5
20240709,6호선,석계,13317,13745,27062,13531
20240709,6호선,돌곶이,10915,10085,21000,10500
20240709,6호선,상월곡(한국과학기술연구원),6836,6196,13032,6516
20240709,6호선,월곡(동덕여대),12611,12597,25208,12604
20240709,6호선,고려대(종암),9345,8780,18125,9062.5
20240709,6호선,안암(고대병원앞),12270,12338,24608,12304
20240709,6호선,보문,8491,7876,16367,8183.5
20240709,6호선,창신,3906,3228,7134,3567
20240709,6호선,동묘앞,8067,8517,16584,8292
20240709,6호선,신당,9063,9595,18658,9329
20240709,6호선,청구,4240,4388,8628,4314
20240709,6호선,약수,4074,3938,8012,4006
20240709,6호선,버티고개,2330,2323,4653,2326.5
20240709,6호선,한강진,9445,10929,20374,10187
20240709,6호선,이태원,10272,10818,21090,10545
20240709,6호선,녹사평(용산구청),5059,4985,10044,5022
20240709,6호선,삼각지,7566,6702,14268,7134
20240709,6호선,효창공원앞,8152,7325,15477,7738.5
20240709,6호선,공덕,21688,20927,42615,21307.5
20240709,6호선,대흥(서강대앞),9991,10413,20404,10202
20240709,6호선,광흥창(서강),10472,10149,20621,10310.5
20240709,6호선,상수,9799,10519,20318,10159
20240709,6호선,합정,14134,13782,27916,13958
20240709,6호선,망원,15617,16574,32191,16095.5
20240709,6호선,마포구청,15898,14505,30403,15201.5
20240709,6호선,월드컵경기장(성산),4473,4568,9041,4520.5
20240709,6호선,디지털미디어시티,16472,18146,34618,17309
20240709,6호선,증산(명지대앞),10753,10669,21422,10711
20240709,6호선,새절(신사),13859,12891,26750,13375
20240709,6호선,구산,9068,7025,16093,8046.5
20240709,6호선,연신내,3,0,3,1.5
20240709,6호선,독바위,3082,3204,6286,3143
20240709,6호선,불광,4954,4930,9884,4942
20240709,6호선,역촌,4038,4650,8688,4344
20240709,6호선,응암,19025,18939,37964,18982
20240709,5호선,하남검단산,7358,6941,14299,7149.5
20240709,5호선,하남시청(덕풍·신장),9376,9026,18402,9201
20240709,5호선,하남풍산,4971,4969,9940,4970
20240709,5호선,미사,19105,19333,38438,19219
20240709,5호선,강일,6622,6265,12887,6443.5
20240709,5호선,마천,8379,7607,15986,7993
20240709,5호선,거여,11287,10989,22276,11138
20240709,5호선,개롱,7303,7449,14752,7376
20240709,5호선,오금,4188,4250,8438,4219
20240709,5호선,방이,8011,8315,16326,8163
20240709,5호선,올림픽공원(한국체대),6183,4996,11179,5589.5
20240709,5호선,둔촌동,9667,9682,19349,9674.5
20240709,5호선,상일동,16531,15641,32172,16086
20240709,5호선,고덕,12191,11745,23936,11968
20240709,5호선,명일,9471,9876,19347,9673.5
20240709,5호선,굽은다리(강동구민회관앞),10625,10107,20732,10366
20240709,5호선,길동,8974,9277,18251,9125.5
20240709,5호선,강동,19902,19451,39353,19676.5
20240709,5호선,천호(풍납토성),20358,19948,40306,20153
20240709,5호선,광나루(장신대),14123,13092,27215,13607.5
20240709,5호선,아차산(어린이대공원후문),15508,15326,30834,15417
20240709,5호선,군자(능동),12081,13207,25288,12644
20240709,5호선,장한평,20851,20768,41619,20809.5
20240709,5호선,답십리,17694,16075,33769,16884.5
20240709,5호선,마장,6320,5900,12220,6110
20240709,5호선,왕십리(성동구청),4968,5515,10483,5241.5
20240709,5호선,행당,9027,8033,17060,8530
20240709,5호선,신금호,7399,7781,15180,7590
20240709,5호선,청구,4292,3940,8232,4116
20240709,5호선,동대문역사문화공원(DDP),3540,4015,7555,3777.5
20240709,5호선,을지로4가,7309,7384,14693,7346.5
20240709,5호선,종로3가,14962,14921,29883,14941.5
20240709,5호선,광화문(세종문화회관),35774,37757,73531,36765.5
20240709,5호선,서대문,22996,23304,46300,23150
20240709,5호선,충정로(경기대입구),5437,5628,11065,5532.5
20240709,5호선,애오개,7634,7690,15324,7662
20240709,5호선,공덕,16619,17416,34035,17017.5
20240709,5호선,마포,16667,16997,33664,16832
20240709,5호선,여의나루,11620,13360,24980,12490
20240709,5호선,여의도,32981,34620,67601,33800.5
20240709,5호선,신길,5227,5459,10686,5343
20240709,5호선,영등포시장,12319,12575,24894,12447
20240709,5호선,영등포구청,5255,5290,10545,5272.5
20240709,5호선,양평,8683,8646,17329,8664.5
20240709,5호선,오목교(목동운동장앞),22874,24340,47214,23607
20240709,5호선,목동,18541,19819,38360,19180
20240709,5호선,신정(은행정),14698,12243,26941,13470.5
20240709,5호선,까치산,30004,28910,58914,29457
20240709,5호선,화곡,30626,28763,59389,29694.5
20240709,5호선,우장산,16245,16041,32286,16143
20240709,5호선,발산,25297,25646,50943,25471.5
20240709,5호선,마곡,13878,13962,27840,13920
20240709,5호선,송정,6742,6351,13093,6546.5
20240709,5호선,김포공항,10689,7831,18520,9260
20240709,5호선,개화산,6696,6381,13077,6538.5
20240709,5호선,방화,7725,7417,15142,7571
20240709,4호선,남태령,1466,1373,2839,1419.5
20240709,4호선,사당,26910,23244,50154,25077
20240709,4호선,총신대입구(이수),20722,22306,43028,21514
20240709,4호선,동작(현충원),1400,1539,2939,1469.5
20240709,4호선,이촌(국립중앙박물관),9446,10406,19852,9926
20240709,4호선,신용산,21322,22926,44248,22124
20240709,4호선,삼각지,6369,7046,13415,6707.5
20240709,4호선,숙대입구(갈월),15480,14983,30463,15231.5
20240709,4호선,서울역,14186,21773,35959,17979.5
20240709,4호선,회현(남대문시장),29384,30326,59710,29855
20240709,4호선,명동,31430,33139,64569,32284.5
20240709,4호선,충무로,32722,33428,66150,33075
20240709,4호선,동대문역사문화공원(DDP),19214,17019,36233,18116.5
20240709,4호선,동대문,21591,21993,43584,21792
20240709,4호선,혜화,35245,35383,70628,35314
20240709,4호선,한성대입구(삼선교),14157,13655,27812,13906
20240709,4호선,성신여대입구(돈암),22138,21676,43814,21907
20240709,4호선,길음,22657,22236,44893,22446.5
20240709,4호선,미아사거리,28446,27998,56444,28222
20240709,4호선,미아(서울사이버대학),16387,15978,32365,16182.5
20240709,4호선,수유(강북구청),34901,35146,70047,35023.5
20240709,4호선,쌍문,31334,29189,60523,30261.5
20240709,4호선,창동,28006,29506,57512,28756
20240709,4호선,노원,30182,33627,63809,31904.5
20240709,4호선,상계,20770,19357,40127,20063.5
20240709,4호선,당고개,10136,8996,19132,9566
20240709,3호선,오금,7619,6766,14385,7192.5
20240709,3호선,경찰병원,8529,8579,17108,8554
20240709,3호선,가락시장,10015,9574,19589,9794.5
20240709,3호선,수서,19366,19393,38759,19379.5
20240709,3호선,일원,12823,12449,25272,12636
20240709,3호선,대청,12354,11597,23951,11975.5
20240709,3호선,학여울,2177,2212,4389,2194.5
20240709,3호선,대치,13502,13613,27115,13557.5
20240709,3호선,도곡,6532,6528,13060,6530
20240709,3호선,매봉,14364,14063,28427,14213.5
20240709,3호선,양재(서초구청),41980,45082,87062,43531
20240709,3호선,남부터미널(예술의전당),31615,32347,63962,31981
20240709,3호선,교대(법원.검찰청),19366,11618,30984,15492
20240709,3호선,고속터미널,43932,40658,84590,42295
20240709,3호선,잠원,5542,5343,10885,5442.5
20240709,3호선,신사,30543,31562,62105,31052.5
20240709,3호선,압구정,35222,37455,72677,36338.5
20240709,3호선,옥수,9473,9823,19296,9648
20240709,3호선,금호,8675,8244,16919,8459.5
20240709,3호선,약수,13900,13604,27504,13752
20240709,3호선,동대입구,9466,9843,19309,9654.5
20240709,3호선,충무로,10,0,10,5
20240709,3호선,을지로3가,12698,12707,25405,12702.5
20240709,3호선,종로3가,12015,13065,25080,12540
20240709,3호선,안국,26962,28004,54966,27483
20240709,3호선,경복궁(정부서울청사),22805,22445,45250,22625
20240709,3호선,독립문,7937,8022,15959,7979.5
20240709,3호선,무악재,4864,4781,9645,4822.5
20240709,3호선,홍제,18992,18074,37066,18533
20240709,3호선,녹번,16597,15423,32020,16010
20240709,3호선,불광,17738,18764,36502,18251
20240709,3호선,연신내,36178,34340,70518,35259
20240709,3호선,구파발,23505,22575,46080,23040
20240709,3호선,지축,8421,8323,16744,8372
20240709,2호선,용두(동대문구청),2744,2890,5634,2817
20240709,2호선,신정네거리,10972,11436,22408,11204
20240709,2호선,양천구청,7915,8266,16181,8090.5
20240709,2호선,도림천,1510,1632,3142,1571
20240709,2호선,신설동,3367,3341,6708,3354
20240709,2호선,신답,1900,2136,4036,2018
20240709,2호선,용답,3185,3068,6253,3126.5
20240709,2호선,충정로(경기대입구),11583,12114,23697,11848.5
20240709,2호선,아현,12078,11141,23219,11609.5
20240709,2호선,이대,16308,18130,34438,17219
20240709,2호선,신촌,39769,40426,80195,40097.5
20240709,2호선,홍대입구,68340,71939,140279,70139.5
20240709,2호선,합정,32981,34996,67977,33988.5
20240709,2호선,당산,19297,22572,41869,20934.5
20240709,2호선,영등포구청,25090,25665,50755,25377.5
20240709,2호선,문래,25898,26405,52303,26151.5
20240709,2호선,신도림,53945,51844,105789,52894.5
20240709,2호선,대림(구로구청),25953,26485,52438,26219
20240709,2호선,구로디지털단지,63261,62726,125987,62993.5
20240709,2호선,신대방,26970,26194,53164,26582
20240709,2호선,신림,57701,55706,113407,56703.5
20240709,2호선,봉천,26455,25350,51805,25902.5
20240709,2호선,서울대입구(관악구청),48517,47783,96300,48150
20240709,2호선,낙성대(강감찬),29895,29245,59140,29570
20240709,2호선,사당,42086,45392,87478,43739
20240709,2호선,방배,17344,17899,35243,17621.5
20240709,2호선,서초,24199,23832,48031,24015.5
20240709,2호선,교대(법원.검찰청),36589,43410,79999,39999.5
20240709,2호선,강남,90955,88693,179648,89824
20240709,2호선,역삼,61563,69918,131481,65740.5
20240709,2호선,선릉,67176,58970,126146,63073
20240709,2호선,삼성(무역센터),60927,62641,123568,61784
20240709,2호선,종합운동장,20089,22224,42313,21156.5
20240709,2호선,잠실새내,26054,25143,51197,25598.5
20240709,2호선,잠실(송파구청),80773,80009,160782,80391
20240709,2호선,잠실나루,18435,17959,36394,18197
20240709,2호선,강변(동서울터미널),29545,27419,56964,28482
20240709,2호선,구의(광진구청),27529,26761,54290,27145
20240709,2호선,건대입구,35779,37336,73115,36557.5
20240709,2호선,성수,45913,50310,96223,48111.5
20240709,2호선,뚝섬,26514,27749,54263,27131.5
20240709,2호선,한양대,10843,11711,22554,11277
20240709,2호선,왕십리(성동구청),16388,14571,30959,15479.5
20240709,2호선,상왕십리,16035,15920,31955,15977.5
20240709,2호선,신당,15620,16314,31934,15967
20240709,2호선,동대문역사문화공원(DDP),14752,16731,31483,15741.5
20240709,2호선,을지로4가,15858,15809,31667,15833.5
20240709,2호선,을지로3가,27274,27296,54570,27285
20240709,2호선,을지로입구,54413,56175,110588,55294
20240709,2호선,시청,30115,29138,59253,29626.5
20240709,1호선,동묘앞,8655,8791,17446,8723
20240709,1호선,청량리(서울시립대입구),23151,22571,45722,22861
20240709,1호선,제기동,17750,17829,35579,17789.5
20240709,1호선,신설동,15018,14567,29585,14792.5
20240709,1호선,동대문,11584,11134,22718,11359
20240709,1호선,종로5가,24964,24704,49668,24834
20240709,1호선,종로3가,26367,24322,50689,25344.5
20240709,1호선,종각,43228,42828,86056,43028
20240709,1호선,시청,28439,28428,56867,28433.5
20240709,1호선,서울역,54976,52166,107142,53571
20240709,8호선,산성,6850,6965,13815,6907.5
20240709,중앙선,팔당,802,797,1599,799.5
20240709,중앙선,도심,2767,2240,5007,2503.5
20240709,중앙선,덕소,5735,5809,11544,5772
20240709,중앙선,양정,561,466,1027,513.5
20240709,중앙선,도농,12188,11093,23281,11640.5
20240709,중앙선,구리,14261,14363,28624,14312
20240709,중앙선,양원,3596,3483,7079,3539.5
20240709,중앙선,망우,8117,7774,15891,7945.5
20240709,중앙선,상봉,6164,6115,12279,6139.5
20240709,중앙선,중랑,5870,5544,11414,5707
20240709,중앙선,회기,26347,25282,51629,25814.5
20240709,장항선,신창(순천향대),1157,1169,2326,1163
20240709,장항선,온양온천,4596,4655,9251,4625.5
20240709,장항선,배방,1150,1093,2243,1121.5
20240709,장항선,탕정,1638,1493,3131,1565.5
20240709,장항선,아산,3161,2921,6082,3041
20240709,장항선,쌍용(나사렛대),2341,2230,4571,2285.5
20240709,장항선,봉명,1495,1485,2980,1490
20240709,일산선,대화,14084,11134,25218,12609
20240709,일산선,주엽,10626,10788,21414,10707
20240709,일산선,정발산,7422,7682,15104,7552
20240709,일산선,마두,8802,9029,17831,8915.5
20240709,일산선,백석,10637,10765,21402,10701
20240709,일산선,대곡,3154,2398,5552,2776
20240709,일산선,화정,17902,18449,36351,18175.5
20240709,일산선,원당,11822,11299,23121,11560.5
20240709,일산선,삼송,20604,19943,40547,20273.5
20240709,일산선,원흥,12265,11751,24016,12008
20240709,우이신설선,신설동,2571,2446,5017,2508.5
20240709,우이신설선,보문,1750,1757,3507,1753.5
20240709,우이신설선,성신여대입구(돈암),3811,4035,7846,3923
20240709,우이신설선,정릉,4958,4695,9653,4826.5
20240709,우이신설선,북한산보국문,6609,6438,13047,6523.5
20240709,우이신설선,솔샘,6494,6235,12729,6364.5
20240709,우이신설선,삼양사거리,2770,2968,5738,2869
20240709,우이신설선,삼양,2148,2303,4451,2225.5
20240709,우이신설선,화계,3957,3725,7682,3841
20240709,우이신설선,가오리,4779,4876,9655,4827.5
20240709,중앙선,지평,54,56,110,55
20240709,중앙선,용문,1819,1807,3626,1813
20240709,중앙선,원덕,362,327,689,344.5
20240709,중앙선,양평,3165,3117,6282,3141
20240709,중앙선,오빈,340,372,712,356
20240709,중앙선,아신,460,477,937,468.5
20240709,중앙선,국수,757,704,1461,730.5
20240709,중앙선,신원,170,163,333,166.5
20240709,중앙선,양수,2247,2234,4481,2240.5
20240709,중앙선,운길산,659,681,1340,670
20240709,우이신설선,4.19민주묘지,3206,3058,6264,3132
20240709,우이신설선,솔밭공원,2975,2857,5832,2916
20240709,우이신설선,북한산우이,2758,2442,5200,2600
20240709,안산선,수리산,4437,3687,8124,4062
20240709,안산선,오이도,7927,7665,15592,7796
20240709,안산선,정왕,9279,9423,18702,9351
20240709,안산선,신길온천,2108,1871,3979,1989.5
20240709,안산선,안산,12305,11004,23309,11654.5
20240709,안산선,초지,5138,5156,10294,5147
20240709,안산선,고잔,9448,8898,18346,9173
20240709,안산선,중앙,18320,18983,37303,18651.5
20240709,안산선,한대앞,9486,9561,19047,9523.5
20240709,안산선,상록수,15098,15525,30623,15311.5
20240709,안산선,반월,4404,4389,8793,4396.5
20240709,안산선,대야미,5206,4631,9837,4918.5
20240709,안산선,산본,17199,18191,35390,17695
20240709,신림선,관악산(서울대),2847,2814,5661,2830.5
20240709,신림선,서울대벤처타운,10091,9429,19520,9760
20240709,신림선,서원,3790,3509,7299,3649.5
20240709,신림선,신림,2048,2680,4728,2364
20240709,신림선,당곡,5308,5306,10614,5307
20240709,신림선,보라매병원,9055,9522,18577,9288.5
20240709,신림선,보라매공원,2693,2799,5492,2746
20240709,신림선,보라매,4803,4334,9137,4568.5
20240709,신림선,서울지방병무청,3555,3889,7444,3722
20240709,신림선,대방,3038,2464,5502,2751
20240709,신림선,샛강,3387,3877,7264,3632
20240709,수인선,인천,997,1554,2551,1275.5
20240709,수인선,신포,1951,2026,3977,1988.5
20240709,수인선,숭의,4422,4136,8558,4279
20240709,수인선,인하대,6837,6552,13389,6694.5
20240709,수인선,송도,2621,2406,5027,2513.5
20240709,수인선,연수,4988,4960,9948,4974
20240709,수인선,원인재,4667,4781,9448,4724
20240709,수인선,남동인더스파크,2478,2837,5315,2657.5
20240709,수인선,호구포,4162,4304,8466,4233
20240709,수인선,인천논현,5748,6086,11834,5917
20240709,수인선,소래포구,4771,4375,9146,4573
20240709,수인선,월곶,2993,2685,5678,2839
20240709,수인선,달월,124,62,186,93
20240709,수인선,사리,5371,4756,10127,5063.5
20240709,수인선,야목,430,376,806,403
20240709,수인선,어천,1409,1392,2801,1400.5
20240709,수인선,오목천,4091,3779,7870,3935
20240709,수인선,고색,6036,5382,11418,5709
20240709,서해선,부천종합운동장,2773,2316,5089,2544.5
20240709,서해선,원종,4968,5042,10010,5005
20240709,서해선,김포공항,2981,3719,6700,3350
20240709,분당선,매교,5759,5747,11506,5753
20240709,분당선,수원시청,14238,15137,29375,14687.5
20240709,분당선,매탄권선,5900,5785,11685,5842.5
20240709,분당선,망포,16730,16019,32749,16374.5
20240709,분당선,영통,9161,9331,18492,9246
20240709,분당선,청명,5020,4855,9875,4937.5
20240709,분당선,상갈,5623,5412,11035,5517.5
20240709,분당선,기흥,10832,9853,20685,10342.5
20240709,분당선,신갈,5288,5081,10369,5184.5
20240709,분당선,구성,6657,6811,13468,6734
20240709,분당선,죽전,13305,14680,27985,13992.5
20240709,분당선,보정,2998,2687,5685,2842.5
20240709,분당선,이매,6226,5843,12069,6034.5
20240709,분당선,오리,12511,10747,23258,11629
20240709,분당선,미금,16677,17281,33958,16979
20240709,분당선,정자,20439,21433,41872,20936
20240709,분당선,수내,15730,15898,31628,15814
20240709,분당선,서현,25671,26418,52089,26044.5
20240709,분당선,야탑,27497,28880,56377,28188.5
20240709,분당선,모란,24604,25152,49756,24878
20240709,분당선,태평,14020,13478,27498,13749
20240709,분당선,가천대,7643,7913,15556,7778
20240709,분당선,선정릉,8818,9294,18112,9056
20240709,분당선,강남구청,10859,12546,23405,11702.5
20240709,분당선,압구정로데오,19625,21333,40958,20479
20240709,분당선,서울숲,12954,13014,25968,12984
20240709,분당선,수원,7914,7313,15227,7613.5
20240709,분당선,복정,8,0,8,4
20240709,분당선,수서,17771,18710,36481,18240.5
20240709,분당선,대모산입구,6748,6542,13290,6645
20240709,분당선,개포동,4992,5123,10115,5057.5
20240709,분당선,구룡,4138,4086,8224,4112
20240709,분당선,도곡,8618,8650,17268,8634
20240709,분당선,한티,16801,18188,34989,17494.5
20240709,분당선,선릉,15527,23520,39047,19523.5
20240709,과천선,범계,28600,28527,57127,28563.5
20240709,과천선,평촌,19590,19136,38726,19363
20240709,과천선,인덕원,27572,28417,55989,27994.5
20240709,과천선,정부과천청사,13823,14358,28181,14090.5
20240709,과천선,과천,7139,6611,13750,6875
20240709,과천선,대공원,2695,2789,5484,2742
20240709,과천선,경마공원,1540,1481,3021,1510.5
20240709,과천선,선바위,8213,7323,15536,7768
20240709,공항철도 1호선,영종,4266,4263,8529,4264.5
20240709,공항철도 1호선,인천공항2터미널,6660,5655,12315,6157.5
20240709,공항철도 1호선,인천공항1터미널,13833,13084,26917,13458.5
20240709,공항철도 1호선,공항화물청사,2289,2470,4759,2379.5
20240709,공항철도 1호선,운서,9349,9797,19146,9573
20240709,공항철도 1호선,청라국제도시,8139,7720,15859,7929.5
20240709,공항철도 1호선,검암,6885,6980,13865,6932.5
20240709,공항철도 1호선,계양,14226,13601,27827,13913.5
20240709,공항철도 1호선,김포공항,10401,5993,16394,8197
20240709,공항철도 1호선,마곡나루(서울식물원),13086,12378,25464,12732
20240709,공항철도 1호선,디지털미디어시티,15954,15113,31067,15533.5
20240709,공항철도 1호선,홍대입구,13893,13433,27326,13663
20240709,공항철도 1호선,공덕,3278,4228,7506,3753
20240709,공항철도 1호선,서울역,12007,10587,22594,11297
20240709,경춘선,춘천,1129,971,2100,1050
20240709,경춘선,남춘천,2264,2302,4566,2283
20240709,경춘선,김유정,398,385,783,391.5
20240709,경춘선,강촌,392,346,738,369
20240709,경춘선,백양리,58,53,111,55.5
20240709,경춘선,굴봉산,118,87,205,102.5
20240709,경춘선,가평,2286,2126,4412,2206
20240709,경춘선,상천,305,271,576,288
20240709,경춘선,청평,1890,1729,3619,1809.5
20240709,경춘선,대성리,1085,671,1756,878
20240709,경춘선,마석,3936,3814,7750,3875
20240709,경춘선,천마산,1527,1503,3030,1515
20240709,경춘선,평내호평,6472,6283,12755,6377.5
20240709,경춘선,금곡,1613,1509,3122,1561
20240709,경춘선,사릉,2145,2163,4308,2154
20240709,경춘선,퇴계원,3918,3546,7464,3732
20240709,경춘선,별내,3728,3618,7346,3673
20240709,경춘선,갈매,3274,2918,6192,3096
20240709,경춘선,신내,3060,2806,5866,2933
20240709,경인선,도화,4621,4248,8869,4434.5
20240709,경인선,중동,10091,9404,19495,9747.5
20240709,경인선,온수(성공회대입구),6875,6560,13435,6717.5
20240709,경인선,도원,3750,3794,7544,3772
20240709,경인선,간석,6266,5942,12208,6104
20240709,경인선,부개,9285,8775,18060,9030
20240709,경인선,소사,7776,7597,15373,7686.5
20240709,경인선,구일,13013,14564,27577,13788.5
20240709,경인선,인천,3577,2781,6358,3179
20240709,경인선,동인천,14536,13744,28280,14140
20240709,경인선,제물포,11173,10926,22099,11049.5
20240709,경인선,주안,18892,17274,36166,18083
20240709,경인선,동암,16177,16367,32544,16272
20240709,경인선,백운,8023,7582,15605,7802.5
20240709,경인선,부평,28658,30072,58730,29365
20240709,경인선,송내,28145,27756,55901,27950.5
20240709,경인선,부천,31505,31339,62844,31422
20240709,경인선,역곡,26870,27077,53947,26973.5
20240709,경인선,오류동,12225,11559,23784,11892
20240709,경인선,개봉,23560,23205,46765,23382.5
20240709,경의선,운천,11,3,14,7
20240709,경의선,임진강,25,9,34,17
20240709,경의선,문산,5602,5484,11086,5543
20240709,경의선,파주,1253,848,2101,1050.5
20240709,경의선,월롱,2230,1944,4174,2087
20240709,경의선,금촌,6736,6490,13226,6613
20240709,경의선,금릉,6129,5676,11805,5902.5
20240709,경의선,운정,8396,7943,16339,8169.5
20240709,경의선,야당,9377,9387,18764,9382
20240709,경의선,탄현,8370,8195,16565,8282.5
20240709,경의선,일산,11619,11478,23097,11548.5
20240709,경의선,풍산,6666,6329,12995,6497.5
20240709,경의선,백마,8118,7894,16012,8006
20240709,경의선,곡산,749,817,1566,783
20240709,경의선,능곡,5136,4850,9986,4993
20240709,경의선,행신,8552,8586,17138,8569
20240709,경의선,강매,3625,3015,6640,3320
20240709,경의선,한국항공대,2207,2075,4282,2141
20240709,경의선,수색,3859,4043,7902,3951
20240709,경의선,디지털미디어시티,2977,2759,5736,2868
20240709,경의선,가좌,6493,6141,12634,6317
20240709,경의선,홍대입구,2017,2476,4493,2246.5
20240709,경의선,서강대,2350,2305,4655,2327.5
20240709,경의선,공덕,4494,3867,8361,4180.5
20240709,경의선,효창공원앞,3509,4099,7608,3804
20240709,경의선,신촌,1165,1402,2567,1283.5
20240709,경의선,서울역,5125,6292,11417,5708.5
20240709,경원선,연천,1165,1041,2206,1103
20240709,경원선,전곡,1222,1051,2273,1136.5
20240709,경원선,청산,158,129,287,143.5
20240709,경원선,소요산,1567,1511,3078,1539
20240709,경원선,동두천,1821,1808,3629,1814.5
20240709,경원선,보산,1542,1445,2987,1493.5
20240709,경원선,동두천중앙,3134,3062,6196,3098
20240709,경원선,지행,6721,6734,13455,6727.5
20240709,경원선,덕정,6305,5984,12289,6144.5
20240709,경원선,덕계,6348,5811,12159,6079.5
20240709,경원선,양주,7408,7087,14495,7247.5
20240709,경원선,녹양,4601,4356,8957,4478.5
20240709,경원선,가능,6996,6803,13799,6899.5
20240709,경원선,의정부,18547,18964,37511,18755.5
20240709,경원선,회룡,13980,13546,27526,13763
20240709,경원선,망월사,7721,7860,15581,7790.5
20240709,경원선,도봉산,7435,4670,12105,6052.5
20240709,경원선,도봉,6661,6473,13134,6567
20240709,경원선,방학,10736,10341,21077,10538.5
20240709,경원선,창동,3,0,3,1.5
20240709,경원선,녹천,4973,4205,9178,4589
20240709,경원선,월계,7014,6584,13598,6799
20240709,경원선,광운대,8448,8074,16522,8261
20240709,경원선,석계,7648,8748,16396,8198
20240709,경원선,신이문,9218,8528,17746,8873
20240709,경원선,외대앞,9219,9108,18327,9163.5
20240709,경원선,청량리(서울시립대입구),15615,16724,32339,16169.5
20240709,경원선,왕십리(성동구청),17279,17232,34511,17255.5
20240709,경원선,응봉,2048,1733,3781,1890.5
20240709,경원선,옥수,55,35,90,45
20240709,경원선,한남,4273,4177,8450,4225
20240709,경원선,서빙고,2379,2166,4545,2272.5
20240709,경원선,이촌(국립중앙박물관),4401,3533,7934,3967
20240709,경부선,광명,3702,3325,7027,3513.5
20240709,경부선,서동탄,1631,1321,2952,1476
20240709,경부선,당정,6482,6096,12578,6289
20240709,경부선,천안,5402,5499,10901,5450.5
20240709,경부선,두정,6149,6221,12370,6185
20240709,경부선,직산,992,917,1909,954.5
20240709,경부선,성환,3723,3767,7490,3745
20240709,경부선,평택,11173,10968,22141,11070.5
20240709,경부선,평택지제,4103,3956,8059,4029.5
20240709,경부선,서정리,7890,7323,15213,7606.5
20240709,경부선,송탄,4133,4132,8265,4132.5
20240709,경부선,진위,1778,1704,3482,1741
20240709,경부선,오산,9465,9705,19170,9585
20240709,경부선,오산대,3591,3307,6898,3449
20240709,경부선,세마,3516,3302,6818,3409
20240709,경부선,병점,14735,14534,29269,14634.5
20240709,경부선,세류,3453,3166,6619,3309.5
20240709,경부선,독산,19178,20057,39235,19617.5
20240709,경부선,수원,34032,35729,69761,34880.5
20240709,경부선,화서,11776,11405,23181,11590.5
20240709,경부선,성균관대,15588,15266,30854,15427
20240709,경부선,의왕,9723,9783,19506,9753
20240709,경부선,군포,7860,7790,15650,7825
20240709,경부선,금정,29421,29850,59271,29635.5
20240709,경부선,명학,9561,9393,18954,9477
20240709,경부선,안양,22063,21897,43960,21980
20240709,경부선,관악,7694,7465,15159,7579.5
20240709,경부선,석수,9120,8338,17458,8729
20240709,경부선,금천구청,11965,12099,24064,12032
20240709,경부선,가산디지털단지,19831,22696,42527,21263.5
20240709,경부선,구로,18831,18876,37707,18853.5
20240709,경부선,신길,9438,8076,17514,8757
20240709,경부선,신도림,4350,4486,8836,4418
20240709,경부선,영등포,40549,41225,81774,40887
20240709,경부선,대방,11335,12238,23573,11786.5
20240709,경부선,노량진,8061,7845,15906,7953
20240709,경부선,용산,38094,38593,76687,38343.5
20240709,경부선,남영,10731,11080,21811,10905.5
20240709,경부선,서울역,8060,2838,10898,5449
20240709,경강선,성남,957,887,1844,922
20240709,경강선,여주,2627,2590,5217,2608.5
20240709,경강선,세종대왕릉,346,347,693,346.5
20240709,경강선,부발,2194,2117,4311,2155.5
20240709,경강선,이천,2875,2976,5851,2925.5
20240709,경강선,신둔도예촌,1510,1447,2957,1478.5
20240709,경강선,곤지암,2215,2098,4313,2156.5
20240709,경강선,초월,3618,3449,7067,3533.5
20240709,경강선,경기광주,8384,7998,16382,8191
20240709,경강선,삼동,2842,2578,5420,2710
20240709,경강선,이매,1198,1031,2229,1114.5
20240709,경강선,판교,6203,6261,12464,6232
20240709,9호선2~3단계,중앙보훈병원,14139,12554,26693,13346.5
20240709,9호선2~3단계,둔촌오륜,1536,1474,3010,1505
20240709,9호선2~3단계,올림픽공원(한국체대),5691,6137,11828,5914
20240709,9호선2~3단계,한성백제,3289,3030,6319,3159.5
20240709,9호선2~3단계,송파나루,6142,6467,12609,6304.5
20240709,9호선2~3단계,석촌,10616,9362,19978,9989
20240709,9호선2~3단계,석촌고분,7961,7849,15810,7905
20240709,9호선2~3단계,삼전,8918,8313,17231,8615.5
20240710,경부선,화서,12147,11921,24068,12034
20240710,경부선,성균관대,16077,15854,31931,15965.5
20240710,경부선,의왕,9866,9687,19553,9776.5
20240710,경부선,군포,7892,7837,15729,7864.5
20240710,경부선,금정,30330,30596,60926,30463
20240710,경부선,명학,9554,9388,18942,9471
20240710,경부선,안양,22984,22647,45631,22815.5
20240710,경부선,관악,7918,7574,15492,7746
20240710,경부선,석수,9215,8471,17686,8843
20240710,경부선,금천구청,12100,12073,24173,12086.5
20240710,경부선,가산디지털단지,19968,22691,42659,21329.5
20240710,경부선,구로,19231,19501,38732,19366
20240710,경부선,신길,9784,8265,18049,9024.5
20240710,경부선,신도림,4354,4609,8963,4481.5
20240710,경부선,영등포,41470,42131,83601,41800.5
20240710,경부선,대방,11631,12625,24256,12128
20240710,경부선,노량진,8119,7934,16053,8026.5
20240710,경부선,용산,36848,38009,74857,37428.5
20240710,경부선,남영,10574,11028,21602,10801
20240710,경부선,서울역,8168,3009,11177,5588.5
20240710,경강선,성남,930,892,1822,911
20240710,경강선,여주,2694,2713,5407,2703.5
20240710,경강선,세종대왕릉,365,338,703,351.5
20240710,경강선,부발,2200,2146,4346,2173
20240710,경강선,이천,2844,3016,5860,2930
20240710,경강선,신둔도예촌,1523,1413,2936,1468
20240710,경강선,곤지암,2261,2278,4539,2269.5
20240710,경강선,초월,3684,3527,7211,3605.5
20240710,경강선,경기광주,8564,8041,16605,8302.5
20240710,경강선,삼동,2811,2649,5460,2730
20240710,경강선,이매,1171,1047,2218,1109
20240710,경강선,판교,6352,6183,12535,6267.5
20240710,9호선2~3단계,중앙보훈병원,13913,12440,26353,13176.5
20240710,9호선2~3단계,둔촌오륜,1617,1546,3163,1581.5
20240710,9호선2~3단계,올림픽공원(한국체대),5703,6112,11815,5907.5
20240710,9호선2~3단계,한성백제,3389,3119,6508,3254
20240710,9호선2~3단계,송파나루,6204,6681,12885,6442.5
20240710,9호선2~3단계,석촌,10826,9540,20366,10183
20240710,9호선2~3단계,석촌고분,8185,7902,16087,8043.5
20240710,9호선2~3단계,삼전,8991,8431,17422,8711
20240710,9호선2~3단계,종합운동장,5655,5674,11329,5664.5
20240710,9호선2~3단계,봉은사,21994,23211,45205,22602.5
20240710,9호선2~3단계,삼성중앙,9217,9650,18867,9433.5
20240710,9호선2~3단계,선정릉,11460,12324,23784,11892
20240710,9호선2~3단계,언주,13256,13405,26661,13330.5
20240710,9호선,신논현,33507,33535,67042,33521
20240710,9호선,사평,4706,4464,9170,4585
20240710,9호선,고속터미널,15252,19965,35217,17608.5
20240710,9호선,신반포,4632,4529,9161,4580.5
20240710,9호선,구반포,1491,1460,2951,1475.5
20240710,9호선,동작(현충원),1829,1530,3359,1679.5
20240710,9호선,흑석(중앙대입구),9689,9959,19648,9824
20240710,9호선,노들,5407,4434,9841,4920.5
20240710,9호선,노량진,27424,26694,54118,27059
20240710,9호선,샛강,7472,7604,15076,7538
20240710,9호선,여의도,35003,34172,69175,34587.5
20240710,9호선,국회의사당,21592,21248,42840,21420
20240710,9호선,당산,21663,21347,43010,21505
20240710,9호선,선유도,10393,9734,20127,10063.5
20240710,9호선,신목동,5019,4529,9548,4774
20240710,9호선,염창,19829,19140,38969,19484.5
20240710,9호선,등촌,13929,13372,27301,13650.5
20240710,9호선,증미,9512,9268,18780,9390
20240710,9호선,가양,24839,24249,49088,24544
20240710,9호선,양천향교,11208,11650,22858,11429
20240710,9호선,마곡나루(서울식물원),15680,15404,31084,15542
20240710,9호선,신방화,8102,8050,16152,8076
20240710,9호선,공항시장,3257,3626,6883,3441.5
20240710,9호선,김포공항,7142,10049,17191,8595.5
20240710,9호선,개화,3110,2129,5239,2619.5
20240710,8호선,남위례,8390,8457,16847,8423.5
20240710,8호선,모란,5208,3995,9203,4601.5
20240710,8호선,수진,6401,5922,12323,6161.5
20240710,8호선,신흥,5640,5915,11555,5777.5
20240710,8호선,단대오거리,13165,12825,25990,12995
20240710,8호선,남한산성입구(성남법원.검찰청),14428,12925,27353,13676.5
20240710,8호선,산성,6940,7188,14128,7064
20240710,8호선,복정,10359,8806,19165,9582.5
20240710,8호선,장지,19033,17503,36536,18268
20240710,8호선,문정,25542,26654,52196,26098
20240710,8호선,가락시장,8620,9453,18073,9036.5
20240710,8호선,송파,10807,10650,21457,10728.5
20240710,8호선,석촌,8773,10188,18961,9480.5
20240710,8호선,잠실(송파구청),17579,20282,37861,18930.5
20240710,8호선,몽촌토성(평화의문),7405,7501,14906,7453
20240710,8호선,강동구청,11910,12313,24223,12111.5
20240710,8호선,천호(풍납토성),16767,18724,35491,17745.5
20240710,8호선,암사,20775,18471,39246,19623
20240710,7호선,온수(성공회대입구),10930,9834,20764,10382
20240710,7호선,천왕,13335,12760,26095,13047.5
20240710,7호선,광명사거리,21601,21451,43052,21526
20240710,7호선,철산,23902,23889,47791,23895.5
20240710,7호선,가산디지털단지,51430,51928,103358,51679
20240710,7호선,남구로,16516,17293,33809,16904.5
20240710,7호선,대림(구로구청),9488,9551,19039,9519.5
20240710,7호선,신풍,12354,11533,23887,11943.5
20240710,7호선,보라매,7394,7622,15016,7508
20240710,7호선,신대방삼거리,16219,15711,31930,15965
20240710,7호선,장승배기,10156,10005,20161,10080.5
20240710,7호선,상도,12459,12147,24606,12303
20240710,7호선,숭실대입구(살피재),13873,13927,27800,13900
20240710,7호선,남성,12695,11999,24694,12347
20240710,7호선,이수,18184,17543,35727,17863.5
20240710,7호선,내방,16860,17080,33940,16970
20240710,7호선,고속터미널,16981,14481,31462,15731
20240710,7호선,반포,7243,7064,14307,7153.5
20240710,7호선,논현,21172,21734,42906,21453
20240710,7호선,학동,27361,28570,55931,27965.5
20240710,7호선,강남구청,18547,20629,39176,19588
20240710,7호선,청담,21355,23563,44918,22459
20240710,7호선,자양(뚝섬한강공원),9634,9355,18989,9494.5
20240710,7호선,건대입구,14303,14344,28647,14323.5
20240710,7호선,어린이대공원(세종대),15390,15152,30542,15271
20240710,7호선,군자(능동),16920,13488,30408,15204
20240710,7호선,중곡,12671,11810,24481,12240.5
20240710,7호선,용마산(용마폭포공원),6254,6164,12418,6209
20240710,7호선,사가정,17492,17471,34963,17481.5
20240710,7호선,면목,16221,15782,32003,16001.5
20240710,7호선,상봉,18933,18067,37000,18500
20240710,7호선,중화,11656,11452,23108,11554
20240710,7호선,먹골,11246,11275,22521,11260.5
20240710,7호선,태릉입구,9405,8866,18271,9135.5
20240710,7호선,공릉(서울과학기술대),13158,12976,26134,13067
20240710,7호선,하계,20127,18761,38888,19444
20240710,7호선,중계,17095,15668,32763,16381.5
20240710,7호선,노원,26234,27411,53645,26822.5
20240710,7호선,마들,14663,13722,28385,14192.5
20240710,7호선,수락산,13330,13229,26559,13279.5
20240710,7호선,도봉산,9489,10898,20387,10193.5
20240710,7호선,장암,3085,1306,4391,2195.5
20240710,6호선,봉화산(서울의료원),10079,9320,19399,9699.5
20240710,6호선,화랑대(서울여대입구),12930,10177,23107,11553.5
20240710,6호선,태릉입구,6062,6591,12653,6326.5
20240710,6호선,석계,13614,13883,27497,13748.5
20240710,6호선,돌곶이,11243,10431,21674,10837
20240710,6호선,상월곡(한국과학기술연구원),6884,6258,13142,6571
20240710,6호선,월곡(동덕여대),12665,12487,25152,12576
20240710,6호선,고려대(종암),9376,8958,18334,9167
20240710,6호선,안암(고대병원앞),12759,12681,25440,12720
20240710,6호선,보문,8602,8040,16642,8321
20240710,6호선,창신,4025,3313,7338,3669
20240710,6호선,동묘앞,8395,8609,17004,8502
20240710,6호선,신당,9108,9669,18777,9388.5
20240710,6호선,청구,4427,4375,8802,4401
20240710,6호선,약수,4048,3986,8034,4017
20240710,6호선,버티고개,2389,2412,4801,2400.5
20240710,6호선,한강진,12034,13755,25789,12894.5
20240710,6호선,이태원,10928,11637,22565,11282.5
20240710,6호선,녹사평(용산구청),5813,5501,11314,5657
20240710,6호선,삼각지,8012,7079,15091,7545.5
20240710,6호선,효창공원앞,8364,7467,15831,7915.5
20240710,6호선,공덕,21664,21329,42993,21496.5
20240710,6호선,대흥(서강대앞),10057,10456,20513,10256.5
20240710,6호선,광흥창(서강),10766,10522,21288,10644
20240710,6호선,상수,10041,11051,21092,10546
20240710,6호선,합정,14420,14250,28670,14335
20240710,6호선,망원,15969,16966,32935,16467.5
20240710,6호선,마포구청,16314,14807,31121,15560.5
20240710,6호선,월드컵경기장(성산),11021,12182,23203,11601.5
20240710,6호선,디지털미디어시티,16881,18212,35093,17546.5
20240710,6호선,증산(명지대앞),10567,10489,21056,10528
20240710,6호선,새절(신사),14189,13076,27265,13632.5
20240710,6호선,구산,9276,7139,16415,8207.5
20240710,6호선,연신내,4,0,4,2
20240710,6호선,독바위,3151,3271,6422,3211
20240710,6호선,불광,5541,5388,10929,5464.5
20240710,6호선,응암,19426,19245,38671,19335.5
20240710,5호선,하남검단산,7027,6730,13757,6878.5
20240710,5호선,하남시청(덕풍·신장),9030,8544,17574,8787
20240710,5호선,하남풍산,4923,4869,9792,4896
20240710,5호선,미사,19754,20068,39822,19911
20240710,5호선,강일,7052,6520,13572,6786
20240710,5호선,거여,11285,11186,22471,11235.5
20240710,5호선,개롱,7521,7687,15208,7604
20240710,5호선,오금,4236,4340,8576,4288
20240710,5호선,방이,7944,8371,16315,8157.5
20240710,5호선,올림픽공원(한국체대),6130,5006,11136,5568
20240710,5호선,둔촌동,9742,9728,19470,9735
20240710,5호선,상일동,16727,15647,32374,16187
20240710,5호선,고덕,12360,11857,24217,12108.5
20240710,5호선,명일,9790,10251,20041,10020.5
20240710,5호선,굽은다리(강동구민회관앞),10759,10364,21123,10561.5
20240710,5호선,길동,9063,9232,18295,9147.5
20240710,5호선,강동,20553,20207,40760,20380
20240710,5호선,천호(풍납토성),21013,20838,41851,20925.5
20240710,5호선,광나루(장신대),14571,13416,27987,13993.5
20240710,5호선,아차산(어린이대공원후문),16119,15514,31633,15816.5
20240710,5호선,군자(능동),12478,13836,26314,13157
20240710,5호선,장한평,21963,21761,43724,21862
20240710,5호선,답십리,17818,16116,33934,16967
20240710,5호선,마장,6529,6090,12619,6309.5
20240710,5호선,왕십리(성동구청),5066,5948,11014,5507
20240710,5호선,행당,9134,8073,17207,8603.5
20240710,5호선,신금호,7373,7785,15158,7579
20240710,5호선,청구,4373,4162,8535,4267.5
20240710,5호선,동대문역사문화공원(DDP),3514,4044,7558,3779
20240710,5호선,을지로4가,7512,7405,14917,7458.5
20240710,5호선,종로3가,15881,15976,31857,15928.5
20240710,5호선,광화문(세종문화회관),37368,39338,76706,38353
20240710,5호선,서대문,24168,24523,48691,24345.5
20240710,5호선,충정로(경기대입구),5459,5606,11065,5532.5
20240710,5호선,애오개,7820,7782,15602,7801
20240710,5호선,공덕,16787,17706,34493,17246.5
20240710,5호선,마포,16733,17130,33863,16931.5
20240710,5호선,여의나루,13351,14891,28242,14121
20240710,5호선,여의도,33248,35582,68830,34415
20240710,5호선,신길,5451,5553,11004,5502
20240710,5호선,영등포시장,12552,12718,25270,12635
20240710,5호선,영등포구청,5422,5372,10794,5397
20240710,5호선,양평,8717,8566,17283,8641.5
20240710,5호선,오목교(목동운동장앞),23000,24548,47548,23774
20240710,5호선,목동,18511,20059,38570,19285
20240710,5호선,신정(은행정),15009,12515,27524,13762
20240710,5호선,까치산,30401,29336,59737,29868.5
20240710,5호선,화곡,31216,29098,60314,30157
20240710,5호선,우장산,16591,16195,32786,16393
20240710,5호선,발산,25669,26157,51826,25913
20240710,5호선,마곡,13933,14104,28037,14018.5
20240710,5호선,송정,7089,6542,13631,6815.5
20240710,5호선,김포공항,11450,8198,19648,9824
20240710,5호선,개화산,6800,6516,13316,6658
20240710,5호선,방화,7765,7470,15235,7617.5
20240710,4호선,남태령,1493,1395,2888,1444
20240710,4호선,사당,27956,24196,52152,26076
20240710,4호선,총신대입구(이수),21136,22725,43861,21930.5
20240710,4호선,동작(현충원),1629,1724,3353,1676.5
20240710,4호선,이촌(국립중앙박물관),9771,10754,20525,10262.5
20240710,4호선,신용산,21212,22390,43602,21801
20240710,4호선,삼각지,6777,7475,14252,7126
20240710,4호선,숙대입구(갈월),15797,15351,31148,15574
20240710,4호선,서울역,14397,22260,36657,18328.5
20240710,4호선,회현(남대문시장),29674,30828,60502,30251
20240710,4호선,명동,32846,35091,67937,33968.5
20240710,4호선,충무로,33131,33938,67069,33534.5
20240710,4호선,동대문역사문화공원(DDP),19758,17573,37331,18665.5
20240710,4호선,동대문,22111,22739,44850,22425
20240710,4호선,혜화,37176,37652,74828,37414
20240710,4호선,한성대입구(삼선교),14528,13855,28383,14191.5
20240710,4호선,성신여대입구(돈암),22163,21595,43758,21879
20240710,4호선,길음,22997,22644,45641,22820.5
20240710,4호선,미아사거리,28840,28362,57202,28601
20240710,4호선,미아(서울사이버대학),16638,16087,32725,16362.5
20240710,4호선,수유(강북구청),36017,36152,72169,36084.5
20240710,4호선,쌍문,31923,29678,61601,30800.5
20240710,4호선,창동,29187,30469,59656,29828
20240710,4호선,노원,30684,34282,64966,32483
20240710,4호선,상계,20930,19648,40578,20289
20240710,4호선,당고개,10390,8812,19202,9601
20240710,3호선,오금,7446,6497,13943,6971.5
20240710,3호선,경찰병원,8621,8746,17367,8683.5
20240710,3호선,가락시장,9957,9696,19653,9826.5
20240710,3호선,수서,19700,19715,39415,19707.5
20240710,3호선,일원,12910,12568,25478,12739
20240710,3호선,대청,12512,11605,24117,12058.5
20240710,3호선,학여울,2226,2194,4420,2210
20240710,3호선,대치,13276,13375,26651,13325.5
20240710,3호선,도곡,6752,6765,13517,6758.5
20240710,3호선,매봉,14826,14215,29041,14520.5
20240710,3호선,양재(서초구청),42065,45156,87221,43610.5
20240710,3호선,남부터미널(예술의전당),32454,33191,65645,32822.5
20240710,3호선,교대(법원.검찰청),19417,11655,31072,15536
20240710,3호선,고속터미널,45855,43195,89050,44525
20240710,3호선,잠원,5955,5551,11506,5753
20240710,3호선,신사,29700,31395,61095,30547.5
20240710,3호선,압구정,35257,37108,72365,36182.5
20240710,3호선,옥수,9660,10015,19675,9837.5
20240710,3호선,금호,8951,8353,17304,8652
20240710,3호선,약수,14292,13866,28158,14079
20240710,3호선,동대입구,9581,10517,20098,10049
20240710,3호선,충무로,4,0,4,2
20240710,3호선,을지로3가,13192,13375,26567,13283.5
20240710,3호선,종로3가,12430,13676,26106,13053
20240710,3호선,안국,28771,29590,58361,29180.5
20240710,3호선,경복궁(정부서울청사),26066,26325,52391,26195.5
20240710,3호선,독립문,8117,8298,16415,8207.5
20240710,3호선,무악재,4880,4893,9773,4886.5
20240710,3호선,홍제,19605,18624,38229,19114.5
20240710,3호선,녹번,16804,15575,32379,16189.5
20240710,3호선,불광,18016,19244,37260,18630
20240710,3호선,연신내,37044,34982,72026,36013
20240710,3호선,구파발,24125,23167,47292,23646
20240710,3호선,지축,8512,8432,16944,8472
20240710,2호선,용두(동대문구청),2679,2795,5474,2737
20240710,2호선,신정네거리,11337,11791,23128,11564
20240710,2호선,양천구청,7607,8134,15741,7870.5
20240710,2호선,도림천,1541,1659,3200,1600
20240710,2호선,신설동,3512,3521,7033,3516.5
20240710,2호선,신답,1882,2122,4004,2002
20240710,2호선,용답,3181,3072,6253,3126.5
20240710,2호선,충정로(경기대입구),11718,12292,24010,12005
20240710,2호선,아현,12388,11389,23777,11888.5
20240710,2호선,이대,16884,18385,35269,17634.5
20240710,2호선,신촌,39711,40519,80230,40115
20240710,2호선,홍대입구,70225,75313,145538,72769
20240710,2호선,합정,33693,35901,69594,34797
20240710,2호선,당산,19749,23183,42932,21466
20240710,2호선,영등포구청,25850,26261,52111,26055.5
20240710,2호선,문래,26383,26971,53354,26677
20240710,2호선,신도림,55433,53822,109255,54627.5
20240710,2호선,대림(구로구청),26432,26794,53226,26613
20240710,2호선,구로디지털단지,64653,64297,128950,64475
20240710,2호선,신대방,27442,26734,54176,27088
20240710,2호선,신림,59192,56895,116087,58043.5
20240710,2호선,봉천,26858,25210,52068,26034
20240710,중앙선,오빈,328,335,663,331.5
20240710,중앙선,아신,531,519,1050,525
20240710,중앙선,국수,790,762,1552,776
20240710,중앙선,신원,170,175,345,172.5
20240710,중앙선,양수,2428,2435,4863,2431.5
20240710,중앙선,운길산,691,621,1312,656
20240710,중앙선,팔당,833,851,1684,842
20240710,중앙선,도심,2732,2125,4857,2428.5
20240710,중앙선,덕소,5849,5782,11631,5815.5
20240710,중앙선,양정,608,515,1123,561.5
20240710,중앙선,도농,12060,11071,23131,11565.5
20240710,중앙선,구리,14367,14484,28851,14425.5
20240710,중앙선,양원,3576,3491,7067,3533.5
20240710,중앙선,망우,8117,7905,16022,8011
20240710,중앙선,상봉,6147,6135,12282,6141
20240710,중앙선,중랑,5984,5818,11802,5901
20240710,5호선,마천,8501,7487,15988,7994
20240710,중앙선,지평,51,65,116,58
20240710,중앙선,용문,3371,3309,6680,3340
20240710,중앙선,원덕,388,352,740,370
20240710,중앙선,양평,3386,3291,6677,3338.5
20240710,6호선,역촌,4251,4762,9013,4506.5
20240710,2호선,서울대입구(관악구청),50583,48852,99435,49717.5
20240710,2호선,낙성대(강감찬),30492,29821,60313,30156.5
20240710,2호선,사당,43234,47154,90388,45194
20240710,2호선,방배,17466,18120,35586,17793
20240710,2호선,서초,24798,24040,48838,24419
20240710,2호선,교대(법원.검찰청),36191,42984,79175,39587.5
20240710,2호선,강남,92105,89957,182062,91031
20240710,2호선,역삼,61750,70066,131816,65908
20240710,2호선,선릉,67486,59256,126742,63371
20240710,2호선,삼성(무역센터),61408,62627,124035,62017.5
20240710,2호선,종합운동장,21952,24520,46472,23236
20240710,2호선,잠실새내,26299,25721,52020,26010
20240710,2호선,잠실(송파구청),83387,83000,166387,83193.5
20240710,2호선,잠실나루,17589,17159,34748,17374
20240710,2호선,강변(동서울터미널),30523,28532,59055,29527.5
20240710,2호선,구의(광진구청),27606,26847,54453,27226.5
20240710,2호선,건대입구,37033,39245,76278,38139
20240710,2호선,뚝섬,27041,28890,55931,27965.5
20240710,2호선,한양대,10718,11395,22113,11056.5
20240710,2호선,왕십리(성동구청),16907,15216,32123,16061.5
20240710,2호선,상왕십리,16215,16020,32235,16117.5
20240710,2호선,신당,15827,16323,32150,16075
20240710,2호선,동대문역사문화공원(DDP),15489,17656,33145,16572.5
20240710,2호선,을지로4가,15824,15870,31694,15847
20240710,2호선,을지로3가,28733,28571,57304,28652
20240710,2호선,을지로입구,54847,56444,111291,55645.5
20240710,2호선,시청,30595,29493,60088,30044
20240710,1호선,동묘앞,9115,9390,18505,9252.5
20240710,1호선,청량리(서울시립대입구),23758,22837,46595,23297.5
20240710,1호선,제기동,17528,17637,35165,17582.5
20240710,1호선,신설동,15174,14732,29906,14953
20240710,1호선,동대문,11717,11346,23063,11531.5
20240710,1호선,종로5가,25072,24785,49857,24928.5
20240710,1호선,종로3가,27212,25081,52293,26146.5
20240710,1호선,종각,44368,43790,88158,44079
20240710,1호선,시청,28287,28720,57007,28503.5
20240710,1호선,서울역,56696,53223,109919,54959.5
20240710,분당선,복정,5,0,5,2.5
20240710,2호선,성수,47433,51630,99063,49531.5
20240710,중앙선,회기,26312,25173,51485,25742.5
20240710,장항선,신창(순천향대),1424,1417,2841,1420.5
20240710,장항선,온양온천,4302,4289,8591,4295.5
20240710,장항선,배방,1243,1201,2444,1222
20240710,장항선,탕정,1777,1601,3378,1689
20240710,장항선,아산,4070,3646,7716,3858
20240710,장항선,쌍용(나사렛대),2381,2259,4640,2320
20240710,장항선,봉명,1481,1543,3024,1512
20240710,일산선,대화,14514,11381,25895,12947.5
20240710,일산선,주엽,10922,11131,22053,11026.5
20240710,일산선,정발산,8167,8080,16247,8123.5
20240710,일산선,마두,9118,9333,18451,9225.5
20240710,일산선,백석,10532,10582,21114,10557
20240710,일산선,대곡,3308,2488,5796,2898
20240710,일산선,화정,18760,19230,37990,18995
20240710,일산선,원당,12018,11374,23392,11696
20240710,일산선,삼송,20900,20074,40974,20487
20240710,일산선,지축,2,0,2,1
20240710,일산선,원흥,12387,11829,24216,12108
20240710,우이신설선,신설동,2672,2490,5162,2581
20240710,우이신설선,보문,1817,1738,3555,1777.5
20240710,우이신설선,성신여대입구(돈암),3823,4173,7996,3998
20240710,우이신설선,정릉,5098,4777,9875,4937.5
20240710,우이신설선,북한산보국문,6531,6214,12745,6372.5
20240710,우이신설선,솔샘,6604,6290,12894,6447
20240710,우이신설선,삼양사거리,2842,2890,5732,2866
20240710,우이신설선,삼양,2299,2441,4740,2370
20240710,우이신설선,화계,4041,3877,7918,3959
20240710,우이신설선,가오리,4800,4896,9696,4848
20240710,우이신설선,4.19민주묘지,3338,3057,6395,3197.5
20240710,우이신설선,솔밭공원,3011,2923,5934,2967
20240710,우이신설선,북한산우이,3061,2724,5785,2892.5
20240710,안산선,수리산,4529,3732,8261,4130.5
20240710,안산선,오이도,8333,8262,16595,8297.5
20240710,안산선,정왕,9575,9787,19362,9681
20240710,안산선,신길온천,2156,1961,4117,2058.5
20240710,안산선,안산,12710,11470,24180,12090
20240710,안산선,초지,5478,5448,10926,5463
20240710,안산선,고잔,9669,9153,18822,9411
20240710,안산선,중앙,19233,20128,39361,19680.5
20240710,안산선,한대앞,9788,9890,19678,9839
20240710,안산선,상록수,15786,16170,31956,15978
20240710,안산선,반월,4622,4494,9116,4558
20240710,안산선,대야미,5450,4804,10254,5127
20240710,안산선,산본,17598,18816,36414,18207
20240710,신림선,관악산(서울대),3252,3356,6608,3304
20240710,신림선,서울대벤처타운,10302,9534,19836,9918
20240710,신림선,서원,3879,3438,7317,3658.5
20240710,신림선,신림,2159,2845,5004,2502
20240710,신림선,당곡,5485,5385,10870,5435
20240710,신림선,보라매병원,8875,9211,18086,9043
20240710,신림선,보라매공원,2668,2862,5530,2765
20240710,신림선,보라매,4810,4274,9084,4542
20240710,신림선,서울지방병무청,3583,3951,7534,3767
20240710,신림선,대방,3264,2646,5910,2955
20240710,신림선,샛강,3443,3868,7311,3655.5
20240710,수인선,인천,1215,1873,3088,1544
20240710,수인선,신포,2100,2084,4184,2092
20240710,수인선,숭의,4654,4286,8940,4470
20240710,수인선,인하대,7124,6738,13862,6931
20240710,수인선,송도,2795,2619,5414,2707
20240710,수인선,연수,5164,5193,10357,5178.5
20240710,수인선,원인재,4799,4870,9669,4834.5
20240710,수인선,남동인더스파크,2671,2932,5603,2801.5
20240710,수인선,호구포,4419,4503,8922,4461
20240710,수인선,인천논현,6048,6347,12395,6197.5
20240710,수인선,소래포구,5083,4674,9757,4878.5
20240710,수인선,월곶,3527,3204,6731,3365.5
20240710,수인선,달월,122,74,196,98
20240710,수인선,사리,5434,4781,10215,5107.5
20240710,수인선,야목,460,408,868,434
20240710,수인선,어천,1467,1533,3000,1500
20240710,수인선,오목천,4303,3765,8068,4034
20240710,수인선,고색,6094,5582,11676,5838
20240710,서해선,부천종합운동장,2858,2405,5263,2631.5
20240710,서해선,원종,5031,5122,10153,5076.5
20240710,서해선,김포공항,3040,3869,6909,3454.5
20240710,분당선,매교,5929,5860,11789,5894.5
20240710,분당선,수원시청,14494,15513,30007,15003.5
20240710,분당선,매탄권선,5932,5728,11660,5830
20240710,분당선,망포,16809,16070,32879,16439.5
20240710,분당선,영통,9414,9487,18901,9450.5
20240710,분당선,청명,5120,5003,10123,5061.5
20240710,분당선,상갈,5853,5588,11441,5720.5
20240710,분당선,기흥,10921,10280,21201,10600.5
20240710,분당선,신갈,5319,5139,10458,5229
20240710,분당선,구성,7040,7025,14065,7032.5
20240710,분당선,죽전,13793,15351,29144,14572
20240710,분당선,보정,3038,2771,5809,2904.5
20240710,분당선,이매,6550,5988,12538,6269
20240710,분당선,오리,12838,10981,23819,11909.5
20240710,분당선,미금,17200,17802,35002,17501
20240710,분당선,정자,20759,21678,42437,21218.5
20240710,분당선,수내,16036,16354,32390,16195
20240710,분당선,서현,26759,27124,53883,26941.5
20240710,분당선,야탑,28004,29939,57943,28971.5
20240710,분당선,모란,20859,21155,42014,21007
20240710,분당선,태평,14120,13458,27578,13789
20240710,분당선,가천대,7760,8031,15791,7895.5
20240710,분당선,선정릉,8926,9243,18169,9084.5
20240710,분당선,강남구청,10977,12687,23664,11832
20240710,분당선,압구정로데오,19719,21820,41539,20769.5
20240710,분당선,서울숲,13619,13827,27446,13723
20240710,분당선,수원,8088,7413,15501,7750.5
20240710,분당선,수서,17761,18469,36230,18115
20240710,분당선,대모산입구,6718,6366,13084,6542
20240710,분당선,개포동,5225,5519,10744,5372
20240710,분당선,구룡,4100,4071,8171,4085.5
20240710,분당선,도곡,8701,8854,17555,8777.5
20240710,분당선,한티,16800,17885,34685,17342.5
20240710,분당선,선릉,15344,23396,38740,19370
20240710,과천선,범계,29458,29525,58983,29491.5
20240710,과천선,평촌,19646,19058,38704,19352
20240710,과천선,인덕원,28156,28891,57047,28523.5
20240710,과천선,정부과천청사,14160,14481,28641,14320.5
20240710,과천선,과천,7247,6751,13998,6999
20240710,과천선,대공원,3041,3005,6046,3023
20240710,과천선,경마공원,1710,1743,3453,1726.5
20240710,과천선,선바위,8275,7291,15566,7783
20240710,공항철도 1호선,영종,4308,4405,8713,4356.5
20240710,공항철도 1호선,인천공항2터미널,6764,5683,12447,6223.5
20240710,공항철도 1호선,인천공항1터미널,14741,13361,28102,14051
20240710,공항철도 1호선,공항화물청사,2274,2480,4754,2377
20240710,공항철도 1호선,운서,9799,10025,19824,9912
20240710,공항철도 1호선,청라국제도시,8246,7702,15948,7974
20240710,공항철도 1호선,검암,6912,7122,14034,7017
20240710,공항철도 1호선,계양,14564,13634,28198,14099
20240710,공항철도 1호선,김포공항,9970,6094,16064,8032
20240710,공항철도 1호선,마곡나루(서울식물원),13188,12415,25603,12801.5
20240710,공항철도 1호선,디지털미디어시티,16377,15526,31903,15951.5
20240710,공항철도 1호선,홍대입구,14163,14171,28334,14167
20240710,공항철도 1호선,공덕,3338,4239,7577,3788.5
20240710,공항철도 1호선,서울역,12220,11098,23318,11659
20240710,경춘선,춘천,1109,981,2090,1045
20240710,경춘선,남춘천,2319,2342,4661,2330.5
20240710,경춘선,김유정,319,346,665,332.5
20240710,경춘선,강촌,393,409,802,401
20240710,경춘선,백양리,77,62,139,69.5
20240710,경춘선,굴봉산,116,94,210,105
20240710,경춘선,가평,2189,2275,4464,2232
20240710,경춘선,상천,281,266,547,273.5
20240710,경춘선,청평,1924,1926,3850,1925
20240710,경춘선,대성리,660,802,1462,731
20240710,경춘선,마석,3854,3706,7560,3780
20240710,경춘선,천마산,1580,1460,3040,1520
20240710,경춘선,평내호평,6463,6160,12623,6311.5
20240710,경춘선,금곡,1478,1559,3037,1518.5
20240710,경춘선,사릉,2135,2134,4269,2134.5
20240710,경춘선,퇴계원,3806,3485,7291,3645.5
20240710,경춘선,별내,3671,3418,7089,3544.5
20240710,경춘선,갈매,3330,2847,6177,3088.5
20240710,경춘선,신내,3061,2843,5904,2952
20240710,경인선,도화,4571,4226,8797,4398.5
20240710,경인선,중동,10317,9514,19831,9915.5
20240710,경인선,온수(성공회대입구),7203,6818,14021,7010.5
20240710,경인선,도원,3784,3843,7627,3813.5
20240710,경인선,간석,6751,6347,13098,6549
20240710,경인선,부개,9653,9007,18660,9330
20240710,경인선,소사,7934,7532,15466,7733
20240710,경인선,구일,13374,14293,27667,13833.5
20240710,경인선,인천,4060,3188,7248,3624
20240710,경인선,동인천,15072,14248,29320,14660
20240710,경인선,제물포,11654,11248,22902,11451
20240710,경인선,주안,19734,17772,37506,18753
20240710,경인선,동암,16741,16814,33555,16777.5
20240710,경인선,백운,8261,7784,16045,8022.5
20240710,경인선,부평,30107,31881,61988,30994
20240710,경인선,송내,28793,28330,57123,28561.5
20240710,경인선,부천,33080,33049,66129,33064.5
20240710,경인선,역곡,27608,27459,55067,27533.5
20240710,경인선,오류동,12678,12006,24684,12342
20240710,경인선,개봉,23623,23257,46880,23440
20240710,경의선,계양,1,0,1,0.5
20240710,경의선,운천,8,6,14,7
20240710,경의선,임진강,14,7,21,10.5
20240710,경의선,문산,5568,5433,11001,5500.5
20240710,경의선,파주,1243,947,2190,1095
20240710,경의선,월롱,2245,1986,4231,2115.5
20240710,경의선,금촌,6925,6713,13638,6819
20240710,경의선,금릉,5873,5650,11523,5761.5
20240710,경의선,운정,8497,7894,16391,8195.5
20240710,경의선,야당,9398,9525,18923,9461.5
20240710,경의선,탄현,8447,8134,16581,8290.5
20240710,경의선,일산,11778,11605,23383,11691.5
20240710,경의선,풍산,6479,6060,12539,6269.5
20240710,경의선,백마,8064,7978,16042,8021
20240710,경의선,곡산,774,820,1594,797
20240710,경의선,능곡,5230,4880,10110,5055
20240710,경의선,행신,8484,8692,17176,8588
20240710,경의선,강매,3729,3112,6841,3420.5
20240710,경의선,한국항공대,2191,1999,4190,2095
20240710,경의선,수색,3809,3876,7685,3842.5
20240710,경의선,디지털미디어시티,3018,2780,5798,2899
20240710,경의선,가좌,6408,5906,12314,6157
20240710,경의선,홍대입구,2150,2499,4649,2324.5
20240710,경의선,서강대,2365,2308,4673,2336.5
20240710,경의선,공덕,4682,3837,8519,4259.5
20240710,경의선,효창공원앞,3585,4049,7634,3817
20240710,경의선,신촌,1111,1406,2517,1258.5
20240710,경의선,서울역,5113,6363,11476,5738
20240710,경원선,연천,1127,1150,2277,1138.5
20240710,경원선,전곡,1045,969,2014,1007
20240710,경원선,청산,164,150,314,157
20240710,경원선,소요산,1654,1631,3285,1642.5
20240710,경원선,동두천,1845,1792,3637,1818.5
20240710,경원선,보산,1543,1412,2955,1477.5
20240710,경원선,동두천중앙,3317,3269,6586,3293
20240710,경원선,지행,6783,6860,13643,6821.5
20240710,경원선,덕정,6144,5948,12092,6046
20240710,경원선,덕계,6468,5826,12294,6147
20240710,경원선,양주,7430,7205,14635,7317.5
20240710,경원선,녹양,4753,4502,9255,4627.5
20240710,경원선,가능,7060,6788,13848,6924
20240710,경원선,의정부,19453,19767,39220,19610
20240710,경원선,회룡,14017,13887,27904,13952
20240710,경원선,망월사,8118,8188,16306,8153
20240710,경원선,도봉산,7900,4888,12788,6394
20240710,경원선,도봉,6552,6408,12960,6480
20240710,경원선,방학,10763,9381,20144,10072
20240710,경원선,창동,3,0,3,1.5
20240710,경원선,녹천,5046,4273,9319,4659.5
20240710,경원선,월계,7222,6674,13896,6948
20240710,경원선,광운대,8580,7940,16520,8260
20240710,경원선,석계,7876,8990,16866,8433
20240710,경원선,신이문,9233,8660,17893,8946.5
20240710,경원선,외대앞,9623,9300,18923,9461.5
20240710,경원선,청량리(서울시립대입구),15228,16713,31941,15970.5
20240710,경원선,왕십리(성동구청),17393,17393,34786,17393
20240710,경원선,응봉,2093,1806,3899,1949.5
20240710,경원선,옥수,46,34,80,40
20240710,경원선,한남,4329,4184,8513,4256.5
20240710,경원선,서빙고,2352,2145,4497,2248.5
20240710,경원선,이촌(국립중앙박물관),4548,3385,7933,3966.5
20240710,경부선,광명,4034,3435,7469,3734.5
20240710,경부선,서동탄,1702,1410,3112,1556
20240710,경부선,당정,6612,6275,12887,6443.5
20240710,경부선,천안,5991,6189,12180,6090
20240710,경부선,두정,6677,6787,13464,6732
20240710,경부선,직산,1049,977,2026,1013
20240710,경부선,성환,4031,4052,8083,4041.5
20240710,경부선,평택,13575,13702,27277,13638.5
20240710,경부선,평택지제,4474,4398,8872,4436
20240710,경부선,서정리,8510,7859,16369,8184.5
20240710,경부선,송탄,4435,4357,8792,4396
20240710,경부선,진위,1860,1722,3582,1791
20240710,경부선,오산,10111,10152,20263,10131.5
20240710,경부선,오산대,3833,3585,7418,3709
20240710,경부선,세마,3577,3364,6941,3470.5
20240710,경부선,병점,15167,15134,30301,15150.5
20240710,경부선,세류,3617,3506,7123,3561.5
20240710,경부선,독산,19138,20184,39322,19661
20240710,경부선,수원,36144,37862,74006,37003
20240711,경부선,오산대,3926,3665,7591,3795.5
20240711,경부선,병점,15603,15455,31058,15529
20240711,경부선,세류,3595,3313,6908,3454
20240711,경부선,독산,19316,20085,39401,19700.5
20240711,경부선,수원,36342,38646,74988,37494
20240711,경부선,화서,12350,11996,24346,12173
20240711,경부선,성균관대,16204,15950,32154,16077
20240711,경부선,의왕,10123,9978,20101,10050.5
20240711,경부선,군포,7897,7883,15780,7890
20240711,경부선,금정,30779,30820,61599,30799.5
20240711,경부선,명학,9836,9738,19574,9787
20240711,경부선,안양,22977,22702,45679,22839.5
20240711,경부선,관악,7980,7520,15500,7750
20240711,경부선,석수,9550,8597,18147,9073.5
20240711,경부선,금천구청,12353,12457,24810,12405
20240711,경부선,가산디지털단지,20103,22711,42814,21407
20240711,경부선,구로,18886,19138,38024,19012
20240711,경부선,신길,9616,8173,17789,8894.5
20240711,경부선,신도림,4415,4675,9090,4545
20240711,경부선,영등포,43205,43835,87040,43520
20240711,경부선,대방,11578,12602,24180,12090
20240711,경부선,노량진,8518,8300,16818,8409
20240711,경부선,용산,40267,41100,81367,40683.5
20240711,경부선,남영,10731,11178,21909,10954.5
20240711,경부선,서울역,8788,3148,11936,5968
20240711,경강선,성남,1048,943,1991,995.5
20240711,경강선,여주,2789,2788,5577,2788.5
20240711,경강선,세종대왕릉,365,356,721,360.5
20240711,경강선,부발,2392,2246,4638,2319
20240711,경강선,이천,3024,3225,6249,3124.5
20240711,경강선,신둔도예촌,1599,1482,3081,1540.5
20240711,경강선,곤지암,2276,2213,4489,2244.5
20240711,경강선,초월,3792,3667,7459,3729.5
20240711,경강선,경기광주,8686,8223,16909,8454.5
20240711,경강선,삼동,2920,2607,5527,2763.5
20240711,경강선,이매,1128,1047,2175,1087.5
20240711,경강선,판교,6345,6355,12700,6350
20240711,9호선2~3단계,중앙보훈병원,14122,12349,26471,13235.5
20240711,9호선2~3단계,둔촌오륜,1597,1524,3121,1560.5
20240711,9호선2~3단계,올림픽공원(한국체대),5902,6257,12159,6079.5
20240711,9호선2~3단계,한성백제,3465,3091,6556,3278
20240711,9호선2~3단계,송파나루,6235,6799,13034,6517
20240711,9호선2~3단계,석촌,10803,9760,20563,10281.5
20240711,9호선2~3단계,석촌고분,8200,7865,16065,8032.5
20240711,9호선2~3단계,삼전,9015,8307,17322,8661
20240711,9호선2~3단계,종합운동장,5692,5774,11466,5733
20240711,9호선2~3단계,봉은사,23194,24323,47517,23758.5
20240711,9호선2~3단계,삼성중앙,9459,9916,19375,9687.5
20240711,9호선2~3단계,선정릉,11529,12554,24083,12041.5
20240711,9호선2~3단계,언주,13168,13482,26650,13325
20240711,9호선,신논현,34383,34512,68895,34447.5
20240711,9호선,사평,4574,4464,9038,4519
20240711,9호선,고속터미널,15764,20500,36264,18132
20240711,9호선,신반포,4702,4555,9257,4628.5
20240711,9호선,구반포,1431,1374,2805,1402.5
20240711,9호선,동작(현충원),1872,1614,3486,1743
20240711,9호선,흑석(중앙대입구),9703,10016,19719,9859.5
20240711,9호선,노들,5424,4530,9954,4977
20240711,9호선,노량진,27520,27197,54717,27358.5
20240711,9호선,샛강,7617,7679,15296,7648
20240711,9호선,여의도,34322,33908,68230,34115
20240711,9호선,국회의사당,19212,20413,39625,19812.5
20240711,9호선,당산,21842,21638,43480,21740
20240711,9호선,선유도,10213,9717,19930,9965
20240711,9호선,신목동,5170,4572,9742,4871
20240711,9호선,염창,20204,19151,39355,19677.5
20240711,9호선,등촌,13924,13221,27145,13572.5
20240711,9호선,증미,9236,9087,18323,9161.5
20240711,9호선,가양,25053,24080,49133,24566.5
20240711,9호선,양천향교,11425,11581,23006,11503
20240711,9호선,마곡나루(서울식물원),15736,15473,31209,15604.5
20240711,9호선,신방화,8062,7984,16046,8023
20240711,9호선,공항시장,3372,3622,6994,3497
20240711,9호선,김포공항,7524,10771,18295,9147.5
20240711,9호선,개화,3247,2081,5328,2664
20240711,8호선,남위례,8394,8359,16753,8376.5
20240711,8호선,모란,5181,4018,9199,4599.5
20240711,8호선,수진,5910,5621,11531,5765.5
20240711,8호선,신흥,5775,5813,11588,5794
20240711,8호선,단대오거리,13287,12829,26116,13058
20240711,8호선,남한산성입구(성남법원.검찰청),14422,12884,27306,13653
20240711,8호선,산성,7003,7143,14146,7073
20240711,8호선,복정,10331,8874,19205,9602.5
20240711,8호선,장지,18898,17350,36248,18124
20240711,8호선,문정,25422,26776,52198,26099
20240711,8호선,가락시장,8603,9562,18165,9082.5
20240711,8호선,송파,10701,10337,21038,10519
20240711,8호선,석촌,8972,10184,19156,9578
20240711,8호선,잠실(송파구청),17527,20345,37872,18936
20240711,8호선,몽촌토성(평화의문),7512,7670,15182,7591
20240711,8호선,강동구청,11835,12284,24119,12059.5
20240711,8호선,천호(풍납토성),16580,18578,35158,17579
20240711,8호선,암사,20992,18506,39498,19749
20240711,7호선,온수(성공회대입구),11119,9729,20848,10424
20240711,7호선,천왕,13147,12576,25723,12861.5
20240711,7호선,광명사거리,21823,21593,43416,21708
20240711,7호선,철산,23624,24069,47693,23846.5
20240711,7호선,가산디지털단지,51166,51638,102804,51402
20240711,7호선,남구로,16346,17133,33479,16739.5
20240711,7호선,대림(구로구청),9434,9409,18843,9421.5
20240711,7호선,신풍,12383,11484,23867,11933.5
20240711,7호선,보라매,7347,7608,14955,7477.5
20240711,7호선,신대방삼거리,16234,15559,31793,15896.5
20240711,7호선,장승배기,10041,9834,19875,9937.5
20240711,7호선,상도,12565,12060,24625,12312.5
20240711,7호선,숭실대입구(살피재),13782,13720,27502,13751
20240711,7호선,남성,12548,11781,24329,12164.5
20240711,7호선,이수,18246,17844,36090,18045
20240711,7호선,내방,16773,16882,33655,16827.5
20240711,7호선,고속터미널,17235,15280,32515,16257.5
20240711,7호선,반포,7097,6863,13960,6980
20240711,7호선,논현,21266,21563,42829,21414.5
20240711,7호선,학동,26971,28597,55568,27784
20240711,7호선,강남구청,18654,20594,39248,19624
20240711,7호선,청담,21465,23527,44992,22496
20240711,7호선,자양(뚝섬한강공원),10363,9979,20342,10171
20240711,7호선,건대입구,14449,14702,29151,14575.5
20240711,7호선,어린이대공원(세종대),15323,15005,30328,15164
20240711,7호선,군자(능동),16935,13410,30345,15172.5
20240711,7호선,중곡,12320,11569,23889,11944.5
20240711,7호선,용마산(용마폭포공원),6292,6162,12454,6227
20240711,7호선,사가정,17498,17521,35019,17509.5
20240711,7호선,면목,16313,15900,32213,16106.5
20240711,7호선,상봉,19069,18332,37401,18700.5
20240711,7호선,중화,11499,11141,22640,11320
20240711,7호선,먹골,11197,11069,22266,11133
20240711,7호선,태릉입구,9661,8924,18585,9292.5
20240711,7호선,공릉(서울과학기술대),13174,12833,26007,13003.5
20240711,7호선,하계,19886,18517,38403,19201.5
20240711,7호선,중계,16221,14881,31102,15551
20240711,7호선,노원,26597,27752,54349,27174.5
20240711,7호선,마들,14661,13814,28475,14237.5
20240711,7호선,수락산,13507,13415,26922,13461
20240711,7호선,도봉산,9584,11214,20798,10399
20240711,7호선,장암,3090,1321,4411,2205.5
20240711,6호선,봉화산(서울의료원),9944,9398,19342,9671
20240711,6호선,화랑대(서울여대입구),13128,10118,23246,11623
20240711,6호선,태릉입구,6177,6913,13090,6545
20240711,6호선,석계,13842,14049,27891,13945.5
20240711,6호선,돌곶이,11228,10340,21568,10784
20240711,6호선,상월곡(한국과학기술연구원),7604,6952,14556,7278
20240711,6호선,월곡(동덕여대),12894,12714,25608,12804
20240711,6호선,고려대(종암),9425,8899,18324,9162
20240711,6호선,안암(고대병원앞),12850,12696,25546,12773
20240711,6호선,보문,8996,8183,17179,8589.5
20240711,6호선,창신,4020,3189,7209,3604.5
20240711,6호선,동묘앞,8604,8958,17562,8781
20240711,6호선,신당,9677,10015,19692,9846
20240711,6호선,청구,4302,4371,8673,4336.5
20240711,6호선,약수,4021,4022,8043,4021.5
20240711,6호선,버티고개,2383,2425,4808,2404
20240711,6호선,한강진,10970,12675,23645,11822.5
20240711,6호선,이태원,11036,11969,23005,11502.5
20240711,6호선,녹사평(용산구청),5683,5696,11379,5689.5
20240711,6호선,삼각지,8150,7234,15384,7692
20240711,6호선,효창공원앞,8017,7229,15246,7623
20240711,6호선,공덕,21927,21468,43395,21697.5
20240711,6호선,대흥(서강대앞),10103,10407,20510,10255
20240711,6호선,광흥창(서강),10692,10213,20905,10452.5
20240711,6호선,상수,10224,11672,21896,10948
20240711,6호선,합정,14737,14268,29005,14502.5
20240711,6호선,망원,16248,17401,33649,16824.5
20240711,6호선,마포구청,16294,14545,30839,15419.5
20240711,6호선,월드컵경기장(성산),4714,4921,9635,4817.5
20240711,6호선,디지털미디어시티,16476,18320,34796,17398
20240711,6호선,증산(명지대앞),10626,10662,21288,10644
20240711,6호선,새절(신사),14183,12908,27091,13545.5
20240711,6호선,구산,9361,7024,16385,8192.5
20240711,6호선,연신내,3,0,3,1.5
20240711,6호선,독바위,3060,3202,6262,3131
20240711,6호선,불광,5296,5110,10406,5203
20240711,6호선,역촌,4231,4807,9038,4519
20240711,6호선,응암,19341,19006,38347,19173.5
20240711,5호선,하남검단산,7210,6782,13992,6996
20240711,5호선,하남시청(덕풍·신장),9212,8643,17855,8927.5
20240711,5호선,하남풍산,4994,4967,9961,4980.5
20240711,5호선,미사,19453,19608,39061,19530.5
20240711,5호선,강일,6799,6251,13050,6525
20240711,5호선,마천,8296,7547,15843,7921.5
20240711,5호선,거여,11365,11151,22516,11258
20240711,5호선,개롱,7492,7623,15115,7557.5
20240711,5호선,오금,4263,4325,8588,4294
20240711,5호선,방이,7909,8503,16412,8206
20240711,5호선,올림픽공원(한국체대),6435,5196,11631,5815.5
20240711,5호선,둔촌동,9762,9750,19512,9756
20240711,5호선,상일동,16614,15479,32093,16046.5
20240711,5호선,고덕,12197,11522,23719,11859.5
20240711,5호선,명일,9732,10146,19878,9939
20240711,5호선,굽은다리(강동구민회관앞),10774,10551,21325,10662.5
20240711,5호선,길동,9080,9202,18282,9141
20240711,5호선,강동,20242,19719,39961,19980.5
20240711,5호선,천호(풍납토성),21074,20743,41817,20908.5
20240711,5호선,광나루(장신대),15743,14780,30523,15261.5
20240711,5호선,아차산(어린이대공원후문),16205,15461,31666,15833
20240711,5호선,군자(능동),12261,13667,25928,12964
20240711,5호선,장한평,21976,21610,43586,21793
20240711,5호선,답십리,18030,16214,34244,17122
20240711,5호선,마장,6478,6055,12533,6266.5
20240711,5호선,왕십리(성동구청),5083,5843,10926,5463
20240711,5호선,행당,9078,8018,17096,8548
20240711,5호선,신금호,7475,7934,15409,7704.5
20240711,5호선,청구,4283,4145,8428,4214
20240711,5호선,동대문역사문화공원(DDP),3602,4148,7750,3875
20240711,5호선,을지로4가,7394,7212,14606,7303
20240711,5호선,종로3가,16169,16346,32515,16257.5
20240711,5호선,광화문(세종문화회관),36762,39156,75918,37959
20240711,5호선,서대문,23120,23333,46453,23226.5
20240711,5호선,충정로(경기대입구),5485,5429,10914,5457
20240711,5호선,애오개,7732,7659,15391,7695.5
20240711,5호선,공덕,16918,17744,34662,17331
20240711,5호선,마포,16590,16837,33427,16713.5
20240711,5호선,여의나루,13936,15447,29383,14691.5
20240711,5호선,여의도,33055,35246,68301,34150.5
20240711,5호선,신길,5409,5527,10936,5468
20240711,5호선,영등포시장,12398,12848,25246,12623
20240711,5호선,영등포구청,5448,5381,10829,5414.5
20240711,5호선,양평,8620,8438,17058,8529
20240711,5호선,오목교(목동운동장앞),22912,24484,47396,23698
20240711,5호선,목동,18656,19997,38653,19326.5
20240711,5호선,신정(은행정),14938,12370,27308,13654
20240711,5호선,까치산,30340,29108,59448,29724
20240711,5호선,화곡,31355,29190,60545,30272.5
20240711,5호선,우장산,16376,16016,32392,16196
20240711,5호선,발산,25510,26274,51784,25892
20240711,5호선,마곡,14006,14020,28026,14013
20240711,5호선,송정,6994,6563,13557,6778.5
20240711,5호선,김포공항,11804,8292,20096,10048
20240711,5호선,개화산,6718,6442,13160,6580
20240711,5호선,방화,7784,7478,15262,7631
20240711,4호선,남태령,1611,1452,3063,1531.5
20240711,4호선,사당,28184,24818,53002,26501
20240711,4호선,총신대입구(이수),21124,22648,43772,21886
20240711,4호선,동작(현충원),1649,1733,3382,1691
20240711,4호선,이촌(국립중앙박물관),9785,10665,20450,10225
20240711,4호선,신용산,21758,23622,45380,22690
20240711,4호선,삼각지,6726,7565,14291,7145.5
20240711,4호선,숙대입구(갈월),15842,15466,31308,15654
20240711,4호선,서울역,14528,23212,37740,18870
20240711,4호선,회현(남대문시장),30018,31302,61320,30660
20240711,4호선,명동,32978,35391,68369,34184.5
20240711,4호선,충무로,33632,34657,68289,34144.5
20240711,4호선,동대문역사문화공원(DDP),20220,18074,38294,19147
20240711,4호선,동대문,22858,23321,46179,23089.5
20240711,4호선,혜화,37263,37626,74889,37444.5
20240711,4호선,한성대입구(삼선교),14669,13958,28627,14313.5
20240711,4호선,성신여대입구(돈암),22547,21883,44430,22215
20240711,4호선,길음,23195,22522,45717,22858.5
20240711,4호선,미아사거리,29026,28539,57565,28782.5
20240711,4호선,미아(서울사이버대학),16854,16344,33198,16599
20240711,4호선,수유(강북구청),36092,36407,72499,36249.5
20240711,4호선,쌍문,31849,29586,61435,30717.5
20240711,4호선,창동,29021,30522,59543,29771.5
20240711,4호선,노원,30986,34829,65815,32907.5
20240711,4호선,상계,21223,19603,40826,20413
20240711,4호선,당고개,10679,8821,19500,9750
20240711,3호선,경찰병원,8761,8743,17504,8752
20240711,3호선,가락시장,10265,9934,20199,10099.5
20240711,3호선,수서,19902,19833,39735,19867.5
20240711,3호선,일원,12855,12438,25293,12646.5
20240711,3호선,대청,12662,11876,24538,12269
20240711,3호선,학여울,2268,2254,4522,2261
20240711,3호선,대치,13337,13232,26569,13284.5
20240711,3호선,도곡,6638,6705,13343,6671.5
20240711,3호선,매봉,14556,14115,28671,14335.5
20240711,3호선,양재(서초구청),42665,46165,88830,44415
20240711,3호선,남부터미널(예술의전당),32737,33732,66469,33234.5
20240711,3호선,교대(법원.검찰청),20106,11924,32030,16015
20240711,3호선,고속터미널,47586,44666,92252,46126
20240711,3호선,잠원,5753,5402,11155,5577.5
20240711,3호선,신사,30704,32260,62964,31482
20240711,3호선,압구정,35303,37490,72793,36396.5
20240711,3호선,옥수,9900,10041,19941,9970.5
20240711,3호선,금호,9063,8455,17518,8759
20240711,3호선,약수,14531,13953,28484,14242
20240711,3호선,동대입구,9469,10464,19933,9966.5
20240711,3호선,충무로,5,0,5,2.5
20240711,3호선,을지로3가,13202,13487,26689,13344.5
20240711,3호선,종로3가,12519,14035,26554,13277
20240711,3호선,안국,29217,30265,59482,29741
20240711,3호선,경복궁(정부서울청사),26055,26424,52479,26239.5
20240711,3호선,독립문,8354,8521,16875,8437.5
20240711,3호선,무악재,4969,4776,9745,4872.5
20240711,3호선,홍제,19579,18514,38093,19046.5
20240711,3호선,녹번,17050,15604,32654,16327
20240711,3호선,불광,18144,19465,37609,18804.5
20240711,3호선,연신내,37505,35564,73069,36534.5
20240711,3호선,구파발,24306,23119,47425,23712.5
20240711,3호선,지축,8514,8471,16985,8492.5
20240711,2호선,용두(동대문구청),2800,2903,5703,2851.5
20240711,2호선,신정네거리,11037,11525,22562,11281
20240711,2호선,양천구청,7480,7930,15410,7705
20240711,2호선,도림천,1540,1643,3183,1591.5
20240711,2호선,신설동,3664,3530,7194,3597
20240711,2호선,신답,1855,2017,3872,1936
20240711,2호선,용답,3225,3178,6403,3201.5
20240711,2호선,충정로(경기대입구),11800,12428,24228,12114
20240711,2호선,아현,12225,11097,23322,11661
20240711,2호선,이대,16958,18555,35513,17756.5
20240711,2호선,신촌,41167,41686,82853,41426.5
20240711,2호선,홍대입구,72860,78362,151222,75611
20240711,2호선,합정,34912,37449,72361,36180.5
20240711,2호선,당산,20106,23398,43504,21752
20240711,2호선,영등포구청,25572,26120,51692,25846
20240711,2호선,문래,26166,26982,53148,26574
20240711,2호선,신도림,56154,54065,110219,55109.5
20240711,2호선,대림(구로구청),26263,26724,52987,26493.5
20240711,2호선,구로디지털단지,64270,63724,127994,63997
20240711,2호선,신대방,27256,26360,53616,26808
20240711,2호선,신림,59502,57334,116836,58418
20240711,2호선,봉천,27102,25268,52370,26185
20240711,2호선,서울대입구(관악구청),50054,48759,98813,49406.5
20240711,2호선,낙성대(강감찬),30482,29362,59844,29922
20240711,2호선,사당,44558,48279,92837,46418.5
20240711,2호선,방배,17524,18233,35757,17878.5
20240711,2호선,서초,24770,24383,49153,24576.5
20240711,2호선,교대(법원.검찰청),36882,43914,80796,40398
20240711,2호선,강남,93496,91391,184887,92443.5
20240711,2호선,역삼,60912,70265,131177,65588.5
20240711,2호선,선릉,67792,60204,127996,63998
20240711,2호선,삼성(무역센터),62774,64790,127564,63782
20240711,2호선,종합운동장,21290,24017,45307,22653.5
20240711,2호선,잠실새내,27064,26112,53176,26588
20240711,2호선,잠실(송파구청),86743,86087,172830,86415
20240711,2호선,잠실나루,17778,17206,34984,17492
20240711,2호선,강변(동서울터미널),31680,30199,61879,30939.5
20240711,2호선,구의(광진구청),27876,26863,54739,27369.5
20240711,2호선,건대입구,37081,38799,75880,37940
20240711,2호선,성수,48055,52716,100771,50385.5
20240711,2호선,뚝섬,27530,29286,56816,28408
20240711,2호선,한양대,10781,11813,22594,11297
20240711,2호선,왕십리(성동구청),16997,15160,32157,16078.5
20240711,2호선,상왕십리,16151,15867,32018,16009
20240711,2호선,신당,15786,16645,32431,16215.5
20240711,2호선,동대문역사문화공원(DDP),15615,17878,33493,16746.5
20240711,2호선,을지로4가,15992,15855,31847,15923.5
20240711,2호선,을지로3가,28536,28445,56981,28490.5
20240711,2호선,을지로입구,54553,56335,110888,55444
20240711,2호선,시청,30811,29827,60638,30319
20240711,1호선,동묘앞,9520,9815,19335,9667.5
20240711,1호선,청량리(서울시립대입구),23892,22987,46879,23439.5
20240711,1호선,제기동,18232,18579,36811,18405.5
20240711,1호선,신설동,15467,15119,30586,15293
20240711,1호선,동대문,12004,11699,23703,11851.5
20240711,1호선,종로5가,25873,25535,51408,25704
20240711,1호선,종로3가,28065,25415,53480,26740
20240711,1호선,종각,44634,44631,89265,44632.5
20240711,1호선,시청,28970,29328,58298,29149
20240711,1호선,서울역,58826,55032,113858,56929
20240711,과천선,대공원,3385,3552,6937,3468.5
20240711,중앙선,양평,3236,3435,6671,3335.5
20240711,중앙선,오빈,373,360,733,366.5
20240711,중앙선,아신,580,542,1122,561
20240711,중앙선,국수,769,776,1545,772.5
20240711,중앙선,신원,216,196,412,206
20240711,중앙선,양수,2675,2673,5348,2674
20240711,중앙선,운길산,756,735,1491,745.5
20240711,중앙선,팔당,896,920,1816,908
20240711,중앙선,도심,2665,2062,4727,2363.5
20240711,중앙선,덕소,5807,5807,11614,5807
20240711,중앙선,양정,652,527,1179,589.5
20240711,중앙선,도농,12230,11156,23386,11693
20240711,중앙선,지평,59,72,131,65.5
20240711,중앙선,용문,1947,1926,3873,1936.5
20240711,중앙선,원덕,403,385,788,394
20240711,3호선,오금,7579,6748,14327,7163.5
20240711,중앙선,구리,14327,14382,28709,14354.5
20240711,중앙선,양원,3535,3488,7023,3511.5
20240711,중앙선,망우,8320,7976,16296,8148
20240711,중앙선,상봉,6419,6312,12731,6365.5
20240711,중앙선,중랑,6108,5664,11772,5886
20240711,중앙선,회기,26913,25348,52261,26130.5
20240711,장항선,신창(순천향대),1245,1259,2504,1252
20240711,장항선,온양온천,4248,4362,8610,4305
20240711,장항선,배방,1301,1208,2509,1254.5
20240711,장항선,탕정,1762,1597,3359,1679.5
20240711,장항선,아산,3600,3316,6916,3458
20240711,장항선,쌍용(나사렛대),2541,2343,4884,2442
20240711,장항선,봉명,1588,1563,3151,1575.5
20240711,일산선,대화,14594,11569,26163,13081.5
20240711,일산선,주엽,10907,11010,21917,10958.5
20240711,일산선,정발산,7899,7988,15887,7943.5
20240711,일산선,마두,8892,9023,17915,8957.5
20240711,일산선,백석,11137,11288,22425,11212.5
20240711,일산선,대곡,3260,2453,5713,2856.5
20240711,일산선,화정,18620,19172,37792,18896
20240711,일산선,원당,12152,11460,23612,11806
20240711,일산선,삼송,20783,20136,40919,20459.5
20240711,일산선,지축,2,0,2,1
20240711,일산선,원흥,12545,11870,24415,12207.5
20240711,우이신설선,신설동,2660,2523,5183,2591.5
20240711,우이신설선,보문,1828,1865,3693,1846.5
20240711,우이신설선,성신여대입구(돈암),3777,4105,7882,3941
20240711,우이신설선,정릉,5206,4818,10024,5012
20240711,우이신설선,북한산보국문,6777,6458,13235,6617.5
20240711,우이신설선,솔샘,6657,6369,13026,6513
20240711,우이신설선,삼양사거리,2787,2865,5652,2826
20240711,우이신설선,삼양,2257,2300,4557,2278.5
20240711,우이신설선,화계,3957,3852,7809,3904.5
20240711,우이신설선,가오리,4811,4901,9712,4856
20240711,우이신설선,4.19민주묘지,3320,3067,6387,3193.5
20240711,우이신설선,솔밭공원,2948,2828,5776,2888
20240711,우이신설선,북한산우이,3195,2857,6052,3026
20240711,안산선,수리산,4552,3769,8321,4160.5
20240711,안산선,오이도,8411,8122,16533,8266.5
20240711,안산선,정왕,9634,9840,19474,9737
20240711,안산선,신길온천,2172,2023,4195,2097.5
20240711,안산선,안산,12679,11557,24236,12118
20240711,안산선,초지,5388,5496,10884,5442
20240711,안산선,고잔,9827,9309,19136,9568
20240711,안산선,중앙,19726,20268,39994,19997
20240711,안산선,한대앞,9713,9961,19674,9837
20240711,안산선,상록수,16037,16186,32223,16111.5
20240711,안산선,반월,4733,4625,9358,4679
20240711,안산선,대야미,5410,4843,10253,5126.5
20240711,안산선,산본,17830,18822,36652,18326
20240711,신림선,관악산(서울대),3363,3315,6678,3339
20240711,신림선,서울대벤처타운,10568,9689,20257,10128.5
20240711,신림선,서원,3885,3367,7252,3626
20240711,신림선,신림,2107,2714,4821,2410.5
20240711,신림선,당곡,5428,5282,10710,5355
20240711,신림선,보라매병원,8816,9587,18403,9201.5
20240711,신림선,보라매공원,2646,2809,5455,2727.5
20240711,신림선,보라매,4778,4336,9114,4557
20240711,신림선,서울지방병무청,3647,3856,7503,3751.5
20240711,신림선,대방,3149,2583,5732,2866
20240711,신림선,샛강,3437,3931,7368,3684
20240711,수인선,인천,1151,1818,2969,1484.5
20240711,수인선,신포,2120,2179,4299,2149.5
20240711,수인선,숭의,4613,4304,8917,4458.5
20240711,수인선,인하대,7250,6833,14083,7041.5
20240711,수인선,송도,2836,2528,5364,2682
20240711,수인선,연수,5269,5255,10524,5262
20240711,수인선,원인재,4996,5157,10153,5076.5
20240711,수인선,남동인더스파크,2650,2937,5587,2793.5
20240711,수인선,호구포,4293,4491,8784,4392
20240711,수인선,인천논현,6169,6411,12580,6290
20240711,수인선,소래포구,5419,4928,10347,5173.5
20240711,수인선,월곶,3517,3312,6829,3414.5
20240711,수인선,달월,123,74,197,98.5
20240711,수인선,사리,5512,4781,10293,5146.5
20240711,수인선,야목,453,388,841,420.5
20240711,수인선,어천,1586,1496,3082,1541
20240711,수인선,오목천,4348,3809,8157,4078.5
20240711,수인선,고색,6111,5616,11727,5863.5
20240711,서해선,부천종합운동장,2842,2397,5239,2619.5
20240711,서해선,원종,5138,5100,10238,5119
20240711,서해선,김포공항,3151,3990,7141,3570.5
20240711,분당선,매교,5992,5925,11917,5958.5
20240711,분당선,수원시청,15091,16255,31346,15673
20240711,분당선,매탄권선,6120,6020,12140,6070
20240711,분당선,망포,17151,16312,33463,16731.5
20240711,분당선,영통,9472,9519,18991,9495.5
20240711,분당선,청명,5028,4954,9982,4991
20240711,분당선,상갈,5882,5708,11590,5795
20240711,분당선,기흥,11239,10224,21463,10731.5
20240711,분당선,신갈,5298,5028,10326,5163
20240711,분당선,구성,7070,6971,14041,7020.5
20240711,분당선,죽전,13880,15226,29106,14553
20240711,분당선,보정,3043,2748,5791,2895.5
20240711,분당선,이매,6387,5972,12359,6179.5
20240711,분당선,오리,12851,11145,23996,11998
20240711,분당선,미금,16822,17397,34219,17109.5
20240711,분당선,정자,20841,21894,42735,21367.5
20240711,분당선,수내,15828,16036,31864,15932
20240711,분당선,서현,26695,27379,54074,27037
20240711,분당선,야탑,28334,29960,58294,29147
20240711,분당선,모란,21306,21402,42708,21354
20240711,분당선,태평,14250,13415,27665,13832.5
20240711,분당선,가천대,7892,8088,15980,7990
20240711,분당선,선정릉,8894,9389,18283,9141.5
20240711,분당선,강남구청,10990,12937,23927,11963.5
20240711,분당선,압구정로데오,20711,23069,43780,21890
20240711,분당선,서울숲,13755,14019,27774,13887
20240711,분당선,수원,8563,7782,16345,8172.5
20240711,분당선,복정,3,0,3,1.5
20240711,분당선,수서,17983,19086,37069,18534.5
20240711,분당선,대모산입구,6785,6304,13089,6544.5
20240711,분당선,개포동,5059,5169,10228,5114
20240711,분당선,구룡,4162,4075,8237,4118.5
20240711,분당선,도곡,8710,8670,17380,8690
20240711,분당선,한티,16946,18402,35348,17674
20240711,분당선,선릉,15546,23478,39024,19512
20240711,과천선,범계,29978,29813,59791,29895.5
20240711,과천선,평촌,20147,19673,39820,19910
20240711,과천선,인덕원,28249,28879,57128,28564
20240711,과천선,정부과천청사,14010,14462,28472,14236
20240711,과천선,과천,7291,6666,13957,6978.5
20240711,과천선,경마공원,1509,1495,3004,1502
20240711,과천선,선바위,8310,7367,15677,7838.5
20240711,공항철도 1호선,영종,4494,4617,9111,4555.5
20240711,공항철도 1호선,인천공항2터미널,7381,5745,13126,6563
20240711,공항철도 1호선,인천공항1터미널,15996,13469,29465,14732.5
20240711,공항철도 1호선,공항화물청사,2322,2504,4826,2413
20240711,공항철도 1호선,운서,10071,10366,20437,10218.5
20240711,공항철도 1호선,청라국제도시,8364,7894,16258,8129
20240711,공항철도 1호선,검암,7086,7413,14499,7249.5
20240711,공항철도 1호선,계양,14680,13762,28442,14221
20240711,공항철도 1호선,김포공항,10683,6051,16734,8367
20240711,공항철도 1호선,마곡나루(서울식물원),13152,12383,25535,12767.5
20240711,공항철도 1호선,디지털미디어시티,16904,15919,32823,16411.5
20240711,공항철도 1호선,홍대입구,14942,14745,29687,14843.5
20240711,공항철도 1호선,공덕,3277,4297,7574,3787
20240711,공항철도 1호선,서울역,12964,11583,24547,12273.5
20240711,경춘선,춘천,1234,1143,2377,1188.5
20240711,경춘선,남춘천,2451,2480,4931,2465.5
20240711,경춘선,김유정,408,401,809,404.5
20240711,경춘선,강촌,427,396,823,411.5
20240711,경춘선,백양리,102,81,183,91.5
20240711,경춘선,굴봉산,127,114,241,120.5
20240711,경춘선,가평,2310,2206,4516,2258
20240711,경춘선,상천,272,262,534,267
20240711,경춘선,청평,1974,1915,3889,1944.5
20240711,경춘선,대성리,891,804,1695,847.5
20240711,경춘선,마석,3945,3883,7828,3914
20240711,경춘선,천마산,1626,1555,3181,1590.5
20240711,경춘선,평내호평,7015,6774,13789,6894.5
20240711,경춘선,금곡,1639,1645,3284,1642
20240711,경춘선,사릉,2143,2133,4276,2138
20240711,경춘선,퇴계원,3912,3550,7462,3731
20240711,경춘선,별내,3749,3562,7311,3655.5
20240711,경춘선,갈매,3245,2869,6114,3057
20240711,경춘선,신내,3045,2832,5877,2938.5
20240711,경인선,도화,4628,4359,8987,4493.5
20240711,경인선,중동,10128,9470,19598,9799
20240711,경인선,온수(성공회대입구),7090,6698,13788,6894
20240711,경인선,도원,3785,3816,7601,3800.5
20240711,경인선,간석,6555,6272,12827,6413.5
20240711,경인선,부개,9627,9090,18717,9358.5
20240711,경인선,소사,8070,7708,15778,7889
20240711,경인선,구일,13319,14598,27917,13958.5
20240711,경인선,인천,4195,3344,7539,3769.5
20240711,경인선,동인천,15456,14964,30420,15210
20240711,경인선,제물포,11712,11238,22950,11475
20240711,경인선,주안,19787,17791,37578,18789
20240711,경인선,동암,16874,16839,33713,16856.5
20240711,경인선,백운,8257,7820,16077,8038.5
20240711,경인선,부평,30472,31924,62396,31198
20240711,경인선,송내,29237,28641,57878,28939
20240711,경인선,부천,33244,33090,66334,33167
20240711,경인선,역곡,27961,27904,55865,27932.5
20240711,경인선,오류동,12767,11877,24644,12322
20240711,경인선,개봉,23639,23110,46749,23374.5
20240711,경의선,운천,6,4,10,5
20240711,경의선,임진강,24,10,34,17
20240711,경의선,문산,5533,5506,11039,5519.5
20240711,경의선,파주,1300,962,2262,1131
20240711,경의선,월롱,2394,1958,4352,2176
20240711,경의선,금촌,7299,7224,14523,7261.5
20240711,경의선,금릉,6098,5708,11806,5903
20240711,경의선,운정,8720,8200,16920,8460
20240711,경의선,야당,9562,9686,19248,9624
20240711,경의선,탄현,8590,8272,16862,8431
20240711,경의선,일산,11922,11753,23675,11837.5
20240711,경의선,풍산,6962,6514,13476,6738
20240711,경의선,백마,8231,7993,16224,8112
20240711,경의선,곡산,808,831,1639,819.5
20240711,경의선,능곡,5333,4940,10273,5136.5
20240711,경의선,행신,8823,8698,17521,8760.5
20240711,경의선,강매,3736,3095,6831,3415.5
20240711,경의선,한국항공대,2264,2086,4350,2175
20240711,경의선,수색,4199,4247,8446,4223
20240711,경의선,디지털미디어시티,2994,2890,5884,2942
20240711,경의선,가좌,6463,6085,12548,6274
20240711,경의선,홍대입구,2222,2679,4901,2450.5
20240711,경의선,서강대,2418,2245,4663,2331.5
20240711,경의선,공덕,4744,4009,8753,4376.5
20240711,경의선,효창공원앞,3509,4016,7525,3762.5
20240711,경의선,신촌,1123,1492,2615,1307.5
20240711,경의선,서울역,5214,6638,11852,5926
20240711,경원선,연천,1228,1290,2518,1259
20240711,경원선,전곡,1128,1031,2159,1079.5
20240711,경원선,청산,185,127,312,156
20240711,경원선,소요산,1853,1830,3683,1841.5
20240711,경원선,동두천,1896,1787,3683,1841.5
20240711,경원선,보산,1541,1501,3042,1521
20240711,경원선,동두천중앙,3250,3232,6482,3241
20240711,경원선,지행,6772,6909,13681,6840.5
20240711,경원선,덕정,6233,5890,12123,6061.5
20240711,경원선,덕계,6490,5873,12363,6181.5
20240711,경원선,양주,7686,7445,15131,7565.5
20240711,경원선,녹양,4761,4521,9282,4641
20240711,경원선,가능,7019,6922,13941,6970.5
20240711,경원선,의정부,19581,19788,39369,19684.5
20240711,경원선,회룡,14073,13765,27838,13919
20240711,경원선,망월사,7914,7997,15911,7955.5
20240711,경원선,도봉산,8190,5207,13397,6698.5
20240711,경원선,도봉,6728,6528,13256,6628
20240711,경원선,방학,10847,10486,21333,10666.5
20240711,경원선,창동,1,0,1,0.5
20240711,경원선,녹천,5145,4272,9417,4708.5
20240711,경원선,월계,7298,6725,14023,7011.5
20240711,경원선,광운대,8659,8166,16825,8412.5
20240711,경원선,석계,7977,9074,17051,8525.5
20240711,경원선,신이문,9241,8599,17840,8920
20240711,경원선,외대앞,9654,9268,18922,9461
20240711,경원선,청량리(서울시립대입구),16320,17725,34045,17022.5
20240711,경원선,왕십리(성동구청),17846,17732,35578,17789
20240711,경원선,응봉,2133,1798,3931,1965.5
20240711,경원선,옥수,60,45,105,52.5
20240711,경원선,한남,4368,4169,8537,4268.5
20240711,경원선,서빙고,2376,2260,4636,2318
20240711,경원선,이촌(국립중앙박물관),4540,3538,8078,4039
20240711,경부선,광명,3891,3463,7354,3677
20240711,경부선,서동탄,1683,1401,3084,1542
20240711,경부선,당정,6666,6318,12984,6492
20240711,경부선,천안,5907,6000,11907,5953.5
20240711,경부선,두정,6862,6924,13786,6893
20240711,경부선,직산,1083,1017,2100,1050
20240711,경부선,성환,4147,4085,8232,4116
20240711,경부선,평택,12346,12273,24619,12309.5
20240711,경부선,평택지제,4180,4189,8369,4184.5
20240711,경부선,서정리,8514,7888,16402,8201
20240711,경부선,송탄,4558,4451,9009,4504.5
20240711,경부선,진위,1772,1674,3446,1723
20240711,경부선,오산,10242,10163,20405,10202.5
20240711,경부선,세마,3652,3448,7100,3550
20240712,6호선,돌곶이,11302,10150,21452,10726
20240712,6호선,태릉입구,6237,6899,13136,6568
20240712,6호선,화랑대(서울여대입구),13210,10130,23340,11670
20240712,6호선,봉화산(서울의료원),9979,9296,19275,9637.5
20240712,7호선,장암,2974,1345,4319,2159.5
20240712,7호선,도봉산,9713,11102,20815,10407.5
20240712,7호선,수락산,13866,13561,27427,13713.5
20240712,7호선,마들,14873,13826,28699,14349.5
20240712,7호선,노원,27612,29391,57003,28501.5
20240712,7호선,중계,16332,14647,30979,15489.5
20240712,7호선,하계,19661,17983,37644,18822
20240712,7호선,공릉(서울과학기술대),13734,13352,27086,13543
20240712,7호선,태릉입구,9860,9255,19115,9557.5
20240712,7호선,먹골,11605,11327,22932,11466
20240712,7호선,중화,11797,11488,23285,11642.5
20240712,7호선,상봉,19513,19274,38787,19393.5
20240712,7호선,면목,16546,15694,32240,16120
20240712,7호선,사가정,18073,17978,36051,18025.5
20240712,7호선,용마산(용마폭포공원),6359,6099,12458,6229
20240712,7호선,중곡,12784,11633,24417,12208.5
20240712,7호선,군자(능동),17328,13492,30820,15410
20240712,7호선,어린이대공원(세종대),15729,14926,30655,15327.5
20240712,7호선,건대입구,14797,14997,29794,14897
20240712,7호선,자양(뚝섬한강공원),10711,10336,21047,10523.5
20240712,7호선,청담,21313,23413,44726,22363
20240712,7호선,강남구청,18707,20956,39663,19831.5
20240712,7호선,학동,27030,28605,55635,27817.5
20240712,7호선,논현,21502,22547,44049,22024.5
20240712,7호선,반포,7507,7140,14647,7323.5
20240712,7호선,고속터미널,20407,16970,37377,18688.5
20240712,7호선,내방,16660,16846,33506,16753
20240712,7호선,이수,19295,18554,37849,18924.5
20240712,7호선,남성,12902,11990,24892,12446
20240712,7호선,숭실대입구(살피재),14304,13821,28125,14062.5
20240712,7호선,상도,12940,12284,25224,12612
20240712,7호선,장승배기,10513,10016,20529,10264.5
20240712,7호선,신대방삼거리,16733,15653,32386,16193
20240712,7호선,보라매,7513,7683,15196,7598
20240712,7호선,신풍,12708,11614,24322,12161
20240712,7호선,대림(구로구청),9621,9972,19593,9796.5
20240712,7호선,남구로,16211,17057,33268,16634
20240712,7호선,가산디지털단지,49627,49460,99087,49543.5
20240712,7호선,철산,24633,25031,49664,24832
20240712,7호선,광명사거리,22740,22287,45027,22513.5
20240712,7호선,천왕,13550,12838,26388,13194
20240712,7호선,온수(성공회대입구),10920,9714,20634,10317
20240712,8호선,암사,21318,18614,39932,19966
20240712,8호선,천호(풍납토성),17325,19975,37300,18650
20240712,8호선,강동구청,11892,12122,24014,12007
20240712,8호선,몽촌토성(평화의문),7369,7714,15083,7541.5
20240712,8호선,잠실(송파구청),18664,22163,40827,20413.5
20240712,8호선,석촌,9049,10451,19500,9750
20240712,8호선,송파,10752,10346,21098,10549
20240712,8호선,가락시장,8927,9861,18788,9394
20240712,8호선,문정,25033,26107,51140,25570
20240712,8호선,장지,19451,17747,37198,18599
20240712,8호선,복정,10657,8850,19507,9753.5
20240712,8호선,산성,7262,7288,14550,7275
20240712,8호선,남한산성입구(성남법원.검찰청),14679,12848,27527,13763.5
20240712,8호선,단대오거리,13367,12824,26191,13095.5
20240712,8호선,신흥,5791,5928,11719,5859.5
20240712,8호선,수진,6211,5753,11964,5982
20240712,8호선,모란,5332,4439,9771,4885.5
20240712,8호선,남위례,8357,8350,16707,8353.5
20240712,9호선,개화,3193,2180,5373,2686.5
20240712,9호선,김포공항,8031,11379,19410,9705
20240712,9호선,공항시장,3427,3581,7008,3504
20240712,9호선,신방화,8213,7839,16052,8026
20240712,9호선,마곡나루(서울식물원),16054,15794,31848,15924
20240712,9호선,양천향교,11382,11483,22865,11432.5
20240712,9호선,가양,25208,24270,49478,24739
20240712,9호선,증미,9016,8563,17579,8789.5
20240712,9호선,등촌,14051,13418,27469,13734.5
20240712,9호선,염창,20396,19215,39611,19805.5
20240712,9호선,신목동,5245,4537,9782,4891
20240712,9호선,선유도,10307,9530,19837,9918.5
20240712,9호선,당산,22556,22159,44715,22357.5
20240712,9호선,국회의사당,20629,20809,41438,20719
20240712,9호선,여의도,35101,33348,68449,34224.5
20240712,9호선,샛강,7406,7502,14908,7454
20240712,9호선,노량진,28927,28053,56980,28490
20240712,9호선,노들,5605,4555,10160,5080
20240712,9호선,흑석(중앙대입구),10119,10318,20437,10218.5
20240712,9호선,동작(현충원),1979,1555,3534,1767
20240712,9호선,구반포,1538,1514,3052,1526
20240712,9호선,신반포,5037,4757,9794,4897
20240712,9호선,고속터미널,17654,24938,42592,21296
20240712,9호선,사평,4854,4632,9486,4743
20240712,9호선,신논현,37506,38818,76324,38162
20240712,9호선2~3단계,언주,13477,13546,27023,13511.5
20240712,9호선2~3단계,선정릉,11794,12367,24161,12080.5
20240712,9호선2~3단계,삼성중앙,9244,9435,18679,9339.5
20240712,9호선2~3단계,봉은사,23148,23920,47068,23534
20240712,9호선2~3단계,종합운동장,5909,5909,11818,5909
20240712,9호선2~3단계,삼전,8999,8379,17378,8689
20240712,9호선2~3단계,석촌고분,8235,7846,16081,8040.5
20240712,9호선2~3단계,석촌,11321,9969,21290,10645
20240712,9호선2~3단계,송파나루,6740,7364,14104,7052
20240712,9호선2~3단계,한성백제,3607,3181,6788,3394
20240712,9호선2~3단계,올림픽공원(한국체대),11508,14108,25616,12808
20240712,9호선2~3단계,둔촌오륜,1581,1507,3088,1544
20240712,9호선2~3단계,중앙보훈병원,14098,12246,26344,13172
20240712,경강선,판교,6436,6311,12747,6373.5
20240712,경강선,이매,1247,1025,2272,1136
20240712,경강선,삼동,2875,2612,5487,2743.5
20240712,경강선,경기광주,8986,8441,17427,8713.5
20240712,경강선,초월,3915,3621,7536,3768
20240712,경강선,곤지암,2570,2516,5086,2543
20240712,경강선,신둔도예촌,1774,1543,3317,1658.5
20240712,경강선,이천,3508,3706,7214,3607
20240712,경강선,부발,2776,2427,5203,2601.5
20240712,경강선,세종대왕릉,404,402,806,403
20240712,경강선,여주,3085,3289,6374,3187
20240712,경강선,성남,1137,1025,2162,1081
20240712,경부선,서울역,11578,4690,16268,8134
20240712,경부선,남영,10993,11300,22293,11146.5
20240712,경부선,용산,48208,50122,98330,49165
20240712,경부선,노량진,9179,9009,18188,9094
20240712,경부선,대방,11631,12375,24006,12003
20240712,경부선,영등포,47644,49206,96850,48425
20240712,경부선,신도림,4573,4773,9346,4673
20240712,경부선,신길,9727,8161,17888,8944
20240712,경부선,구로,19433,20136,39569,19784.5
20240712,경부선,가산디지털단지,19458,21954,41412,20706
20240712,경부선,금천구청,12583,12721,25304,12652
20240712,경부선,석수,9715,8607,18322,9161
20240712,경부선,관악,8122,7705,15827,7913.5
20240712,경부선,안양,23345,23301,46646,23323
20240712,경부선,명학,9415,9197,18612,9306
20240712,경부선,금정,31784,31887,63671,31835.5
20240712,경부선,군포,7933,7781,15714,7857
20240712,경부선,의왕,10369,9967,20336,10168
20240712,경부선,성균관대,17214,16434,33648,16824
20240712,경부선,화서,12817,12745,25562,12781
20240712,경부선,수원,40373,44339,84712,42356
20240712,경부선,독산,19494,19734,39228,19614
20240712,경부선,세류,4179,3638,7817,3908.5
20240712,경부선,병점,16938,16466,33404,16702
20240712,경부선,세마,3947,3638,7585,3792.5
20240712,경부선,오산대,4225,3947,8172,4086
20240712,경부선,오산,11404,11225,22629,11314.5
20240712,경부선,진위,2086,1725,3811,1905.5
20240712,경부선,송탄,5440,4994,10434,5217
20240712,경부선,서정리,10682,8763,19445,9722.5
20240712,경부선,평택지제,5015,4965,9980,4990
20240712,경부선,평택,15104,14251,29355,14677.5
20240712,경부선,성환,4714,4285,8999,4499.5
20240712,경부선,직산,1200,1102,2302,1151
20240712,경부선,두정,7939,7756,15695,7847.5
20240712,경부선,천안,6887,7052,13939,6969.5
20240712,경부선,당정,6846,6341,13187,6593.5
20240712,경부선,서동탄,1810,1501,3311,1655.5
20240712,경부선,광명,4458,3966,8424,4212
20240712,경원선,이촌(국립중앙박물관),4708,3522,8230,4115
20240712,경원선,서빙고,2505,2303,4808,2404
20240712,경원선,한남,4301,4200,8501,4250.5
20240712,경원선,옥수,81,42,123,61.5
20240712,경원선,응봉,2193,1807,4000,2000
20240712,경원선,왕십리(성동구청),19303,19333,38636,19318
20240712,경원선,청량리(서울시립대입구),19358,20843,40201,20100.5
20240712,경원선,외대앞,10818,10077,20895,10447.5
20240712,경원선,신이문,9371,8547,17918,8959
20240712,경원선,석계,8141,9507,17648,8824
20240712,경원선,광운대,8592,7971,16563,8281.5
20240712,경원선,월계,7490,6780,14270,7135
20240712,경원선,녹천,5109,4188,9297,4648.5
20240712,경원선,창동,6,0,6,3
20240712,경원선,방학,11173,10832,22005,11002.5
20240712,경원선,도봉,6835,6428,13263,6631.5
20240712,경원선,도봉산,8102,5284,13386,6693
20240712,경원선,망월사,7843,7856,15699,7849.5
20240712,경원선,회룡,14627,14192,28819,14409.5
20240712,경원선,의정부,20506,21384,41890,20945
20240712,경원선,가능,7182,6985,14167,7083.5
20240712,경원선,녹양,4902,4742,9644,4822
20240712,경원선,양주,8290,7789,16079,8039.5
20240712,경원선,덕정,6608,6265,12873,6436.5
20240712,경원선,지행,7527,7669,15196,7598
20240712,경원선,동두천중앙,3321,3302,6623,3311.5
20240712,경원선,보산,2028,1669,3697,1848.5
20240712,경원선,동두천,1972,1846,3818,1909
20240712,경원선,소요산,2089,2099,4188,2094
20240712,경원선,청산,161,148,309,154.5
20240712,경원선,전곡,1237,1269,2506,1253
20240712,경원선,연천,1273,1496,2769,1384.5
20240712,경의선,서울역,5375,6846,12221,6110.5
20240712,경의선,신촌,1090,1436,2526,1263
20240712,경의선,효창공원앞,3561,3984,7545,3772.5
20240712,경의선,공덕,4977,4026,9003,4501.5
20240712,경의선,서강대,2525,2322,4847,2423.5
20240712,경의선,홍대입구,2388,2891,5279,2639.5
20240712,경의선,가좌,6652,6275,12927,6463.5
20240712,경의선,디지털미디어시티,3142,2930,6072,3036
20240712,경의선,수색,3706,3811,7517,3758.5
20240712,경의선,한국항공대,2278,2017,4295,2147.5
20240712,경의선,강매,3775,3037,6812,3406
20240712,경의선,행신,9173,9202,18375,9187.5
20240712,경의선,능곡,5327,5017,10344,5172
20240712,경의선,곡산,766,808,1574,787
20240712,경의선,백마,8491,8267,16758,8379
20240712,경의선,풍산,6939,6661,13600,6800
20240712,경의선,일산,11882,11781,23663,11831.5
20240712,경의선,탄현,8904,8530,17434,8717
20240712,경의선,야당,9974,10753,20727,10363.5
20240712,경의선,운정,8793,8073,16866,8433
20240712,경의선,금릉,6196,5894,12090,6045
20240712,경의선,금촌,7503,7248,14751,7375.5
20240712,경의선,월롱,2594,1836,4430,2215
20240712,경의선,파주,1373,983,2356,1178
20240712,경의선,문산,6095,6193,12288,6144
20240712,경의선,임진강,21,11,32,16
20240712,경의선,운천,9,4,13,6.5
20240712,경인선,개봉,23676,23434,47110,23555
20240712,경인선,오류동,13008,11906,24914,12457
20240712,경인선,역곡,28399,28304,56703,28351.5
20240712,경인선,부천,34795,35330,70125,35062.5
20240712,경인선,송내,29435,29200,58635,29317.5
20240712,경인선,부평,32389,35810,68199,34099.5
20240712,경인선,백운,8388,7784,16172,8086
20240712,경인선,동암,17591,17678,35269,17634.5
20240712,경인선,주안,20852,18621,39473,19736.5
20240712,경인선,제물포,12169,11527,23696,11848
20240712,경인선,동인천,15933,14878,30811,15405.5
20240712,경인선,인천,4322,3451,7773,3886.5
20240712,경인선,구일,7277,6970,14247,7123.5
20240712,경인선,소사,8199,7621,15820,7910
20240712,경인선,부개,9831,9216,19047,9523.5
20240712,경인선,간석,6690,6286,12976,6488
20240712,경인선,도원,3823,3923,7746,3873
20240712,경인선,온수(성공회대입구),7369,6911,14280,7140
20240712,경인선,중동,10448,9736,20184,10092
20240712,경인선,도화,4821,4415,9236,4618
20240712,경춘선,신내,3123,2848,5971,2985.5
20240712,경춘선,갈매,3359,2925,6284,3142
20240712,경춘선,별내,3923,3640,7563,3781.5
20240712,경춘선,퇴계원,3890,3599,7489,3744.5
20240712,경춘선,사릉,2247,2219,4466,2233
20240712,경춘선,금곡,1634,1597,3231,1615.5
20240712,경춘선,평내호평,6783,6685,13468,6734
20240712,경춘선,천마산,1645,1519,3164,1582
20240712,경춘선,마석,4134,4075,8209,4104.5
20240712,경춘선,대성리,835,1148,1983,991.5
20240712,경춘선,청평,2056,2352,4408,2204
20240712,경춘선,상천,298,285,583,291.5
20240712,경춘선,가평,2519,2595,5114,2557
20240712,경춘선,굴봉산,141,145,286,143
20240712,경춘선,백양리,91,81,172,86
20240712,경춘선,강촌,452,475,927,463.5
20240712,경춘선,김유정,358,465,823,411.5
20240712,경춘선,남춘천,3397,3471,6868,3434
20240712,경춘선,춘천,1541,1372,2913,1456.5
20240712,공항철도 1호선,서울역,15857,14506,30363,15181.5
20240712,공항철도 1호선,공덕,3531,4504,8035,4017.5
20240712,공항철도 1호선,홍대입구,16336,16371,32707,16353.5
20240712,공항철도 1호선,디지털미디어시티,15459,14537,29996,14998
20240712,공항철도 1호선,마곡나루(서울식물원),13099,11674,24773,12386.5
20240712,공항철도 1호선,김포공항,11404,6081,17485,8742.5
20240712,공항철도 1호선,계양,14872,14006,28878,14439
20240712,공항철도 1호선,검암,7397,7575,14972,7486
20240712,공항철도 1호선,청라국제도시,8540,7951,16491,8245.5
20240712,공항철도 1호선,운서,10562,10752,21314,10657
20240712,공항철도 1호선,공항화물청사,2257,2407,4664,2332
20240712,공항철도 1호선,인천공항1터미널,17263,14409,31672,15836
20240712,공항철도 1호선,인천공항2터미널,8192,6442,14634,7317
20240712,공항철도 1호선,영종,4676,4896,9572,4786
20240712,과천선,선바위,8610,7366,15976,7988
20240712,과천선,경마공원,7419,7536,14955,7477.5
20240712,과천선,대공원,3071,3256,6327,3163.5
20240712,과천선,과천,7594,6785,14379,7189.5
20240712,과천선,정부과천청사,14251,14448,28699,14349.5
20240712,과천선,인덕원,28897,29577,58474,29237
20240712,과천선,평촌,19898,19386,39284,19642
20240712,과천선,범계,30858,31465,62323,31161.5
20240712,분당선,선릉,14861,23036,37897,18948.5
20240712,분당선,한티,17958,19372,37330,18665
20240712,분당선,도곡,9133,8826,17959,8979.5
20240712,분당선,구룡,4195,4033,8228,4114
20240712,분당선,개포동,5172,5354,10526,5263
20240712,분당선,대모산입구,6952,6429,13381,6690.5
20240712,분당선,수서,19223,20646,39869,19934.5
20240712,분당선,복정,9,0,9,4.5
20240712,분당선,수원,9071,8757,17828,8914
20240712,분당선,서울숲,14259,14472,28731,14365.5
20240712,분당선,압구정로데오,22948,26625,49573,24786.5
20240712,분당선,강남구청,11202,12943,24145,12072.5
20240712,분당선,선정릉,8826,9083,17909,8954.5
20240712,분당선,가천대,7976,7907,15883,7941.5
20240712,분당선,태평,14818,13863,28681,14340.5
20240712,분당선,모란,21923,22417,44340,22170
20240712,분당선,야탑,28589,30471,59060,29530
20240712,분당선,서현,28336,28787,57123,28561.5
20240712,분당선,수내,15972,16092,32064,16032
20240712,분당선,정자,20748,21384,42132,21066
20240712,분당선,미금,17364,18111,35475,17737.5
20240712,분당선,오리,13027,10948,23975,11987.5
20240712,분당선,이매,6582,6110,12692,6346
20240712,분당선,보정,3114,2695,5809,2904.5
20240712,분당선,죽전,14914,16170,31084,15542
20240712,분당선,구성,7443,7472,14915,7457.5
20240712,분당선,신갈,5431,5275,10706,5353
20240712,분당선,기흥,11480,10483,21963,10981.5
20240712,분당선,상갈,6180,5872,12052,6026
20240712,분당선,청명,5590,4997,10587,5293.5
20240712,분당선,영통,10422,10539,20961,10480.5
20240712,분당선,망포,18073,16940,35013,17506.5
20240712,분당선,매탄권선,6493,5986,12479,6239.5
20240712,분당선,수원시청,15886,18233,34119,17059.5
20240712,분당선,매교,6206,5971,12177,6088.5
20240712,서해선,김포공항,3375,3998,7373,3686.5
20240712,서해선,원종,5383,5387,10770,5385
20240712,서해선,부천종합운동장,2949,2504,5453,2726.5
20240712,수인선,고색,6360,5767,12127,6063.5
20240712,수인선,오목천,4666,3964,8630,4315
20240712,수인선,어천,1681,1483,3164,1582
20240712,수인선,야목,499,425,924,462
20240712,수인선,사리,5820,4936,10756,5378
20240712,수인선,달월,119,82,201,100.5
20240712,수인선,월곶,3276,2927,6203,3101.5
20240712,수인선,소래포구,5281,4949,10230,5115
20240712,수인선,인천논현,6428,6830,13258,6629
20240712,수인선,호구포,4584,4589,9173,4586.5
20240712,수인선,남동인더스파크,2545,2866,5411,2705.5
20240712,수인선,원인재,5046,5103,10149,5074.5
20240712,수인선,연수,5554,5519,11073,5536.5
20240712,수인선,송도,2919,2557,5476,2738
20240712,수인선,인하대,7404,6872,14276,7138
20240712,수인선,숭의,4697,4299,8996,4498
20240712,수인선,신포,2240,2267,4507,2253.5
20240712,수인선,인천,1156,1859,3015,1507.5
20240712,신림선,샛강,3244,3822,7066,3533
20240712,신림선,대방,3430,2606,6036,3018
20240712,신림선,서울지방병무청,3764,3944,7708,3854
20240712,신림선,보라매,4910,4348,9258,4629
20240712,신림선,보라매공원,2673,2814,5487,2743.5
20240712,신림선,보라매병원,8086,8450,16536,8268
20240712,신림선,당곡,5577,5365,10942,5471
20240712,신림선,신림,2242,2876,5118,2559
20240712,신림선,서원,3882,3346,7228,3614
20240712,신림선,서울대벤처타운,10735,9629,20364,10182
20240712,신림선,관악산(서울대),3474,3340,6814,3407
20240712,안산선,산본,18555,19737,38292,19146
20240712,안산선,대야미,5623,4914,10537,5268.5
20240712,안산선,반월,4960,4701,9661,4830.5
20240712,안산선,상록수,16454,16684,33138,16569
20240712,안산선,한대앞,10368,10199,20567,10283.5
20240712,안산선,중앙,20418,22214,42632,21316
20240712,안산선,고잔,9975,9514,19489,9744.5
20240712,안산선,초지,5621,5645,11266,5633
20240712,안산선,안산,13124,12314,25438,12719
20240712,안산선,신길온천,2238,2130,4368,2184
20240712,안산선,정왕,10352,10394,20746,10373
20240712,안산선,오이도,8867,8866,17733,8866.5
20240712,안산선,수리산,4743,3744,8487,4243.5
20240712,우이신설선,북한산우이,3213,2957,6170,3085
20240712,중앙선,구리,14707,15021,29728,14864
20240712,중앙선,도농,12136,11165,23301,11650.5
20240712,중앙선,양정,593,540,1133,566.5
20240712,중앙선,덕소,5839,5836,11675,5837.5
20240712,중앙선,도심,2600,2037,4637,2318.5
20240712,중앙선,팔당,916,966,1882,941
20240712,중앙선,운길산,742,695,1437,718.5
20240712,중앙선,양수,2550,2551,5101,2550.5
20240712,중앙선,신원,194,158,352,176
20240712,중앙선,국수,801,790,1591,795.5
20240712,우이신설선,솔샘,6806,6211,13017,6508.5
20240712,우이신설선,북한산보국문,6804,6258,13062,6531
20240712,우이신설선,정릉,5356,4836,10192,5096
20240712,우이신설선,성신여대입구(돈암),4058,4471,8529,4264.5
20240712,우이신설선,보문,1814,1796,3610,1805
20240712,우이신설선,신설동,2601,2549,5150,2575
20240712,일산선,원흥,12916,12178,25094,12547
20240712,일산선,지축,3,0,3,1.5
20240712,일산선,삼송,21879,20723,42602,21301
20240712,일산선,원당,12577,11840,24417,12208.5
20240712,일산선,화정,19014,19504,38518,19259
20240712,일산선,대곡,3398,2515,5913,2956.5
20240712,일산선,백석,11341,11676,23017,11508.5
20240712,일산선,마두,9126,9260,18386,9193
20240712,일산선,정발산,8540,9036,17576,8788
20240712,일산선,주엽,11246,11437,22683,11341.5
20240712,일산선,대화,15365,12168,27533,13766.5
20240712,장항선,봉명,1548,1539,3087,1543.5
20240712,장항선,쌍용(나사렛대),2541,2443,4984,2492
20240712,장항선,아산,4256,4264,8520,4260
20240712,장항선,탕정,2059,1772,3831,1915.5
20240712,장항선,배방,1440,1376,2816,1408
20240712,장항선,온양온천,4842,4915,9757,4878.5
20240712,장항선,신창(순천향대),1657,1327,2984,1492
20240712,중앙선,회기,29198,27362,56560,28280
20240712,중앙선,중랑,6251,5907,12158,6079
20240712,중앙선,상봉,6766,6605,13371,6685.5
20240712,중앙선,망우,8531,8230,16761,8380.5
20240712,중앙선,양원,3615,3528,7143,3571.5
20240712,우이신설선,솔밭공원,3025,2788,5813,2906.5
20240712,우이신설선,4.19민주묘지,3439,3174,6613,3306.5
20240712,우이신설선,가오리,4888,4814,9702,4851
20240712,우이신설선,화계,4047,3720,7767,3883.5
20240712,우이신설선,삼양,2309,2446,4755,2377.5
20240712,우이신설선,삼양사거리,3002,3053,6055,3027.5
20240712,경원선,덕계,6658,6128,12786,6393
20240712,3호선,충무로,9,0,9,4.5
20240712,5호선,강동,20649,19798,40447,20223.5
20240712,중앙선,지평,58,98,156,78
20240712,중앙선,용문,2128,2425,4553,2276.5
20240712,중앙선,원덕,368,392,760,380
20240712,중앙선,양평,3517,3777,7294,3647
20240712,중앙선,오빈,321,374,695,347.5
20240712,중앙선,아신,569,592,1161,580.5
20240712,1호선,서울역,63860,61673,125533,62766.5
20240712,1호선,시청,28694,29203,57897,28948.5
20240712,1호선,종각,44166,44127,88293,44146.5
20240712,1호선,종로3가,29166,27366,56532,28266
20240712,1호선,종로5가,26421,25852,52273,26136.5
20240712,1호선,동대문,12391,11361,23752,11876
20240712,1호선,신설동,16309,15550,31859,15929.5
20240712,1호선,제기동,18709,18695,37404,18702
20240712,1호선,청량리(서울시립대입구),25492,25381,50873,25436.5
20240712,1호선,동묘앞,9926,10075,20001,10000.5
20240712,2호선,시청,30315,29595,59910,29955
20240712,2호선,을지로입구,53693,55415,109108,54554
20240712,2호선,을지로3가,28928,29453,58381,29190.5
20240712,2호선,을지로4가,16375,16379,32754,16377
20240712,2호선,동대문역사문화공원(DDP),16301,17883,34184,17092
20240712,2호선,신당,16851,17715,34566,17283
20240712,2호선,상왕십리,16509,16104,32613,16306.5
20240712,2호선,왕십리(성동구청),17982,16420,34402,17201
20240712,2호선,한양대,10387,10803,21190,10595
20240712,2호선,뚝섬,28398,29691,58089,29044.5
20240712,2호선,성수,49691,54509,104200,52100
20240712,2호선,건대입구,39921,43421,83342,41671
20240712,2호선,구의(광진구청),28406,26841,55247,27623.5
20240712,2호선,강변(동서울터미널),34286,34212,68498,34249
20240712,2호선,잠실나루,17297,16669,33966,16983
20240712,2호선,잠실(송파구청),89741,88259,178000,89000
20240712,2호선,잠실새내,28067,28038,56105,28052.5
20240712,2호선,종합운동장,23502,26247,49749,24874.5
20240712,2호선,삼성(무역센터),63071,63867,126938,63469
20240712,2호선,선릉,66501,58342,124843,62421.5
20240712,2호선,역삼,58192,66263,124455,62227.5
20240712,2호선,강남,97724,96566,194290,97145
20240712,2호선,교대(법원.검찰청),36639,44476,81115,40557.5
20240712,2호선,서초,24183,23709,47892,23946
20240712,2호선,방배,17630,18320,35950,17975
20240712,2호선,사당,46511,51151,97662,48831
20240712,2호선,낙성대(강감찬),31232,29180,60412,30206
20240712,2호선,서울대입구(관악구청),52914,50062,102976,51488
20240712,2호선,봉천,27541,25336,52877,26438.5
20240712,2호선,신림,61578,58829,120407,60203.5
20240712,2호선,신대방,27900,26318,54218,27109
20240712,2호선,구로디지털단지,64794,64118,128912,64456
20240712,2호선,대림(구로구청),26690,27004,53694,26847
20240712,2호선,신도림,56896,56102,112998,56499
20240712,2호선,문래,26472,27609,54081,27040.5
20240712,2호선,영등포구청,25028,26005,51033,25516.5
20240712,2호선,당산,20596,24062,44658,22329
20240712,2호선,합정,36271,40596,76867,38433.5
20240712,2호선,홍대입구,78118,88348,166466,83233
20240712,2호선,신촌,43024,43803,86827,43413.5
20240712,2호선,이대,17032,18261,35293,17646.5
20240712,2호선,아현,12576,11413,23989,11994.5
20240712,2호선,충정로(경기대입구),11335,11925,23260,11630
20240712,2호선,용답,3381,3131,6512,3256
20240712,2호선,신답,1824,1948,3772,1886
20240712,2호선,신설동,4095,3974,8069,4034.5
20240712,2호선,도림천,1558,1587,3145,1572.5
20240712,2호선,양천구청,7720,8127,15847,7923.5
20240712,2호선,신정네거리,11456,11756,23212,11606
20240712,2호선,용두(동대문구청),2934,2951,5885,2942.5
20240712,3호선,지축,8729,8630,17359,8679.5
20240712,3호선,구파발,24268,23177,47445,23722.5
20240712,3호선,연신내,38778,36572,75350,37675
20240712,3호선,불광,18623,19694,38317,19158.5
20240712,3호선,녹번,17197,15537,32734,16367
20240712,3호선,홍제,20167,18992,39159,19579.5
20240712,3호선,무악재,5029,4730,9759,4879.5
20240712,3호선,독립문,8565,8490,17055,8527.5
20240712,3호선,경복궁(정부서울청사),26691,26928,53619,26809.5
20240712,3호선,안국,29652,30572,60224,30112
20240712,3호선,종로3가,13116,15170,28286,14143
20240712,3호선,을지로3가,13378,14114,27492,13746
20240712,3호선,동대입구,11745,12910,24655,12327.5
20240712,3호선,약수,15315,14861,30176,15088
20240712,3호선,금호,9193,8654,17847,8923.5
20240712,3호선,옥수,10128,10249,20377,10188.5
20240712,3호선,압구정,37470,40047,77517,38758.5
20240712,3호선,신사,32525,35173,67698,33849
20240712,3호선,잠원,6181,5647,11828,5914
20240712,3호선,고속터미널,55717,56997,112714,56357
20240712,3호선,교대(법원.검찰청),20393,11979,32372,16186
20240712,3호선,남부터미널(예술의전당),35298,35829,71127,35563.5
20240712,3호선,양재(서초구청),44152,46084,90236,45118
20240712,3호선,매봉,14696,14148,28844,14422
20240712,3호선,도곡,6834,6891,13725,6862.5
20240712,3호선,대치,14204,13977,28181,14090.5
20240712,3호선,학여울,3428,3471,6899,3449.5
20240712,3호선,대청,12751,11805,24556,12278
20240712,3호선,일원,12634,11928,24562,12281
20240712,3호선,수서,21924,21514,43438,21719
20240712,3호선,가락시장,10493,10182,20675,10337.5
20240712,3호선,경찰병원,8837,8649,17486,8743
20240712,3호선,오금,7583,6654,14237,7118.5
20240712,4호선,당고개,10919,9361,20280,10140
20240712,4호선,상계,21660,20121,41781,20890.5
20240712,4호선,노원,32494,37087,69581,34790.5
20240712,4호선,창동,30468,32013,62481,31240.5
20240712,4호선,쌍문,32640,30075,62715,31357.5
20240712,4호선,수유(강북구청),37439,38127,75566,37783
20240712,4호선,미아(서울사이버대학),17005,16180,33185,16592.5
20240712,4호선,미아사거리,30063,29895,59958,29979
20240712,4호선,길음,23584,22627,46211,23105.5
20240712,4호선,성신여대입구(돈암),23559,23087,46646,23323
20240712,4호선,한성대입구(삼선교),15167,14313,29480,14740
20240712,4호선,혜화,38108,38489,76597,38298.5
20240712,4호선,동대문,22456,22188,44644,22322
20240712,4호선,동대문역사문화공원(DDP),20860,17714,38574,19287
20240712,4호선,충무로,33891,35433,69324,34662
20240712,4호선,명동,34312,37195,71507,35753.5
20240712,4호선,회현(남대문시장),29979,31528,61507,30753.5
20240712,4호선,서울역,14762,25931,40693,20346.5
20240712,4호선,숙대입구(갈월),16465,15736,32201,16100.5
20240712,4호선,삼각지,7346,8670,16016,8008
20240712,4호선,신용산,23262,25170,48432,24216
20240712,4호선,이촌(국립중앙박물관),10301,11267,21568,10784
20240712,4호선,동작(현충원),1737,1916,3653,1826.5
20240712,4호선,총신대입구(이수),22325,24052,46377,23188.5
20240712,4호선,사당,29848,26380,56228,28114
20240712,4호선,남태령,1684,1354,3038,1519
20240712,5호선,방화,7989,7695,15684,7842
20240712,5호선,개화산,6889,6359,13248,6624
20240712,5호선,김포공항,12500,8772,21272,10636
20240712,5호선,송정,7282,6835,14117,7058.5
20240712,5호선,마곡,14168,14334,28502,14251
20240712,5호선,발산,25239,26921,52160,26080
20240712,5호선,우장산,17087,16283,33370,16685
20240712,5호선,화곡,32053,29519,61572,30786
20240712,5호선,까치산,31144,29479,60623,30311.5
20240712,5호선,신정(은행정),15323,12428,27751,13875.5
20240712,5호선,목동,19142,20365,39507,19753.5
20240712,5호선,오목교(목동운동장앞),24337,25945,50282,25141
20240712,5호선,양평,8814,8389,17203,8601.5
20240712,5호선,영등포구청,5462,5302,10764,5382
20240712,5호선,영등포시장,13144,13304,26448,13224
20240712,5호선,신길,5669,5659,11328,5664
20240712,5호선,여의도,32130,34220,66350,33175
20240712,5호선,여의나루,14460,15951,30411,15205.5
20240712,5호선,마포,16601,16923,33524,16762
20240712,5호선,공덕,16686,17767,34453,17226.5
20240712,5호선,애오개,8050,7753,15803,7901.5
20240712,5호선,충정로(경기대입구),5211,5304,10515,5257.5
20240712,5호선,서대문,22915,23016,45931,22965.5
20240712,5호선,광화문(세종문화회관),36804,39053,75857,37928.5
20240712,5호선,종로3가,17078,18100,35178,17589
20240712,5호선,을지로4가,7460,7664,15124,7562
20240712,5호선,동대문역사문화공원(DDP),3553,4220,7773,3886.5
20240712,5호선,청구,4409,4234,8643,4321.5
20240712,5호선,신금호,7404,7612,15016,7508
20240712,5호선,행당,9091,7996,17087,8543.5
20240712,5호선,왕십리(성동구청),5216,6303,11519,5759.5
20240712,5호선,마장,6622,6081,12703,6351.5
20240712,5호선,답십리,18211,16277,34488,17244
20240712,5호선,장한평,22206,21870,44076,22038
20240712,5호선,군자(능동),13084,14530,27614,13807
20240712,5호선,아차산(어린이대공원후문),16596,15746,32342,16171
20240712,5호선,광나루(장신대),14851,13502,28353,14176.5
20240712,5호선,천호(풍납토성),22222,22072,44294,22147
20240712,5호선,길동,9324,9723,19047,9523.5
20240712,5호선,굽은다리(강동구민회관앞),11329,10868,22197,11098.5
20240712,5호선,명일,10158,10225,20383,10191.5
20240712,5호선,고덕,12690,12408,25098,12549
20240712,5호선,상일동,18003,16402,34405,17202.5
20240712,5호선,둔촌동,10248,10127,20375,10187.5
20240712,5호선,올림픽공원(한국체대),11751,9531,21282,10641
20240712,5호선,방이,8329,8738,17067,8533.5
20240712,5호선,오금,4199,4305,8504,4252
20240712,5호선,개롱,7551,7690,15241,7620.5
20240712,5호선,거여,11279,10799,22078,11039
20240712,5호선,마천,8578,7545,16123,8061.5
20240712,5호선,강일,6713,6170,12883,6441.5
20240712,5호선,미사,19962,20489,40451,20225.5
20240712,5호선,하남풍산,5137,5095,10232,5116
20240712,5호선,하남시청(덕풍·신장),9559,9010,18569,9284.5
20240712,5호선,하남검단산,7519,7061,14580,7290
20240712,6호선,응암,19552,18939,38491,19245.5
20240712,6호선,역촌,4282,4653,8935,4467.5
20240712,6호선,불광,5331,5154,10485,5242.5
20240712,6호선,독바위,3125,3211,6336,3168
20240712,6호선,연신내,2,0,2,1
20240712,6호선,구산,9302,7029,16331,8165.5
20240712,6호선,새절(신사),14229,12914,27143,13571.5
20240712,6호선,증산(명지대앞),10793,10506,21299,10649.5
20240712,6호선,디지털미디어시티,16163,17441,33604,16802
20240712,6호선,월드컵경기장(성산),4927,5075,10002,5001
20240712,6호선,마포구청,16549,14710,31259,15629.5
20240712,6호선,망원,17077,18484,35561,17780.5
20240712,6호선,합정,15583,15581,31164,15582
20240712,6호선,상수,11196,13140,24336,12168
20240712,6호선,광흥창(서강),10891,10374,21265,10632.5
20240712,6호선,대흥(서강대앞),10225,10448,20673,10336.5
20240712,6호선,공덕,22171,21639,43810,21905
20240712,6호선,효창공원앞,8370,7449,15819,7909.5
20240712,6호선,삼각지,8751,7536,16287,8143.5
20240712,6호선,녹사평(용산구청),6087,6461,12548,6274
20240712,6호선,이태원,12636,16989,29625,14812.5
20240712,6호선,한강진,11577,13524,25101,12550.5
20240712,6호선,버티고개,2418,2383,4801,2400.5
20240712,6호선,약수,4278,4286,8564,4282
20240712,6호선,청구,4429,4258,8687,4343.5
20240712,6호선,신당,9402,8987,18389,9194.5
20240712,6호선,동묘앞,8971,8895,17866,8933
20240712,6호선,창신,3907,3174,7081,3540.5
20240712,6호선,보문,9128,8191,17319,8659.5
20240712,6호선,안암(고대병원앞),12402,11847,24249,12124.5
20240712,6호선,고려대(종암),9439,8761,18200,9100
20240712,6호선,월곡(동덕여대),13202,12619,25821,12910.5
20240712,6호선,상월곡(한국과학기술연구원),6991,6226,13217,6608.5
20240712,6호선,석계,13767,14097,27864,13932
20240713,과천선,대공원,9515,10495,20010,10005
20240713,과천선,과천,5574,5065,10639,5319.5
20240713,과천선,정부과천청사,8418,8274,16692,8346
20240713,과천선,인덕원,18612,18319,36931,18465.5
20240713,과천선,평촌,10250,9745,19995,9997.5
20240713,과천선,범계,24580,24011,48591,24295.5
20240713,분당선,선릉,5942,9394,15336,7668
20240713,분당선,한티,16752,16117,32869,16434.5
20240713,분당선,도곡,5211,4808,10019,5009.5
20240713,분당선,구룡,2767,2602,5369,2684.5
20240713,2호선,서울대입구(관악구청),39597,38104,77701,38850.5
20240713,2호선,봉천,19819,18050,37869,18934.5
20240713,2호선,신림,49387,46712,96099,48049.5
20240713,2호선,신대방,21513,20164,41677,20838.5
20240713,2호선,구로디지털단지,39086,37911,76997,38498.5
20240713,2호선,대림(구로구청),20515,21353,41868,20934
20240713,2호선,신도림,48734,48245,96979,48489.5
20240713,2호선,문래,15068,16157,31225,15612.5
20240713,2호선,영등포구청,14346,14792,29138,14569
20240713,2호선,당산,13032,14172,27204,13602
20240713,분당선,개포동,3506,3325,6831,3415.5
20240713,분당선,대모산입구,4386,3944,8330,4165
20240713,분당선,수서,14726,15334,30060,15030
20240713,분당선,복정,13,0,13,6.5
20240713,분당선,수원,8101,7747,15848,7924
20240713,분당선,서울숲,11001,11128,22129,11064.5
20240713,분당선,압구정로데오,19992,23378,43370,21685
20240713,분당선,강남구청,5769,6843,12612,6306
20240713,분당선,선정릉,3564,3475,7039,3519.5
20240713,분당선,가천대,5752,5800,11552,5776
20240713,분당선,태평,11288,10439,21727,10863.5
20240713,분당선,모란,16986,17637,34623,17311.5
20240713,분당선,야탑,19274,19979,39253,19626.5
20240713,분당선,서현,19877,20024,39901,19950.5
20240713,분당선,수내,9590,9145,18735,9367.5
20240713,분당선,정자,12020,12016,24036,12018
20240713,분당선,미금,11393,11715,23108,11554
20240713,분당선,오리,8183,7052,15235,7617.5
20240713,분당선,이매,4614,4534,9148,4574
20240713,분당선,보정,1799,1724,3523,1761.5
20240713,분당선,죽전,10479,11700,22179,11089.5
20240713,분당선,구성,5016,5108,10124,5062
20240713,분당선,신갈,3400,3338,6738,3369
20240713,분당선,기흥,8034,7208,15242,7621
20240713,분당선,상갈,4315,4129,8444,4222
20240713,분당선,청명,3499,3396,6895,3447.5
20240713,분당선,영통,8007,7721,15728,7864
20240713,분당선,망포,11308,10080,21388,10694
20240713,분당선,매탄권선,4288,3949,8237,4118.5
20240713,분당선,수원시청,13101,14758,27859,13929.5
20240713,분당선,매교,3693,3742,7435,3717.5
20240713,서해선,김포공항,3135,4046,7181,3590.5
20240713,서해선,원종,4335,4178,8513,4256.5
20240713,서해선,부천종합운동장,1960,1566,3526,1763
20240713,수인선,고색,3411,3342,6753,3376.5
20240713,수인선,오목천,3603,2886,6489,3244.5
20240713,수인선,어천,1507,1228,2735,1367.5
20240713,수인선,야목,352,324,676,338
20240713,수인선,사리,4263,3549,7812,3906
20240713,수인선,달월,91,83,174,87
20240713,수인선,월곶,2594,2460,5054,2527
20240713,수인선,소래포구,4856,4808,9664,4832
20240713,수인선,인천논현,4802,5057,9859,4929.5
20240713,수인선,호구포,2836,2714,5550,2775
20240713,수인선,남동인더스파크,1045,1016,2061,1030.5
20240713,수인선,원인재,4071,4031,8102,4051
20240713,수인선,연수,4569,4625,9194,4597
20240713,수인선,송도,2163,2073,4236,2118
20240713,수인선,인하대,5122,4596,9718,4859
20240713,수인선,숭의,3288,2958,6246,3123
20240713,중앙선,원덕,405,441,846,423
20240713,중앙선,양평,4350,4654,9004,4502
20240713,중앙선,오빈,363,373,736,368
20240713,중앙선,아신,625,670,1295,647.5
20240713,중앙선,국수,729,715,1444,722
20240713,중앙선,신원,242,212,454,227
20240713,중앙선,양수,3517,3453,6970,3485
20240713,중앙선,운길산,1113,1103,2216,1108
20240713,중앙선,팔당,1218,1316,2534,1267
20240713,중앙선,도심,1849,1544,3393,1696.5
20240713,중앙선,덕소,4909,4782,9691,4845.5
20240713,중앙선,양정,553,461,1014,507
20240713,중앙선,도농,8129,7769,15898,7949
20240713,중앙선,구리,11456,11519,22975,11487.5
20240713,중앙선,양원,2223,2085,4308,2154
20240713,중앙선,망우,7027,6909,13936,6968
20240713,중앙선,상봉,5561,5490,11051,5525.5
20240713,중앙선,중랑,4946,4484,9430,4715
20240713,중앙선,회기,22992,20991,43983,21991.5
20240713,장항선,신창(순천향대),1111,1078,2189,1094.5
20240713,장항선,온양온천,4962,4887,9849,4924.5
20240713,장항선,배방,1309,1200,2509,1254.5
20240713,장항선,탕정,1602,1446,3048,1524
20240713,장항선,아산,4059,3727,7786,3893
20240713,장항선,쌍용(나사렛대),2034,1954,3988,1994
20240713,장항선,봉명,858,825,1683,841.5
20240713,일산선,대화,10630,9124,19754,9877
20240713,일산선,주엽,8230,7874,16104,8052
20240713,일산선,정발산,6941,7067,14008,7004
20240713,일산선,마두,5938,5811,11749,5874.5
20240713,일산선,백석,8293,8396,16689,8344.5
20240713,일산선,대곡,2403,2106,4509,2254.5
20240713,일산선,화정,14465,14842,29307,14653.5
20240713,일산선,원당,9337,8746,18083,9041.5
20240713,일산선,삼송,15606,14794,30400,15200
20240713,일산선,지축,1,0,1,0.5
20240713,일산선,원흥,8658,8247,16905,8452.5
20240713,우이신설선,신설동,1741,1654,3395,1697.5
20240713,우이신설선,보문,1479,1414,2893,1446.5
20240713,우이신설선,성신여대입구(돈암),3516,3846,7362,3681
20240713,우이신설선,정릉,4196,3505,7701,3850.5
20240713,우이신설선,북한산보국문,5337,4659,9996,4998
20240713,우이신설선,솔샘,4562,4066,8628,4314
20240713,우이신설선,삼양사거리,2345,2189,4534,2267
20240713,우이신설선,삼양,1705,1755,3460,1730
20240713,우이신설선,화계,2914,2692,5606,2803
20240713,우이신설선,가오리,3562,3325,6887,3443.5
20240713,우이신설선,4.19민주묘지,2893,2599,5492,2746
20240713,우이신설선,솔밭공원,2202,2159,4361,2180.5
20240713,우이신설선,북한산우이,4236,4412,8648,4324
20240713,안산선,수리산,3241,2834,6075,3037.5
20240713,안산선,오이도,8014,8205,16219,8109.5
20240713,2호선,합정,34390,39263,73653,36826.5
20240713,2호선,홍대입구,91748,103977,195725,97862.5
20240713,2호선,신촌,37914,38873,76787,38393.5
20240713,2호선,이대,12882,13463,26345,13172.5
20240713,2호선,아현,9150,8221,17371,8685.5
20240713,2호선,충정로(경기대입구),6754,7104,13858,6929
20240713,2호선,용답,2366,2237,4603,2301.5
20240713,2호선,신답,1127,1083,2210,1105
20240713,2호선,신설동,4002,3792,7794,3897
20240713,2호선,도림천,989,1035,2024,1012
20240713,2호선,양천구청,5142,5065,10207,5103.5
20240713,2호선,신정네거리,8371,8187,16558,8279
20240713,2호선,용두(동대문구청),2133,2038,4171,2085.5
20240713,3호선,지축,5943,5560,11503,5751.5
20240713,3호선,구파발,18831,18976,37807,18903.5
20240713,3호선,연신내,30965,28815,59780,29890
20240713,3호선,불광,14280,15724,30004,15002
20240713,3호선,녹번,11544,10121,21665,10832.5
20240713,3호선,홍제,15364,14405,29769,14884.5
20240713,3호선,무악재,3287,3266,6553,3276.5
20240713,3호선,독립문,7017,7572,14589,7294.5
20240713,3호선,경복궁(정부서울청사),21625,22706,44331,22165.5
20240713,3호선,안국,23366,25096,48462,24231
20240713,3호선,종로3가,8786,11948,20734,10367
20240713,3호선,을지로3가,7081,7695,14776,7388
20240713,3호선,충무로,10,0,10,5
20240713,3호선,동대입구,11532,12765,24297,12148.5
20240713,3호선,약수,10649,10229,20878,10439
20240713,3호선,금호,6532,5898,12430,6215
20240713,3호선,옥수,7671,7751,15422,7711
20240713,3호선,압구정,26439,28157,54596,27298
20240713,3호선,신사,23976,25362,49338,24669
20240713,3호선,잠원,4018,3689,7707,3853.5
20240713,3호선,고속터미널,62282,60328,122610,61305
20240713,3호선,교대(법원.검찰청),10718,5473,16191,8095.5
20240713,3호선,남부터미널(예술의전당),23019,22726,45745,22872.5
20240713,3호선,양재(서초구청),21343,23020,44363,22181.5
20240713,3호선,매봉,6998,6930,13928,6964
20240713,3호선,도곡,3602,3579,7181,3590.5
20240713,3호선,대치,12178,10810,22988,11494
20240713,3호선,학여울,3158,3294,6452,3226
20240713,3호선,대청,7255,6737,13992,6996
20240713,3호선,일원,5810,5501,11311,5655.5
20240713,3호선,수서,16154,15649,31803,15901.5
20240713,3호선,가락시장,6962,6643,13605,6802.5
20240713,3호선,경찰병원,4847,4700,9547,4773.5
20240713,3호선,오금,4545,4325,8870,4435
20240713,4호선,당고개,8745,7923,16668,8334
20240713,4호선,상계,16093,14582,30675,15337.5
20240713,4호선,노원,26146,29005,55151,27575.5
20240713,4호선,창동,22909,23854,46763,23381.5
20240713,4호선,쌍문,24328,21480,45808,22904
20240713,4호선,수유(강북구청),29189,28380,57569,28784.5
20240713,4호선,미아(서울사이버대학),13242,12159,25401,12700.5
20240713,4호선,미아사거리,23721,22393,46114,23057
20240713,4호선,길음,16695,15645,32340,16170
20240713,4호선,성신여대입구(돈암),19469,18762,38231,19115.5
20240713,4호선,한성대입구(삼선교),11459,11098,22557,11278.5
20240713,4호선,혜화,36018,38304,74322,37161
20240713,4호선,동대문,17771,18257,36028,18014
20240713,4호선,동대문역사문화공원(DDP),17111,14774,31885,15942.5
20240713,4호선,충무로,18155,19544,37699,18849.5
20240713,4호선,명동,32081,36274,68355,34177.5
20240713,4호선,회현(남대문시장),22956,24178,47134,23567
20240713,4호선,서울역,8051,20663,28714,14357
20240713,4호선,숙대입구(갈월),11645,11667,23312,11656
20240713,4호선,삼각지,6035,8239,14274,7137
20240713,4호선,신용산,17210,19255,36465,18232.5
20240713,4호선,이촌(국립중앙박물관),9910,10407,20317,10158.5
20240713,4호선,동작(현충원),1443,1607,3050,1525
20240713,4호선,총신대입구(이수),16201,17538,33739,16869.5
20240713,4호선,사당,25886,24316,50202,25101
20240713,4호선,남태령,1330,811,2141,1070.5
20240713,5호선,방화,5696,5412,11108,5554
20240713,5호선,개화산,4509,4196,8705,4352.5
20240713,5호선,김포공항,10738,8507,19245,9622.5
20240713,안산선,정왕,8211,8379,16590,8295
20240713,안산선,신길온천,1899,1756,3655,1827.5
20240713,수인선,신포,1728,1762,3490,1745
20240713,수인선,인천,1418,2189,3607,1803.5
20240713,신림선,샛강,1320,1663,2983,1491.5
20240713,신림선,대방,2575,1884,4459,2229.5
20240713,신림선,서울지방병무청,2305,2520,4825,2412.5
20240713,신림선,보라매,2970,2676,5646,2823
20240713,신림선,보라매공원,1655,1704,3359,1679.5
20240713,신림선,보라매병원,3758,3810,7568,3784
20240713,신림선,당곡,4118,3677,7795,3897.5
20240713,신림선,신림,1709,2253,3962,1981
20240713,신림선,서원,2945,2518,5463,2731.5
20240713,신림선,서울대벤처타운,8683,7332,16015,8007.5
20240713,신림선,관악산(서울대),4213,4298,8511,4255.5
20240713,안산선,산본,14736,15592,30328,15164
20240713,안산선,대야미,4351,3806,8157,4078.5
20240713,안산선,반월,3762,3571,7333,3666.5
20240713,2호선,종합운동장,24031,27685,51716,25858
20240713,2호선,삼성(무역센터),41086,40469,81555,40777.5
20240713,2호선,선릉,30203,26545,56748,28374
20240713,2호선,역삼,19407,21438,40845,20422.5
20240713,2호선,강남,65545,65707,131252,65626
20240713,2호선,교대(법원.검찰청),17460,21813,39273,19636.5
20240713,2호선,서초,13474,11929,25403,12701.5
20240713,2호선,방배,10483,10413,20896,10448
20240713,2호선,사당,39284,43085,82369,41184.5
20240713,2호선,낙성대(강감찬),23946,21412,45358,22679
20240713,공항철도 1호선,운서,9282,9724,19006,9503
20240713,공항철도 1호선,공항화물청사,1270,1281,2551,1275.5
20240713,공항철도 1호선,인천공항1터미널,16853,14546,31399,15699.5
20240713,공항철도 1호선,인천공항2터미널,7499,6277,13776,6888
20240713,공항철도 1호선,영종,4053,4172,8225,4112.5
20240713,과천선,선바위,5593,4509,10102,5051
20240713,과천선,경마공원,11780,11815,23595,11797.5
20240713,1호선,서울역,46689,44858,91547,45773.5
20240713,1호선,시청,16806,17406,34212,17106
20240713,1호선,종각,25216,24345,49561,24780.5
20240713,1호선,종로3가,25712,24614,50326,25163
20240713,1호선,종로5가,21603,21239,42842,21421
20240713,1호선,동대문,11983,12368,24351,12175.5
20240713,1호선,신설동,11049,10435,21484,10742
20240713,1호선,제기동,16825,17218,34043,17021.5
20240713,1호선,청량리(서울시립대입구),22545,22463,45008,22504
20240713,1호선,동묘앞,13416,13725,27141,13570.5
20240713,2호선,시청,14227,12048,26275,13137.5
20240713,2호선,을지로입구,34439,34227,68666,34333
20240713,2호선,을지로3가,15806,15537,31343,15671.5
20240713,2호선,을지로4가,9896,10228,20124,10062
20240713,2호선,동대문역사문화공원(DDP),13984,16475,30459,15229.5
20240713,2호선,신당,12724,13741,26465,13232.5
20240713,2호선,상왕십리,11373,10586,21959,10979.5
20240713,2호선,왕십리(성동구청),13864,13550,27414,13707
20240713,2호선,한양대,4900,5139,10039,5019.5
20240713,2호선,뚝섬,19460,18971,38431,19215.5
20240713,2호선,성수,35128,40125,75253,37626.5
20240713,2호선,건대입구,37553,40867,78420,39210
20240713,2호선,구의(광진구청),19615,18750,38365,19182.5
20240713,2호선,강변(동서울터미널),29081,28541,57622,28811
20240713,2호선,잠실나루,8887,8568,17455,8727.5
20240713,2호선,잠실(송파구청),82773,80227,163000,81500
20240713,2호선,잠실새내,21962,22886,44848,22424
20240713,안산선,안산,12018,12949,24967,12483.5
20240713,안산선,초지,4142,4075,8217,4108.5
20240713,안산선,고잔,7155,6924,14079,7039.5
20240713,안산선,중앙,18319,19355,37674,18837
20240713,안산선,한대앞,8028,7701,15729,7864.5
20240713,안산선,상록수,13230,13307,26537,13268.5
20240713,중앙선,지평,74,80,154,77
20240713,중앙선,용문,2427,2837,5264,2632
20240713,5호선,송정,5623,5236,10859,5429.5
20240713,5호선,마곡,7676,7710,15386,7693
20240713,5호선,발산,16575,17674,34249,17124.5
20240713,5호선,우장산,11246,10956,22202,11101
20240713,5호선,화곡,22193,20539,42732,21366
20240713,5호선,까치산,22731,20917,43648,21824
20240713,5호선,신정(은행정),9870,8279,18149,9074.5
20240713,5호선,목동,12521,12284,24805,12402.5
20240713,5호선,오목교(목동운동장앞),18002,18038,36040,18020
20240713,5호선,양평,4528,4101,8629,4314.5
20240713,5호선,영등포구청,2800,2531,5331,2665.5
20240713,5호선,영등포시장,9412,9641,19053,9526.5
20240713,5호선,신길,3805,3822,7627,3813.5
20240713,5호선,여의도,14499,15721,30220,15110
20240713,5호선,여의나루,13738,15461,29199,14599.5
20240713,5호선,마포,9074,9245,18319,9159.5
20240713,5호선,공덕,8585,8751,17336,8668
20240713,5호선,애오개,4355,4062,8417,4208.5
20240713,5호선,충정로(경기대입구),2366,2164,4530,2265
20240713,5호선,서대문,8867,8787,17654,8827
20240713,5호선,광화문(세종문화회관),23497,23931,47428,23714
20240713,5호선,종로3가,17010,17760,34770,17385
20240713,5호선,을지로4가,4041,4298,8339,4169.5
20240713,5호선,동대문역사문화공원(DDP),1570,2071,3641,1820.5
20240713,5호선,청구,2743,2664,5407,2703.5
20240713,5호선,신금호,4717,4867,9584,4792
20240713,5호선,행당,5952,5009,10961,5480.5
20240713,5호선,왕십리(성동구청),3811,5052,8863,4431.5
20240713,5호선,마장,4356,4034,8390,4195
20240713,5호선,답십리,11384,10171,21555,10777.5
20240713,5호선,장한평,13369,12846,26215,13107.5
20240713,5호선,군자(능동),9565,10880,20445,10222.5
20240713,5호선,아차산(어린이대공원후문),13717,12921,26638,13319
20240713,5호선,광나루(장신대),11837,11002,22839,11419.5
20240713,5호선,천호(풍납토성),19286,18550,37836,18918
20240713,5호선,강동,14029,13414,27443,13721.5
20240713,5호선,길동,7074,7079,14153,7076.5
20240713,5호선,굽은다리(강동구민회관앞),8633,8125,16758,8379
20240713,5호선,명일,7089,6853,13942,6971
20240713,5호선,고덕,8048,7670,15718,7859
20240713,5호선,상일동,10566,9984,20550,10275
20240713,5호선,둔촌동,7342,7164,14506,7253
20240713,5호선,올림픽공원(한국체대),7164,7085,14249,7124.5
20240713,5호선,방이,6061,5967,12028,6014
20240713,5호선,오금,2410,2343,4753,2376.5
20240713,5호선,개롱,5079,5175,10254,5127
20240713,5호선,거여,7121,6581,13702,6851
20240713,5호선,마천,5403,5258,10661,5330.5
20240713,5호선,강일,4937,4423,9360,4680
20240713,5호선,미사,15585,15606,31191,15595.5
20240713,5호선,하남풍산,3388,3412,6800,3400
20240713,5호선,하남시청(덕풍·신장),7278,6657,13935,6967.5
20240713,5호선,하남검단산,6802,6558,13360,6680
20240713,6호선,응암,14019,13671,27690,13845
20240713,6호선,역촌,3160,3355,6515,3257.5
20240713,6호선,불광,4612,4105,8717,4358.5
20240713,6호선,독바위,2321,2450,4771,2385.5
20240713,6호선,연신내,6,0,6,3
20240713,6호선,구산,6571,4935,11506,5753
20240713,6호선,새절(신사),9477,8727,18204,9102
20240713,6호선,증산(명지대앞),7984,7655,15639,7819.5
20240713,6호선,디지털미디어시티,8986,9064,18050,9025
20240713,6호선,월드컵경기장(성산),5233,5546,10779,5389.5
20240713,6호선,마포구청,10860,9586,20446,10223
20240713,6호선,망원,15371,16743,32114,16057
20240713,6호선,합정,14143,13711,27854,13927
20240713,6호선,상수,11119,13403,24522,12261
20240713,6호선,광흥창(서강),6188,5529,11717,5858.5
20240713,6호선,대흥(서강대앞),6546,6420,12966,6483
20240713,6호선,공덕,12156,11706,23862,11931
20240713,6호선,효창공원앞,5372,4492,9864,4932
20240713,6호선,삼각지,7593,6300,13893,6946.5
20240713,6호선,녹사평(용산구청),5900,6798,12698,6349
20240713,6호선,이태원,13763,18092,31855,15927.5
20240713,6호선,한강진,10975,13089,24064,12032
20240713,6호선,버티고개,1755,1835,3590,1795
20240713,6호선,약수,3181,3128,6309,3154.5
20240713,6호선,청구,2845,2515,5360,2680
20240713,6호선,신당,7262,6673,13935,6967.5
20240713,6호선,동묘앞,8952,8717,17669,8834.5
20240713,6호선,창신,2450,1999,4449,2224.5
20240713,6호선,보문,6291,5714,12005,6002.5
20240713,6호선,안암(고대병원앞),7417,6888,14305,7152.5
20240713,6호선,고려대(종암),5926,5636,11562,5781
20240713,6호선,월곡(동덕여대),8254,7754,16008,8004
20240713,6호선,상월곡(한국과학기술연구원),4589,3929,8518,4259
20240713,6호선,돌곶이,7346,6476,13822,6911
20240713,6호선,석계,9703,9670,19373,9686.5
20240713,6호선,태릉입구,4947,5166,10113,5056.5
20240713,6호선,화랑대(서울여대입구),7973,6463,14436,7218
20240713,6호선,봉화산(서울의료원),6205,5936,12141,6070.5
20240713,6호선,신내,2,0,2,1
20240713,7호선,장암,2320,1596,3916,1958
20240713,7호선,도봉산,6984,9438,16422,8211
20240713,7호선,수락산,11521,11193,22714,11357
20240713,7호선,마들,10140,9442,19582,9791
20240713,7호선,노원,22627,23280,45907,22953.5
20240713,7호선,중계,10814,9750,20564,10282
20240713,7호선,하계,13685,12359,26044,13022
20240713,7호선,공릉(서울과학기술대),9733,9286,19019,9509.5
20240713,7호선,태릉입구,7757,6864,14621,7310.5
20240713,7호선,먹골,8498,8160,16658,8329
20240713,7호선,중화,8327,7845,16172,8086
20240713,7호선,상봉,15653,15282,30935,15467.5
20240713,7호선,면목,11576,10987,22563,11281.5
20240713,7호선,사가정,13478,12920,26398,13199
20240713,7호선,용마산(용마폭포공원),4548,4586,9134,4567
20240713,7호선,중곡,7918,7193,15111,7555.5
20240713,7호선,군자(능동),12751,9398,22149,11074.5
20240713,7호선,어린이대공원(세종대),11577,10844,22421,11210.5
20240713,7호선,건대입구,12649,12721,25370,12685
20240713,7호선,자양(뚝섬한강공원),11571,11147,22718,11359
20240713,7호선,청담,12339,13244,25583,12791.5
20240713,7호선,강남구청,10030,11504,21534,10767
20240713,7호선,학동,12220,12660,24880,12440
20240713,7호선,논현,11545,12538,24083,12041.5
20240713,7호선,반포,5661,5308,10969,5484.5
20240713,7호선,고속터미널,17049,13117,30166,15083
20240713,7호선,내방,9018,8787,17805,8902.5
20240713,7호선,이수,14101,13476,27577,13788.5
20240713,7호선,남성,8925,8017,16942,8471
20240713,7호선,숭실대입구(살피재),9152,8860,18012,9006
20240713,7호선,상도,9039,8013,17052,8526
20240713,7호선,장승배기,7389,6913,14302,7151
20240713,7호선,신대방삼거리,11554,10717,22271,11135.5
20240713,7호선,보라매,5304,5334,10638,5319
20240713,7호선,신풍,8750,8090,16840,8420
20240713,7호선,대림(구로구청),8628,9377,18005,9002.5
20240713,7호선,남구로,8749,9180,17929,8964.5
20240713,7호선,가산디지털단지,15267,13684,28951,14475.5
20240713,7호선,철산,17542,17452,34994,17497
20240713,7호선,광명사거리,17339,17104,34443,17221.5
20240713,7호선,천왕,7920,7437,15357,7678.5
20240713,7호선,온수(성공회대입구),6056,5999,12055,6027.5
20240713,8호선,암사,14080,12843,26923,13461.5
20240713,8호선,천호(풍납토성),13390,15510,28900,14450
20240713,8호선,강동구청,6837,6715,13552,6776
20240713,8호선,몽촌토성(평화의문),5259,5267,10526,5263
20240713,8호선,잠실(송파구청),16854,19783,36637,18318.5
20240713,8호선,석촌,6882,8671,15553,7776.5
20240713,8호선,송파,7134,6814,13948,6974
20240713,8호선,가락시장,6117,6159,12276,6138
20240713,8호선,문정,10521,10734,21255,10627.5
20240713,8호선,장지,14138,12699,26837,13418.5
20240713,8호선,복정,6688,5514,12202,6101
20240713,8호선,산성,5186,5393,10579,5289.5
20240713,8호선,남한산성입구(성남법원.검찰청),9820,8525,18345,9172.5
20240713,8호선,단대오거리,9193,8524,17717,8858.5
20240713,8호선,신흥,4498,4603,9101,4550.5
20240713,8호선,수진,4598,4107,8705,4352.5
20240713,8호선,모란,4276,3667,7943,3971.5
20240713,8호선,남위례,5203,5157,10360,5180
20240713,9호선,개화,1621,1299,2920,1460
20240713,9호선,김포공항,7587,11521,19108,9554
20240713,9호선,공항시장,2574,2691,5265,2632.5
20240713,9호선,신방화,5618,5150,10768,5384
20240713,9호선,마곡나루(서울식물원),10134,9673,19807,9903.5
20240713,9호선,양천향교,6926,6341,13267,6633.5
20240713,9호선,가양,15978,15337,31315,15657.5
20240713,9호선,증미,4094,3754,7848,3924
20240713,9호선,등촌,8563,8027,16590,8295
20240713,9호선,염창,13620,12304,25924,12962
20240713,9호선,신목동,2845,2372,5217,2608.5
20240713,9호선,선유도,4576,4365,8941,4470.5
20240713,9호선,당산,15130,13879,29009,14504.5
20240713,9호선,국회의사당,7050,7127,14177,7088.5
20240713,9호선,여의도,16473,15724,32197,16098.5
20240713,9호선,샛강,3481,3364,6845,3422.5
20240713,9호선,노량진,23165,22312,45477,22738.5
20240713,9호선,노들,3950,3287,7237,3618.5
20240713,9호선,흑석(중앙대입구),6534,6449,12983,6491.5
20240713,9호선,동작(현충원),1477,1435,2912,1456
20240713,9호선,구반포,867,837,1704,852
20240713,9호선,신반포,3441,3371,6812,3406
20240713,9호선,고속터미널,17878,26371,44249,22124.5
20240713,9호선,사평,3129,2880,6009,3004.5
20240713,9호선,신논현,29644,30636,60280,30140
20240713,9호선2~3단계,언주,7420,7257,14677,7338.5
20240713,9호선2~3단계,선정릉,5263,5813,11076,5538
20240713,9호선2~3단계,삼성중앙,3891,3798,7689,3844.5
20240713,9호선2~3단계,봉은사,18975,19701,38676,19338
20240713,9호선2~3단계,종합운동장,6542,5465,12007,6003.5
20240713,9호선2~3단계,삼전,6062,5491,11553,5776.5
20240713,9호선2~3단계,석촌고분,5628,5428,11056,5528
20240713,9호선2~3단계,석촌,8940,7623,16563,8281.5
20240713,9호선2~3단계,송파나루,5305,5883,11188,5594
20240713,9호선2~3단계,한성백제,2599,2207,4806,2403
20240713,9호선2~3단계,올림픽공원(한국체대),11680,11589,23269,11634.5
20240713,9호선2~3단계,둔촌오륜,947,1004,1951,975.5
20240713,9호선2~3단계,중앙보훈병원,6657,6146,12803,6401.5
20240713,경강선,판교,4146,3868,8014,4007
20240713,경강선,이매,923,693,1616,808
20240713,경강선,삼동,1828,1610,3438,1719
20240713,경강선,경기광주,6431,6033,12464,6232
20240713,경강선,초월,2755,2453,5208,2604
20240713,경강선,곤지암,2233,2195,4428,2214
20240713,경강선,신둔도예촌,1373,1295,2668,1334
20240713,경강선,이천,3621,3773,7394,3697
20240713,경강선,부발,2349,2242,4591,2295.5
20240713,경강선,세종대왕릉,385,437,822,411
20240713,경강선,여주,3228,3544,6772,3386
20240713,경강선,성남,861,783,1644,822
20240713,경부선,서울역,11099,3960,15059,7529.5
20240713,경부선,남영,6708,7165,13873,6936.5
20240713,경부선,용산,49761,53020,102781,51390.5
20240713,경부선,노량진,8606,7988,16594,8297
20240713,경부선,대방,6788,7262,14050,7025
20240713,경부선,영등포,48395,50510,98905,49452.5
20240713,경부선,신도림,3345,4239,7584,3792
20240713,경부선,신길,6883,5834,12717,6358.5
20240713,경부선,구로,14789,15738,30527,15263.5
20240713,경부선,가산디지털단지,7020,8791,15811,7905.5
20240713,경부선,금천구청,8772,8690,17462,8731
20240713,경부선,석수,7177,6709,13886,6943
20240713,경부선,관악,6422,6231,12653,6326.5
20240713,경부선,안양,19714,19455,39169,19584.5
20240713,경부선,명학,5304,5019,10323,5161.5
20240713,경부선,금정,22286,21847,44133,22066.5
20240713,경부선,군포,4581,4292,8873,4436.5
20240713,경부선,의왕,6635,6511,13146,6573
20240713,경부선,성균관대,12406,12116,24522,12261
20240713,경부선,화서,13858,13828,27686,13843
20240713,경부선,수원,45602,49532,95134,47567
20240713,경부선,독산,10343,9905,20248,10124
20240713,경부선,세류,3362,3313,6675,3337.5
20240713,경부선,병점,14728,14237,28965,14482.5
20240713,경부선,세마,3045,2688,5733,2866.5
20240713,경부선,오산대,3545,3139,6684,3342
20240713,경부선,오산,11244,10654,21898,10949
20240713,경부선,진위,1318,1149,2467,1233.5
20240713,경부선,송탄,5695,5020,10715,5357.5
20240713,경부선,서정리,8981,7744,16725,8362.5
20240713,경부선,평택지제,4321,4073,8394,4197
20240713,경부선,평택,16343,15563,31906,15953
20240713,경부선,성환,3761,3389,7150,3575
20240713,경부선,직산,1008,959,1967,983.5
20240713,경부선,두정,7421,7233,14654,7327
20240713,경부선,천안,7964,8277,16241,8120.5
20240713,경부선,당정,4492,4100,8592,4296
20240713,경부선,서동탄,1230,1261,2491,1245.5
20240713,경부선,광명,3517,3066,6583,3291.5
20240713,경원선,이촌(국립중앙박물관),3602,2807,6409,3204.5
20240713,경원선,서빙고,1814,1771,3585,1792.5
20240713,경원선,한남,2787,2750,5537,2768.5
20240713,경원선,옥수,40,55,95,47.5
20240713,경원선,응봉,1614,1410,3024,1512
20240713,경원선,왕십리(성동구청),17145,17212,34357,17178.5
20240713,경원선,청량리(서울시립대입구),19755,21504,41259,20629.5
20240713,경원선,외대앞,8463,7834,16297,8148.5
20240713,경원선,신이문,6912,6128,13040,6520
20240713,경원선,석계,6919,7117,14036,7018
20240713,경원선,광운대,6130,5926,12056,6028
20240713,경원선,월계,5191,4546,9737,4868.5
20240713,경원선,녹천,3530,2968,6498,3249
20240713,경원선,창동,10,0,10,5
20240713,경원선,방학,8346,8145,16491,8245.5
20240713,경원선,도봉,5045,4706,9751,4875.5
20240713,경원선,도봉산,9590,6696,16286,8143
20240713,경원선,망월사,6180,6289,12469,6234.5
20240713,경원선,회룡,11198,10969,22167,11083.5
20240713,경원선,의정부,19164,20288,39452,19726
20240713,경원선,가능,5656,5220,10876,5438
20240713,경원선,녹양,3766,3581,7347,3673.5
20240713,경원선,양주,7204,6532,13736,6868
20240713,경원선,덕계,5002,4717,9719,4859.5
20240713,경원선,덕정,5308,4699,10007,5003.5
20240713,경원선,지행,6645,6424,13069,6534.5
20240713,경원선,동두천중앙,2790,2765,5555,2777.5
20240713,경원선,보산,1667,1637,3304,1652
20240713,경원선,동두천,1748,1596,3344,1672
20240713,경원선,소요산,3283,3231,6514,3257
20240713,경원선,청산,172,143,315,157.5
20240713,경원선,전곡,1666,1395,3061,1530.5
20240713,경원선,연천,1710,1621,3331,1665.5
20240713,경의선,서울역,1733,1800,3533,1766.5
20240713,경의선,신촌,406,485,891,445.5
20240713,경의선,효창공원앞,2176,2448,4624,2312
20240713,경의선,공덕,3612,2746,6358,3179
20240713,경의선,서강대,2064,1968,4032,2016
20240713,경의선,홍대입구,3066,3703,6769,3384.5
20240713,경의선,가좌,4621,4421,9042,4521
20240713,경의선,디지털미디어시티,2488,2300,4788,2394
20240713,경의선,수색,2294,2241,4535,2267.5
20240713,경의선,한국항공대,1386,1267,2653,1326.5
20240713,경의선,강매,2166,1975,4141,2070.5
20240713,경의선,행신,6189,6486,12675,6337.5
20240713,경의선,능곡,3925,3854,7779,3889.5
20240713,경의선,곡산,483,494,977,488.5
20240713,경의선,백마,5644,5193,10837,5418.5
20240713,경의선,풍산,5676,5373,11049,5524.5
20240713,경의선,일산,9505,8982,18487,9243.5
20240713,경의선,탄현,6569,6078,12647,6323.5
20240713,경의선,야당,8385,8703,17088,8544
20240713,경의선,운정,6389,5722,12111,6055.5
20240713,경의선,금릉,4910,4724,9634,4817
20240713,경의선,금촌,6682,6179,12861,6430.5
20240713,경의선,월롱,1250,1139,2389,1194.5
20240713,경의선,파주,1187,857,2044,1022
20240713,경의선,문산,6060,5441,11501,5750.5
20240713,경의선,임진강,89,84,173,86.5
20240713,경의선,운천,9,14,23,11.5
20240713,경인선,개봉,18173,17436,35609,17804.5
20240713,경인선,오류동,9904,8957,18861,9430.5
20240713,경인선,역곡,21178,20963,42141,21070.5
20240713,경인선,부천,30947,31730,62677,31338.5
20240713,경인선,송내,20115,19414,39529,19764.5
20240713,경인선,부평,30202,33250,63452,31726
20240713,경인선,백운,6359,6182,12541,6270.5
20240713,경인선,동암,14202,14166,28368,14184
20240713,경인선,주안,18158,15755,33913,16956.5
20240713,경인선,제물포,8391,7970,16361,8180.5
20240713,경인선,동인천,13099,12894,25993,12996.5
20240713,경인선,인천,4750,4064,8814,4407
20240713,경인선,구일,5086,4943,10029,5014.5
20240713,경인선,소사,6580,6308,12888,6444
20240713,경인선,부개,6972,6586,13558,6779
20240713,경인선,간석,4943,4597,9540,4770
20240713,경인선,도원,2415,2494,4909,2454.5
20240713,경인선,온수(성공회대입구),5178,4736,9914,4957
20240713,경인선,중동,7475,6946,14421,7210.5
20240713,경인선,도화,3724,3367,7091,3545.5
20240713,경춘선,신내,1880,1753,3633,1816.5
20240713,경춘선,갈매,2161,1913,4074,2037
20240713,경춘선,별내,2681,2555,5236,2618
20240713,경춘선,퇴계원,2751,2571,5322,2661
20240713,경춘선,사릉,1707,1581,3288,1644
20240713,경춘선,금곡,1176,1066,2242,1121
20240713,경춘선,평내호평,4875,4737,9612,4806
20240713,경춘선,천마산,1288,1260,2548,1274
20240713,경춘선,마석,3984,3833,7817,3908.5
20240713,경춘선,대성리,1169,1271,2440,1220
20240713,경춘선,청평,2373,2603,4976,2488
20240713,경춘선,상천,459,435,894,447
20240713,경춘선,가평,2831,3744,6575,3287.5
20240713,경춘선,굴봉산,200,195,395,197.5
20240713,경춘선,백양리,126,106,232,116
20240713,경춘선,강촌,686,827,1513,756.5
20240713,경춘선,김유정,510,603,1113,556.5
20240713,경춘선,남춘천,3231,3407,6638,3319
20240713,경춘선,춘천,1997,1758,3755,1877.5
20240713,공항철도 1호선,서울역,14722,14308,29030,14515
20240713,공항철도 1호선,공덕,2447,3476,5923,2961.5
20240713,공항철도 1호선,홍대입구,20341,19947,40288,20144
20240713,공항철도 1호선,디지털미디어시티,7837,7170,15007,7503.5
20240713,공항철도 1호선,마곡나루(서울식물원),4597,5073,9670,4835
20240713,공항철도 1호선,김포공항,9185,4914,14099,7049.5
20240713,공항철도 1호선,계양,10645,9655,20300,10150
20240713,공항철도 1호선,검암,5180,5309,10489,5244.5
20240713,공항철도 1호선,청라국제도시,5873,5518,11391,5695.5
20240714,3호선,종로3가,6025,7042,13067,6533.5
20240714,중앙선,양수,2867,2640,5507,2753.5
20240714,중앙선,운길산,835,799,1634,817
20240714,중앙선,팔당,1207,1111,2318,1159
20240714,중앙선,도심,1325,1166,2491,1245.5
20240714,중앙선,덕소,3641,3644,7285,3642.5
20240714,중앙선,양정,386,298,684,342
20240714,중앙선,도농,5834,5734,11568,5784
20240714,중앙선,구리,8054,8243,16297,8148.5
20240714,중앙선,양원,1578,1644,3222,1611
20240714,중앙선,망우,5114,5140,10254,5127
20240714,중앙선,상봉,4041,4191,8232,4116
20240714,중앙선,중랑,3743,3543,7286,3643
20240714,중앙선,회기,16682,16262,32944,16472
20240714,장항선,신창(순천향대),1006,1148,2154,1077
20240714,장항선,온양온천,5574,5704,11278,5639
20240714,장항선,배방,1094,1258,2352,1176
20240714,장항선,탕정,1288,1390,2678,1339
20240714,수인선,인천,1238,1729,2967,1483.5
20240714,수인선,신포,1283,1295,2578,1289
20240714,수인선,숭의,2263,2050,4313,2156.5
20240714,수인선,인하대,3875,3765,7640,3820
20240714,수인선,송도,1575,1610,3185,1592.5
20240714,수인선,연수,3879,3779,7658,3829
20240714,수인선,원인재,2974,3067,6041,3020.5
20240714,수인선,남동인더스파크,691,726,1417,708.5
20240714,수인선,호구포,2270,2370,4640,2320
20240714,수인선,인천논현,3389,3564,6953,3476.5
20240714,수인선,소래포구,3741,3544,7285,3642.5
20240714,수인선,월곶,2048,1862,3910,1955
20240714,수인선,달월,47,38,85,42.5
20240714,수인선,사리,3072,2673,5745,2872.5
20240714,수인선,야목,297,258,555,277.5
20240714,수인선,어천,1064,1311,2375,1187.5
20240714,수인선,오목천,2381,2248,4629,2314.5
20240714,수인선,고색,2282,2305,4587,2293.5
20240714,서해선,부천종합운동장,1379,1153,2532,1266
20240714,서해선,원종,3166,3214,6380,3190
20240714,서해선,김포공항,2924,3449,6373,3186.5
20240714,분당선,매교,2741,2689,5430,2715
20240714,분당선,수원시청,8572,8444,17016,8508
20240714,분당선,매탄권선,3100,3027,6127,3063.5
20240714,분당선,망포,7134,7776,14910,7455
20240714,분당선,영통,5582,5468,11050,5525
20240714,분당선,청명,2467,2681,5148,2574
20240714,분당선,상갈,3035,3169,6204,3102
20240714,분당선,기흥,5606,5330,10936,5468
20240714,분당선,신갈,2291,2309,4600,2300
20240714,분당선,구성,3736,3766,7502,3751
20240714,분당선,죽전,7659,8860,16519,8259.5
20240714,분당선,보정,1297,1300,2597,1298.5
20240714,분당선,이매,3810,3942,7752,3876
20240714,분당선,오리,5781,5083,10864,5432
20240714,분당선,미금,8245,8712,16957,8478.5
20240714,분당선,정자,8022,8250,16272,8136
20240714,분당선,수내,6681,6516,13197,6598.5
20240714,분당선,서현,15630,15575,31205,15602.5
20240714,분당선,야탑,14546,14696,29242,14621
20240714,분당선,모란,18206,19179,37385,18692.5
20240714,분당선,태평,8730,8381,17111,8555.5
20240714,분당선,가천대,4411,4822,9233,4616.5
20240714,분당선,선정릉,2368,2369,4737,2368.5
20240714,분당선,강남구청,3219,3779,6998,3499
20240714,분당선,압구정로데오,11711,12296,24007,12003.5
20240714,분당선,서울숲,8385,8155,16540,8270
20240714,분당선,수원,6501,5883,12384,6192
20240714,분당선,복정,4,0,4,2
20240714,분당선,수서,11435,11427,22862,11431
20240714,분당선,대모산입구,3196,3204,6400,3200
20240714,분당선,개포동,2823,2882,5705,2852.5
20240714,분당선,구룡,1943,2142,4085,2042.5
20240714,분당선,도곡,3416,3357,6773,3386.5
20240714,분당선,한티,11736,11068,22804,11402
20240714,분당선,선릉,3381,5053,8434,4217
20240714,과천선,범계,17093,16653,33746,16873
20240714,과천선,평촌,6853,6614,13467,6733.5
20240714,과천선,인덕원,13617,13817,27434,13717
20240714,과천선,정부과천청사,5557,5615,11172,5586
20240714,과천선,과천,4301,3966,8267,4133.5
20240714,과천선,대공원,6004,6467,12471,6235.5
20240714,과천선,경마공원,13820,13959,27779,13889.5
20240714,과천선,선바위,4006,3431,7437,3718.5
20240714,공항철도 1호선,영종,3311,3310,6621,3310.5
20240714,공항철도 1호선,인천공항2터미널,6677,5941,12618,6309
20240714,공항철도 1호선,인천공항1터미널,15571,15189,30760,15380
20240714,공항철도 1호선,공항화물청사,937,1046,1983,991.5
20240714,공항철도 1호선,운서,7965,8787,16752,8376
20240714,공항철도 1호선,청라국제도시,4336,4385,8721,4360.5
20240714,공항철도 1호선,검암,3689,3899,7588,3794
20240714,공항철도 1호선,계양,7474,7265,14739,7369.5
20240714,공항철도 1호선,김포공항,8748,4969,13717,6858.5
20240714,공항철도 1호선,마곡나루(서울식물원),2806,3247,6053,3026.5
20240714,공항철도 1호선,디지털미디어시티,4161,4243,8404,4202
20240714,공항철도 1호선,홍대입구,17321,15520,32841,16420.5
20240714,공항철도 1호선,공덕,1810,2551,4361,2180.5
20240714,공항철도 1호선,서울역,14463,12626,27089,13544.5
20240714,경춘선,춘천,1838,1390,3228,1614
20240714,경춘선,남춘천,2751,2809,5560,2780
20240714,경춘선,김유정,504,450,954,477
20240714,경춘선,강촌,902,518,1420,710
20240714,경춘선,백양리,132,118,250,125
20240714,경춘선,굴봉산,178,120,298,149
20240714,경춘선,가평,3254,2246,5500,2750
20240714,경춘선,상천,390,315,705,352.5
20240714,경춘선,청평,2444,1785,4229,2114.5
20240714,경춘선,대성리,1177,582,1759,879.5
20240714,경춘선,마석,2736,2719,5455,2727.5
20240714,경춘선,천마산,1087,1070,2157,1078.5
20240714,경춘선,평내호평,3590,3489,7079,3539.5
20240714,경춘선,금곡,951,866,1817,908.5
20240714,경춘선,사릉,1278,1215,2493,1246.5
20240714,경춘선,퇴계원,2171,2160,4331,2165.5
20240714,경춘선,별내,1993,1877,3870,1935
20240714,경춘선,갈매,1506,1377,2883,1441.5
20240714,경춘선,신내,1341,1257,2598,1299
20240714,경인선,도화,2672,2459,5131,2565.5
20240714,경인선,중동,5512,5115,10627,5313.5
20240714,경인선,온수(성공회대입구),4258,3824,8082,4041
20240714,경인선,도원,1830,1906,3736,1868
20240714,경인선,간석,3711,3488,7199,3599.5
20240714,경인선,부개,5322,5066,10388,5194
20240714,경인선,소사,5244,4987,10231,5115.5
20240714,경인선,구일,9651,10575,20226,10113
20240714,경인선,인천,3906,3252,7158,3579
20240714,경인선,동인천,9927,9793,19720,9860
20240714,경인선,제물포,5790,5629,11419,5709.5
20240714,경인선,주안,12804,11157,23961,11980.5
20240714,경인선,동암,10665,10315,20980,10490
20240714,경인선,백운,4709,4613,9322,4661
20240714,경인선,부평,23809,23523,47332,23666
20240714,경인선,송내,14360,14074,28434,14217
20240714,경인선,부천,23279,22916,46195,23097.5
20240714,경인선,역곡,15131,14963,30094,15047
20240714,경인선,오류동,7508,7135,14643,7321.5
20240714,경인선,개봉,13262,12914,26176,13088
20240714,경의선,운천,11,7,18,9
20240714,경의선,임진강,79,58,137,68.5
20240714,경의선,문산,4499,5044,9543,4771.5
20240714,경의선,파주,765,769,1534,767
20240714,경의선,월롱,969,1328,2297,1148.5
20240714,경의선,금촌,4808,5242,10050,5025
20240714,경의선,금릉,3582,3464,7046,3523
20240714,경의선,운정,4423,4245,8668,4334
20240714,경의선,야당,6277,6270,12547,6273.5
20240714,경의선,탄현,4686,4533,9219,4609.5
20240714,경의선,일산,6287,5860,12147,6073.5
20240714,경의선,풍산,4342,4076,8418,4209
20240714,경의선,백마,4091,4114,8205,4102.5
20240714,경의선,곡산,426,411,837,418.5
20240714,경의선,능곡,2955,2875,5830,2915
20240714,경의선,행신,4963,4829,9792,4896
20240714,경의선,강매,1620,1511,3131,1565.5
20240714,경의선,한국항공대,982,1038,2020,1010
20240714,경의선,수색,1369,1418,2787,1393.5
20240714,경의선,디지털미디어시티,1752,1512,3264,1632
20240714,경의선,가좌,3465,3411,6876,3438
20240714,경의선,홍대입구,2453,3001,5454,2727
20240714,경의선,서강대,1509,1575,3084,1542
20240714,경의선,공덕,2413,1858,4271,2135.5
20240714,경의선,효창공원앞,1500,1915,3415,1707.5
20240714,경의선,신촌,362,378,740,370
20240714,경의선,서울역,1323,1190,2513,1256.5
20240714,경원선,연천,1271,1411,2682,1341
20240714,경원선,전곡,1320,1308,2628,1314
20240714,경원선,청산,175,141,316,158
20240714,경원선,소요산,2927,2901,5828,2914
20240714,경원선,동두천,1234,1399,2633,1316.5
20240714,경원선,보산,1305,1430,2735,1367.5
20240714,경원선,동두천중앙,2226,2124,4350,2175
20240714,경원선,지행,4901,5260,10161,5080.5
20240714,경원선,덕정,3796,3979,7775,3887.5
20240714,경원선,덕계,3738,3465,7203,3601.5
20240714,경원선,양주,5385,5388,10773,5386.5
20240714,경원선,녹양,2835,2646,5481,2740.5
20240714,경원선,가능,4181,3989,8170,4085
20240714,경원선,의정부,15055,15112,30167,15083.5
20240714,경원선,회룡,8463,8237,16700,8350
20240714,경원선,망월사,5567,5553,11120,5560
20240714,경원선,도봉산,8649,5879,14528,7264
20240714,경원선,도봉,3760,3606,7366,3683
20240714,경원선,방학,6601,6256,12857,6428.5
20240714,경원선,창동,3,0,3,1.5
20240714,경원선,녹천,2729,2455,5184,2592
20240714,경원선,월계,3874,3521,7395,3697.5
20240714,경원선,광운대,4866,4769,9635,4817.5
20240714,경원선,석계,5040,5550,10590,5295
20240714,경원선,신이문,5104,4963,10067,5033.5
20240714,경원선,외대앞,5736,5423,11159,5579.5
20240714,경원선,청량리(서울시립대입구),17165,15825,32990,16495
20240714,경원선,왕십리(성동구청),12013,12055,24068,12034
20240714,경원선,응봉,1214,1118,2332,1166
20240714,경원선,옥수,52,21,73,36.5
20240714,경원선,한남,1725,1754,3479,1739.5
20240714,경원선,서빙고,2218,2369,4587,2293.5
20240714,경원선,이촌(국립중앙박물관),2907,2272,5179,2589.5
20240714,경부선,광명,3511,2369,5880,2940
20240714,경부선,서동탄,881,949,1830,915
20240714,경부선,당정,3231,3150,6381,3190.5
20240714,경부선,천안,7480,7183,14663,7331.5
20240714,경부선,두정,6124,6679,12803,6401.5
20240714,경부선,직산,795,934,1729,864.5
20240714,경부선,성환,3312,3737,7049,3524.5
20240714,경부선,평택,13612,14478,28090,14045
20240714,경부선,평택지제,3536,3278,6814,3407
20240714,경부선,서정리,5744,7446,13190,6595
20240714,경부선,송탄,3938,4474,8412,4206
20240714,경부선,진위,1102,1118,2220,1110
20240714,경부선,오산,8906,9473,18379,9189.5
20240714,경부선,오산대,2745,2545,5290,2645
20240714,경부선,세마,2195,2188,4383,2191.5
20240714,경부선,병점,10495,11631,22126,11063
20240714,경부선,세류,2594,2460,5054,2527
20240714,경부선,독산,6895,7055,13950,6975
20240714,경부선,수원,39671,38357,78028,39014
20240714,경부선,화서,10497,10118,20615,10307.5
20240714,경부선,성균관대,8981,9331,18312,9156
20240714,경부선,의왕,4610,4590,9200,4600
20240714,경부선,군포,3136,3055,6191,3095.5
20240714,경부선,금정,16222,16709,32931,16465.5
20240714,경부선,명학,3475,3410,6885,3442.5
20240714,경부선,안양,14460,13950,28410,14205
20240714,경부선,관악,5470,4971,10441,5220.5
20240714,경부선,석수,5275,5055,10330,5165
20240714,경부선,금천구청,6417,6382,12799,6399.5
20240714,경부선,가산디지털단지,5302,6965,12267,6133.5
20240714,경부선,구로,11765,11879,23644,11822
20240714,경부선,신길,4953,4466,9419,4709.5
20240714,경부선,신도림,2810,3140,5950,2975
20240714,경부선,영등포,38211,36891,75102,37551
20240714,경부선,대방,5345,6190,11535,5767.5
20240714,경부선,노량진,5905,5587,11492,5746
20240714,경부선,용산,44239,39685,83924,41962
20240714,경부선,남영,5726,6038,11764,5882
20240714,경부선,서울역,11688,3453,15141,7570.5
20240714,경강선,성남,622,584,1206,603
20240714,경강선,여주,2890,2713,5603,2801.5
20240714,경강선,세종대왕릉,400,358,758,379
20240714,경강선,부발,1651,2222,3873,1936.5
20240714,경강선,이천,2582,2865,5447,2723.5
20240714,경강선,신둔도예촌,1039,1052,2091,1045.5
20240714,경강선,곤지암,1859,1996,3855,1927.5
20240714,경강선,초월,1969,1965,3934,1967
20240714,경강선,경기광주,4680,4778,9458,4729
20240714,경강선,삼동,1251,1270,2521,1260.5
20240714,경강선,이매,824,597,1421,710.5
20240714,경강선,판교,3295,2798,6093,3046.5
20240714,9호선2~3단계,중앙보훈병원,4999,4771,9770,4885
20240714,9호선2~3단계,둔촌오륜,881,832,1713,856.5
20240714,9호선2~3단계,올림픽공원(한국체대),10876,10678,21554,10777
20240714,9호선2~3단계,한성백제,2031,1772,3803,1901.5
20240714,9호선2~3단계,송파나루,3994,4495,8489,4244.5
20240714,9호선2~3단계,석촌,6256,5361,11617,5808.5
20240714,9호선2~3단계,석촌고분,4065,4062,8127,4063.5
20240714,9호선2~3단계,삼전,4291,4254,8545,4272.5
20240714,9호선2~3단계,종합운동장,6149,4687,10836,5418
20240714,9호선2~3단계,봉은사,15717,16138,31855,15927.5
20240714,9호선2~3단계,삼성중앙,2629,2607,5236,2618
20240714,9호선2~3단계,선정릉,3692,4075,7767,3883.5
20240714,9호선2~3단계,언주,4558,4617,9175,4587.5
20240714,9호선,신논현,18898,18681,37579,18789.5
20240714,9호선,사평,2091,2148,4239,2119.5
20240714,9호선,고속터미널,14471,20999,35470,17735
20240714,9호선,신반포,2776,2816,5592,2796
20240714,9호선,구반포,401,439,840,420
20240714,9호선,동작(현충원),1220,1086,2306,1153
20240714,9호선,흑석(중앙대입구),4475,4521,8996,4498
20240714,9호선,노들,3291,2825,6116,3058
20240714,9호선,노량진,15679,16698,32377,16188.5
20240714,9호선,샛강,2350,2396,4746,2373
20240714,9호선,여의도,11868,10768,22636,11318
20240714,9호선,국회의사당,6680,6287,12967,6483.5
20240714,9호선,당산,10722,10716,21438,10719
20240714,9호선,선유도,3414,3376,6790,3395
20240714,9호선,신목동,2280,1987,4267,2133.5
20240714,9호선,염창,9965,9775,19740,9870
20240714,9호선,등촌,5904,6017,11921,5960.5
20240714,9호선,증미,3144,3025,6169,3084.5
20240714,9호선,가양,13288,12854,26142,13071
20240714,9호선,양천향교,4764,5004,9768,4884
20240714,9호선,마곡나루(서울식물원),6726,6684,13410,6705
20240714,9호선,신방화,4091,4119,8210,4105
20240714,9호선,공항시장,1962,2169,4131,2065.5
20240714,9호선,김포공항,6249,9771,16020,8010
20240714,9호선,개화,1182,1133,2315,1157.5
20240714,8호선,남위례,3688,3700,7388,3694
20240714,8호선,모란,4958,4033,8991,4495.5
20240714,8호선,수진,3901,3643,7544,3772
20240714,8호선,신흥,3362,3521,6883,3441.5
20240714,8호선,단대오거리,6459,6332,12791,6395.5
20240714,8호선,남한산성입구(성남법원.검찰청),7074,6465,13539,6769.5
20240714,8호선,산성,3750,3994,7744,3872
20240714,8호선,복정,5609,5188,10797,5398.5
20240714,8호선,장지,9661,9233,18894,9447
20240714,8호선,문정,6664,6912,13576,6788
20240714,8호선,가락시장,3365,4191,7556,3778
20240714,8호선,송파,5012,5095,10107,5053.5
20240714,8호선,석촌,4753,5944,10697,5348.5
20240714,8호선,잠실(송파구청),13156,14344,27500,13750
20240714,8호선,몽촌토성(평화의문),3810,3801,7611,3805.5
20240714,8호선,강동구청,4983,5152,10135,5067.5
20240714,8호선,천호(풍납토성),9576,10898,20474,10237
20240714,8호선,암사,9894,9322,19216,9608
20240714,7호선,온수(성공회대입구),4305,4479,8784,4392
20240714,7호선,천왕,5508,5411,10919,5459.5
20240714,7호선,광명사거리,12539,12547,25086,12543
20240714,7호선,철산,11490,11386,22876,11438
20240714,7호선,가산디지털단지,10747,10038,20785,10392.5
20240714,7호선,남구로,7331,7382,14713,7356.5
20240714,7호선,대림(구로구청),9697,9065,18762,9381
20240714,7호선,신풍,6659,6184,12843,6421.5
20240714,7호선,보라매,3929,4029,7958,3979
20240714,7호선,신대방삼거리,8254,8202,16456,8228
20240714,7호선,장승배기,4825,5010,9835,4917.5
20240714,7호선,상도,6390,6385,12775,6387.5
20240714,7호선,숭실대입구(살피재),6607,6829,13436,6718
20240714,7호선,남성,6511,6428,12939,6469.5
20240714,7호선,이수,9617,9340,18957,9478.5
20240714,7호선,내방,5804,6030,11834,5917
20240714,7호선,고속터미널,15071,9628,24699,12349.5
20240714,7호선,반포,3543,3421,6964,3482
20240714,7호선,논현,6558,6974,13532,6766
20240714,7호선,학동,7703,8290,15993,7996.5
20240714,7호선,강남구청,5439,5958,11397,5698.5
20240714,7호선,청담,6961,7343,14304,7152
20240714,7호선,자양(뚝섬한강공원),8795,8232,17027,8513.5
20240714,7호선,건대입구,8180,8444,16624,8312
20240714,7호선,어린이대공원(세종대),8628,8613,17241,8620.5
20240714,7호선,군자(능동),9344,7067,16411,8205.5
20240714,7호선,중곡,5791,5672,11463,5731.5
20240714,7호선,용마산(용마폭포공원),3349,3635,6984,3492
20240714,7호선,사가정,9622,9357,18979,9489.5
20240714,7호선,면목,8337,8058,16395,8197.5
20240714,7호선,상봉,10790,10111,20901,10450.5
20240714,7호선,중화,6058,5912,11970,5985
20240714,7호선,먹골,5823,5848,11671,5835.5
20240714,7호선,태릉입구,5757,5461,11218,5609
20240714,7호선,공릉(서울과학기술대),7081,7058,14139,7069.5
20240714,7호선,하계,10203,9709,19912,9956
20240714,7호선,중계,8443,7887,16330,8165
20240714,7호선,노원,15986,16098,32084,16042
20240714,7호선,마들,6706,6269,12975,6487.5
20240714,7호선,수락산,9093,8788,17881,8940.5
20240714,7호선,도봉산,5376,7812,13188,6594
20240714,7호선,장암,2030,1423,3453,1726.5
20240714,6호선,봉화산(서울의료원),4396,4277,8673,4336.5
20240714,6호선,화랑대(서울여대입구),5961,4981,10942,5471
20240714,6호선,태릉입구,3659,3962,7621,3810.5
20240714,6호선,석계,7113,7314,14427,7213.5
20240714,6호선,돌곶이,6643,6256,12899,6449.5
20240714,6호선,상월곡(한국과학기술연구원),3691,3330,7021,3510.5
20240714,6호선,월곡(동덕여대),5709,5627,11336,5668
20240714,6호선,고려대(종암),4619,4517,9136,4568
20240714,6호선,안암(고대병원앞),5727,6053,11780,5890
20240714,6호선,보문,4498,4422,8920,4460
20240714,6호선,창신,1896,1707,3603,1801.5
20240714,6호선,동묘앞,7127,7046,14173,7086.5
20240714,6호선,신당,4891,5278,10169,5084.5
20240714,6호선,청구,2174,1984,4158,2079
20240714,6호선,약수,2031,1924,3955,1977.5
20240714,6호선,버티고개,1236,1350,2586,1293
20240714,6호선,한강진,8599,9749,18348,9174
20240714,6호선,이태원,11667,9925,21592,10796
20240714,6호선,녹사평(용산구청),4418,4262,8680,4340
20240714,6호선,삼각지,5518,4308,9826,4913
20240714,6호선,효창공원앞,3883,3370,7253,3626.5
20240714,6호선,공덕,8212,7859,16071,8035.5
20240714,6호선,대흥(서강대앞),4720,5003,9723,4861.5
20240714,6호선,광흥창(서강),4929,4786,9715,4857.5
20240714,6호선,상수,8451,9258,17709,8854.5
20240714,6호선,합정,10854,9764,20618,10309
20240714,6호선,망원,11421,12134,23555,11777.5
20240714,6호선,마포구청,7835,7263,15098,7549
20240714,6호선,월드컵경기장(성산),3791,3833,7624,3812
20240714,6호선,디지털미디어시티,6179,6708,12887,6443.5
20240714,6호선,증산(명지대앞),5888,5914,11802,5901
20240714,6호선,새절(신사),7192,7108,14300,7150
20240714,6호선,구산,4655,3755,8410,4205
20240714,6호선,연신내,2,0,2,1
20240714,6호선,독바위,1701,1892,3593,1796.5
20240714,6호선,불광,3430,3061,6491,3245.5
20240714,6호선,역촌,2402,2641,5043,2521.5
20240714,6호선,응암,10126,10299,20425,10212.5
20240714,5호선,하남검단산,5355,5310,10665,5332.5
20240714,5호선,하남시청(덕풍·신장),5428,5249,10677,5338.5
20240714,5호선,하남풍산,3033,3099,6132,3066
20240714,5호선,미사,10972,11293,22265,11132.5
20240714,5호선,강일,3447,3136,6583,3291.5
20240714,5호선,마천,4184,4213,8397,4198.5
20240714,5호선,거여,4994,4934,9928,4964
20240714,5호선,개롱,3595,3862,7457,3728.5
20240714,5호선,오금,1757,1598,3355,1677.5
20240714,5호선,방이,5091,4914,10005,5002.5
20240714,5호선,올림픽공원(한국체대),5636,5775,11411,5705.5
20240714,5호선,둔촌동,5804,5685,11489,5744.5
20240714,5호선,상일동,7278,7370,14648,7324
20240714,5호선,고덕,4937,5027,9964,4982
20240714,5호선,명일,5824,5892,11716,5858
20240714,5호선,굽은다리(강동구민회관앞),6288,5930,12218,6109
20240714,5호선,길동,4932,4938,9870,4935
20240714,5호선,강동,10021,10134,20155,10077.5
20240714,5호선,천호(풍납토성),14125,13052,27177,13588.5
20240714,5호선,광나루(장신대),9205,8895,18100,9050
20240714,5호선,아차산(어린이대공원후문),10311,10102,20413,10206.5
20240714,5호선,군자(능동),6893,7763,14656,7328
20240714,5호선,장한평,9709,9585,19294,9647
20240714,5호선,답십리,8220,7613,15833,7916.5
20240714,5호선,마장,3141,3057,6198,3099
20240714,5호선,왕십리(성동구청),2646,3346,5992,2996
20240714,5호선,행당,4402,3997,8399,4199.5
20240714,5호선,신금호,3291,3704,6995,3497.5
20240714,5호선,청구,2082,2017,4099,2049.5
20240714,5호선,동대문역사문화공원(DDP),1320,1589,2909,1454.5
20240714,5호선,을지로4가,2282,2404,4686,2343
20240714,5호선,종로3가,11152,10626,21778,10889
20240714,5호선,광화문(세종문화회관),14601,14967,29568,14784
20240714,5호선,서대문,6109,5922,12031,6015.5
20240714,5호선,충정로(경기대입구),1682,1706,3388,1694
20240714,5호선,애오개,2939,3031,5970,2985
20240714,5호선,공덕,5487,5501,10988,5494
20240714,5호선,마포,6181,6128,12309,6154.5
20240714,5호선,여의나루,11664,13184,24848,12424
20240714,5호선,여의도,10018,10471,20489,10244.5
20240714,5호선,신길,2743,2847,5590,2795
20240714,5호선,영등포시장,6708,7024,13732,6866
20240714,5호선,영등포구청,1843,1754,3597,1798.5
20240714,5호선,양평,2973,2970,5943,2971.5
20240714,5호선,오목교(목동운동장앞),13301,13600,26901,13450.5
20240714,5호선,목동,8502,8765,17267,8633.5
20240714,5호선,신정(은행정),7172,6512,13684,6842
20240714,5호선,까치산,16520,16081,32601,16300.5
20240714,5호선,화곡,15436,14396,29832,14916
20240714,5호선,우장산,7680,7908,15588,7794
20240714,5호선,발산,10832,11472,22304,11152
20240714,5호선,마곡,4689,4821,9510,4755
20240714,5호선,송정,3821,3713,7534,3767
20240714,5호선,김포공항,9277,7129,16406,8203
20240714,5호선,개화산,3228,3188,6416,3208
20240714,5호선,방화,4186,4183,8369,4184.5
20240714,4호선,남태령,926,740,1666,833
20240714,4호선,사당,18252,17391,35643,17821.5
20240714,4호선,총신대입구(이수),11726,12520,24246,12123
20240714,4호선,동작(현충원),1100,1159,2259,1129.5
20240714,4호선,이촌(국립중앙박물관),7207,7606,14813,7406.5
20240714,4호선,신용산,13284,14011,27295,13647.5
20240714,4호선,삼각지,4444,5754,10198,5099
20240714,4호선,숙대입구(갈월),10402,9569,19971,9985.5
20240714,4호선,서울역,6372,16631,23003,11501.5
20240714,4호선,회현(남대문시장),11237,11438,22675,11337.5
20240714,4호선,명동,28846,32101,60947,30473.5
20240714,4호선,충무로,12437,12739,25176,12588
20240714,4호선,동대문역사문화공원(DDP),14807,13069,27876,13938
20240714,4호선,동대문,10256,11245,21501,10750.5
20240714,4호선,혜화,27420,28302,55722,27861
20240714,4호선,한성대입구(삼선교),8868,8867,17735,8867.5
20240714,4호선,성신여대입구(돈암),14627,14145,28772,14386
20240714,4호선,길음,12162,11929,24091,12045.5
20240714,4호선,미아사거리,17024,16422,33446,16723
20240714,4호선,미아(서울사이버대학),8878,8140,17018,8509
20240714,4호선,수유(강북구청),22174,21557,43731,21865.5
20240714,4호선,쌍문,17716,16002,33718,16859
20240714,4호선,창동,17082,17738,34820,17410
20240714,4호선,노원,19297,20666,39963,19981.5
20240714,4호선,상계,11615,10643,22258,11129
20240714,4호선,당고개,6941,6674,13615,6807.5
20240714,3호선,오금,3150,3176,6326,3163
20240714,3호선,경찰병원,3244,3444,6688,3344
20240714,3호선,가락시장,4107,4273,8380,4190
20240714,3호선,수서,11957,11894,23851,11925.5
20240714,3호선,일원,4291,4427,8718,4359
20240714,일산선,대화,7942,7016,14958,7479
20240714,장항선,봉명,708,680,1388,694
20240714,장항선,쌍용(나사렛대),1715,1769,3484,1742
20240714,안산선,신길온천,1594,1461,3055,1527.5
20240714,안산선,정왕,7239,7268,14507,7253.5
20240714,안산선,오이도,6121,5912,12033,6016.5
20240714,안산선,수리산,2425,2245,4670,2335
20240714,우이신설선,북한산우이,4296,4255,8551,4275.5
20240714,우이신설선,솔밭공원,1732,1663,3395,1697.5
20240714,우이신설선,4.19민주묘지,2526,2181,4707,2353.5
20240714,우이신설선,가오리,2744,2570,5314,2657
20240714,우이신설선,화계,2662,2486,5148,2574
20240714,우이신설선,삼양,1282,1309,2591,1295.5
20240714,우이신설선,삼양사거리,1775,1778,3553,1776.5
20240714,우이신설선,솔샘,3317,3053,6370,3185
20240714,우이신설선,북한산보국문,4200,3812,8012,4006
20240714,우이신설선,정릉,3112,2642,5754,2877
20240714,우이신설선,성신여대입구(돈암),2684,3092,5776,2888
20240714,중앙선,신원,194,152,346,173
20240714,중앙선,국수,614,539,1153,576.5
20240714,중앙선,아신,593,438,1031,515.5
20240714,중앙선,오빈,277,239,516,258
20240714,중앙선,양평,2768,2557,5325,2662.5
20240714,중앙선,원덕,340,296,636,318
20240714,중앙선,용문,2377,2078,4455,2227.5
20240714,중앙선,지평,84,56,140,70
20240714,3호선,대청,4987,4901,9888,4944
20240714,3호선,학여울,2228,2374,4602,2301
20240714,3호선,대치,7898,6703,14601,7300.5
20240714,3호선,도곡,2518,2480,4998,2499
20240714,3호선,매봉,4825,4882,9707,4853.5
20240714,3호선,양재(서초구청),14545,16668,31213,15606.5
20240714,3호선,남부터미널(예술의전당),16179,16483,32662,16331
20240714,3호선,교대(법원.검찰청),6605,3309,9914,4957
20240714,3호선,고속터미널,51534,46565,98099,49049.5
20240714,3호선,잠원,2919,2928,5847,2923.5
20240714,3호선,신사,13093,13228,26321,13160.5
20240714,3호선,압구정,16549,17020,33569,16784.5
20240714,3호선,옥수,5490,5805,11295,5647.5
20240714,3호선,금호,4780,4712,9492,4746
20240714,3호선,약수,8035,7673,15708,7854
20240714,3호선,동대입구,8563,9404,17967,8983.5
20240714,3호선,충무로,10,0,10,5
20240714,3호선,을지로3가,5347,5022,10369,5184.5
20240714,3호선,안국,16575,17213,33788,16894
20240714,3호선,독립문,4970,5372,10342,5171
20240714,3호선,무악재,2323,2385,4708,2354
20240714,3호선,홍제,10719,10304,21023,10511.5
20240714,3호선,녹번,7927,7316,15243,7621.5
20240714,3호선,불광,10429,11895,22324,11162
20240714,3호선,연신내,22572,21178,43750,21875
20240714,3호선,구파발,13597,14142,27739,13869.5
20240714,3호선,지축,4261,4222,8483,4241.5
20240714,2호선,용두(동대문구청),1577,1577,3154,1577
20240714,2호선,신정네거리,6287,6301,12588,6294
20240714,2호선,양천구청,4121,4176,8297,4148.5
20240714,2호선,도림천,621,712,1333,666.5
20240714,2호선,신설동,3602,3379,6981,3490.5
20240714,2호선,신답,857,918,1775,887.5
20240714,2호선,용답,1900,1954,3854,1927
20240714,2호선,충정로(경기대입구),4230,4592,8822,4411
20240714,2호선,아현,6243,6080,12323,6161.5
20240714,2호선,이대,9522,10495,20017,10008.5
20240714,2호선,신촌,27109,26990,54099,27049.5
20240714,2호선,홍대입구,74180,76377,150557,75278.5
20240714,2호선,합정,24797,26500,51297,25648.5
20240714,2호선,당산,9156,10046,19202,9601
20240714,2호선,영등포구청,9389,9663,19052,9526
20240714,2호선,문래,9082,9592,18674,9337
20240714,2호선,신도림,34636,34164,68800,34400
20240714,2호선,대림(구로구청),17368,17794,35162,17581
20240714,2호선,구로디지털단지,27878,26915,54793,27396.5
20240714,2호선,신대방,16643,16071,32714,16357
20240714,2호선,신림,36935,36333,73268,36634
20240714,2호선,봉천,14131,13680,27811,13905.5
20240714,2호선,서울대입구(관악구청),28087,28635,56722,28361
20240714,2호선,낙성대(강감찬),17349,17822,35171,17585.5
20240714,2호선,사당,26851,28810,55661,27830.5
20240714,2호선,방배,7952,8182,16134,8067
20240714,2호선,서초,14910,14111,29021,14510.5
20240714,2호선,교대(법원.검찰청),11049,13276,24325,12162.5
20240714,2호선,강남,39227,37893,77120,38560
20240714,2호선,역삼,13177,14403,27580,13790
20240714,2호선,선릉,16950,14408,31358,15679
20240714,2호선,삼성(무역센터),31713,30439,62152,31076
20240714,2호선,종합운동장,22417,25772,48189,24094.5
20240714,2호선,잠실새내,15805,15860,31665,15832.5
20240714,2호선,잠실(송파구청),62021,58488,120509,60254.5
20240714,2호선,잠실나루,6235,6281,12516,6258
20240714,2호선,강변(동서울터미널),23521,22497,46018,23009
20240714,2호선,구의(광진구청),13671,13622,27293,13646.5
20240714,2호선,건대입구,27897,29101,56998,28499
20240714,2호선,성수,27727,30987,58714,29357
20240714,2호선,뚝섬,14154,13693,27847,13923.5
20240714,2호선,한양대,3174,3480,6654,3327
20240714,2호선,왕십리(성동구청),9405,9008,18413,9206.5
20240714,2호선,상왕십리,8038,8214,16252,8126
20240714,2호선,신당,9367,10216,19583,9791.5
20240714,2호선,동대문역사문화공원(DDP),11808,14374,26182,13091
20240714,2호선,을지로4가,6270,6051,12321,6160.5
20240714,2호선,을지로3가,12702,12656,25358,12679
20240714,2호선,을지로입구,27038,26199,53237,26618.5
20240714,2호선,시청,9685,7688,17373,8686.5
20240714,1호선,동묘앞,13228,12966,26194,13097
20240714,1호선,청량리(서울시립대입구),16699,16803,33502,16751
20240714,1호선,제기동,11548,11985,23533,11766.5
20240714,1호선,신설동,8939,8992,17931,8965.5
20240714,1호선,동대문,11116,12021,23137,11568.5
20240714,1호선,종로5가,12137,11634,23771,11885.5
20240714,1호선,종로3가,15431,13751,29182,14591
20240714,1호선,종각,15681,14286,29967,14983.5
20240714,3호선,경복궁(정부서울청사),14893,15650,30543,15271.5
20240714,1호선,시청,11032,10561,21593,10796.5
20240714,1호선,서울역,37643,35281,72924,36462
20240714,일산선,원흥,6506,6190,12696,6348
20240714,우이신설선,신설동,1416,1390,2806,1403
20240714,우이신설선,보문,1116,1125,2241,1120.5
20240714,장항선,아산,4010,2796,6806,3403
20240714,안산선,안산,12299,11192,23491,11745.5
20240714,일산선,주엽,5679,5671,11350,5675
20240714,일산선,정발산,5654,5625,11279,5639.5
20240714,일산선,마두,3748,3825,7573,3786.5
20240714,일산선,백석,6323,6206,12529,6264.5
20240714,일산선,대곡,1741,1543,3284,1642
20240714,일산선,화정,11121,11568,22689,11344.5
20240714,일산선,원당,6883,6752,13635,6817.5
20240714,일산선,삼송,11625,11575,23200,11600
20240714,일산선,지축,2,0,2,1
20240714,안산선,초지,2797,2783,5580,2790
20240714,안산선,고잔,5163,5013,10176,5088
20240714,안산선,중앙,13360,13338,26698,13349
20240714,안산선,한대앞,6115,6155,12270,6135
20240714,안산선,상록수,9805,9807,19612,9806
20240714,안산선,반월,2798,2869,5667,2833.5
20240714,안산선,대야미,3260,2986,6246,3123
20240714,안산선,산본,10403,11011,21414,10707
20240714,신림선,관악산(서울대),3996,4169,8165,4082.5
20240714,신림선,서울대벤처타운,6491,6115,12606,6303
20240714,신림선,서원,2303,2119,4422,2211
20240714,신림선,신림,1372,1933,3305,1652.5
20240714,신림선,당곡,3005,2926,5931,2965.5
20240714,신림선,보라매병원,2741,2815,5556,2778
20240714,신림선,보라매공원,1380,1384,2764,1382
20240714,신림선,보라매,2303,2133,4436,2218
20240714,신림선,서울지방병무청,1869,2081,3950,1975
20240714,신림선,대방,1881,1599,3480,1740
20240714,신림선,샛강,964,1094,2058,1029
20240715,2호선,서울대입구(관악구청),49003,47984,96987,48493.5
20240715,장항선,온양온천,4343,4354,8697,4348.5
20240715,장항선,신창(순천향대),1228,1381,2609,1304.5
20240715,중앙선,회기,25679,24635,50314,25157
20240715,중앙선,중랑,6004,5715,11719,5859.5
20240715,중앙선,상봉,6363,6115,12478,6239
20240715,중앙선,망우,7941,7718,15659,7829.5
20240715,중앙선,양원,3476,3451,6927,3463.5
20240715,중앙선,구리,14085,14135,28220,14110
20240715,중앙선,도농,12033,10987,23020,11510
20240715,중앙선,양정,650,518,1168,584
20240715,중앙선,덕소,5725,5517,11242,5621
20240715,중앙선,도심,2679,2192,4871,2435.5
20240715,중앙선,팔당,915,933,1848,924
20240715,중앙선,운길산,725,709,1434,717
20240715,중앙선,양수,2335,2338,4673,2336.5
20240715,중앙선,신원,201,165,366,183
20240715,중앙선,국수,782,762,1544,772
20240715,중앙선,아신,542,562,1104,552
20240715,중앙선,오빈,371,353,724,362
20240715,중앙선,양평,3362,3319,6681,3340.5
20240715,중앙선,원덕,367,348,715,357.5
20240715,중앙선,용문,3119,2966,6085,3042.5
20240715,중앙선,지평,71,75,146,73
20240715,5호선,강일,6512,6023,12535,6267.5
20240715,5호선,마천,8303,7378,15681,7840.5
20240715,5호선,거여,11114,10957,22071,11035.5
20240715,5호선,개롱,7272,7543,14815,7407.5
20240715,5호선,오금,4159,4194,8353,4176.5
20240715,5호선,방이,7683,8113,15796,7898
20240715,5호선,올림픽공원(한국체대),6039,4928,10967,5483.5
20240715,5호선,둔촌동,9486,9423,18909,9454.5
20240715,5호선,상일동,16290,15355,31645,15822.5
20240715,5호선,고덕,12414,11954,24368,12184
20240715,5호선,명일,9467,9757,19224,9612
20240715,5호선,굽은다리(강동구민회관앞),10462,10154,20616,10308
20240715,5호선,길동,9138,9348,18486,9243
20240715,5호선,강동,19644,19152,38796,19398
20240715,5호선,천호(풍납토성),19934,19788,39722,19861
20240715,5호선,미사,18643,18958,37601,18800.5
20240715,4호선,숙대입구(갈월),14805,14447,29252,14626
20240715,4호선,삼각지,6191,6721,12912,6456
20240715,4호선,신용산,20687,22048,42735,21367.5
20240715,4호선,이촌(국립중앙박물관),8619,9582,18201,9100.5
20240715,4호선,동작(현충원),1501,1645,3146,1573
20240715,4호선,총신대입구(이수),20410,21956,42366,21183
20240715,4호선,사당,26108,22730,48838,24419
20240715,4호선,남태령,1425,1276,2701,1350.5
20240715,5호선,방화,7699,7528,15227,7613.5
20240715,5호선,개화산,6609,6329,12938,6469
20240715,5호선,김포공항,11496,8232,19728,9864
20240715,5호선,송정,6919,6527,13446,6723
20240715,5호선,마곡,13518,13759,27277,13638.5
20240715,5호선,발산,24834,25303,50137,25068.5
20240715,5호선,우장산,15741,15749,31490,15745
20240715,5호선,화곡,30376,28489,58865,29432.5
20240715,5호선,까치산,29495,28456,57951,28975.5
20240715,5호선,신정(은행정),14362,11905,26267,13133.5
20240715,5호선,양평,8674,8483,17157,8578.5
20240715,5호선,하남풍산,4800,4776,9576,4788
20240715,5호선,하남시청(덕풍·신장),8854,8413,17267,8633.5
20240715,7호선,가산디지털단지,51429,51488,102917,51458.5
20240715,7호선,철산,23139,23544,46683,23341.5
20240715,7호선,광명사거리,21584,20969,42553,21276.5
20240715,7호선,천왕,12779,12454,25233,12616.5
20240715,7호선,온수(성공회대입구),10621,9459,20080,10040
20240715,8호선,암사,20626,18316,38942,19471
20240715,8호선,천호(풍납토성),16187,18269,34456,17228
20240715,8호선,강동구청,11251,11832,23083,11541.5
20240715,8호선,몽촌토성(평화의문),7174,7295,14469,7234.5
20240715,8호선,잠실(송파구청),16495,18886,35381,17690.5
20240715,8호선,석촌,8625,9706,18331,9165.5
20240715,8호선,송파,10293,10205,20498,10249
20240715,8호선,가락시장,8267,9231,17498,8749
20240715,8호선,문정,25054,26460,51514,25757
20240715,8호선,장지,18022,16666,34688,17344
20240715,3호선,녹번,16528,15264,31792,15896
20240715,3호선,불광,17724,18986,36710,18355
20240715,3호선,연신내,36109,34226,70335,35167.5
20240715,3호선,구파발,23778,22806,46584,23292
20240715,3호선,지축,8112,8209,16321,8160.5
20240715,2호선,용두(동대문구청),2763,2820,5583,2791.5
20240715,2호선,신정네거리,10864,11475,22339,11169.5
20240715,2호선,양천구청,7270,7733,15003,7501.5
20240715,일산선,원당,11825,11219,23044,11522
20240715,공항철도 1호선,계양,14266,13512,27778,13889
20240715,공항철도 1호선,검암,6719,7015,13734,6867
20240715,공항철도 1호선,청라국제도시,8109,7519,15628,7814
20240715,공항철도 1호선,운서,9819,10310,20129,10064.5
20240715,공항철도 1호선,공항화물청사,2318,2458,4776,2388
20240715,공항철도 1호선,인천공항1터미널,15197,16883,32080,16040
20240715,공항철도 1호선,인천공항2터미널,7230,6989,14219,7109.5
20240715,공항철도 1호선,영종,4464,4498,8962,4481
20240715,장항선,배방,1255,1241,2496,1248
20240715,장항선,탕정,1802,1623,3425,1712.5
20240715,장항선,아산,3608,3273,6881,3440.5
20240715,장항선,쌍용(나사렛대),2365,2231,4596,2298
20240715,장항선,봉명,1536,1616,3152,1576
20240715,일산선,대화,14546,10914,25460,12730
20240715,일산선,주엽,10628,10887,21515,10757.5
20240715,일산선,정발산,7203,7291,14494,7247
20240715,일산선,마두,8911,9033,17944,8972
20240715,일산선,백석,10586,10688,21274,10637
20240715,일산선,대곡,3158,2421,5579,2789.5
20240715,일산선,화정,18148,18484,36632,18316
20240715,일산선,삼송,20119,19577,39696,19848
20240715,일산선,지축,1,0,1,0.5
20240715,일산선,원흥,12306,11785,24091,12045.5
20240715,우이신설선,신설동,2573,2276,4849,2424.5
20240715,우이신설선,보문,1753,1722,3475,1737.5
20240715,우이신설선,성신여대입구(돈암),3765,3932,7697,3848.5
20240715,우이신설선,정릉,4806,5224,10030,5015
20240715,우이신설선,북한산보국문,6245,6868,13113,6556.5
20240715,우이신설선,솔샘,5783,6716,12499,6249.5
20240715,우이신설선,삼양사거리,2876,2977,5853,2926.5
20240715,우이신설선,삼양,2278,2452,4730,2365
20240715,우이신설선,화계,3901,3929,7830,3915
20240715,우이신설선,가오리,4670,5002,9672,4836
20240715,우이신설선,4.19민주묘지,3210,3189,6399,3199.5
20240715,우이신설선,솔밭공원,2866,2901,5767,2883.5
20240715,우이신설선,북한산우이,3055,2760,5815,2907.5
20240715,안산선,수리산,4356,3711,8067,4033.5
20240715,안산선,오이도,8218,8056,16274,8137
20240715,안산선,정왕,9618,9807,19425,9712.5
20240715,안산선,신길온천,2108,1901,4009,2004.5
20240715,안산선,안산,12569,11449,24018,12009
20240715,안산선,초지,5316,5393,10709,5354.5
20240715,안산선,고잔,9647,9002,18649,9324.5
20240715,안산선,중앙,18567,19017,37584,18792
20240715,안산선,한대앞,9573,9695,19268,9634
20240715,안산선,상록수,15455,15661,31116,15558
20240715,안산선,반월,4657,4572,9229,4614.5
20240715,안산선,대야미,5252,4728,9980,4990
20240715,안산선,산본,16968,17856,34824,17412
20240715,신림선,관악산(서울대),3253,3261,6514,3257
20240715,신림선,서울대벤처타운,10135,9598,19733,9866.5
20240715,신림선,서원,3759,3453,7212,3606
20240715,신림선,신림,2165,2808,4973,2486.5
20240715,신림선,당곡,5431,5262,10693,5346.5
20240715,신림선,보라매병원,8712,9244,17956,8978
20240715,신림선,보라매공원,2441,2593,5034,2517
20240715,신림선,보라매,4792,4244,9036,4518
20240715,신림선,서울지방병무청,3548,3970,7518,3759
20240715,신림선,대방,3142,2555,5697,2848.5
20240715,신림선,샛강,3331,3744,7075,3537.5
20240715,수인선,인천,1145,1692,2837,1418.5
20240715,수인선,숭의,4481,4164,8645,4322.5
20240715,수인선,인하대,6924,6646,13570,6785
20240715,수인선,송도,2610,2311,4921,2460.5
20240715,과천선,선바위,7975,7052,15027,7513.5
20240715,과천선,경마공원,902,875,1777,888.5
20240715,수인선,연수,4971,4897,9868,4934
20240715,수인선,원인재,4524,4724,9248,4624
20240715,수인선,남동인더스파크,2621,2947,5568,2784
20240715,수인선,호구포,4153,4278,8431,4215.5
20240715,수인선,인천논현,5907,6162,12069,6034.5
20240715,수인선,소래포구,4751,4402,9153,4576.5
20240715,수인선,월곶,3015,2665,5680,2840
20240715,수인선,달월,115,68,183,91.5
20240715,수인선,사리,5295,4668,9963,4981.5
20240715,수인선,야목,427,373,800,400
20240715,1호선,청량리(서울시립대입구),23386,22679,46065,23032.5
20240715,1호선,제기동,17506,17710,35216,17608
20240715,1호선,신설동,15313,14725,30038,15019
20240715,1호선,동대문,11803,11476,23279,11639.5
20240715,1호선,종로5가,24976,24223,49199,24599.5
20240715,1호선,종로3가,26457,24021,50478,25239
20240715,1호선,종각,42872,42305,85177,42588.5
20240715,1호선,시청,27150,27138,54288,27144
20240715,1호선,서울역,57534,54062,111596,55798
20240715,수인선,어천,1342,1292,2634,1317
20240715,수인선,오목천,4265,3843,8108,4054
20240715,수인선,고색,5957,5423,11380,5690
20240715,서해선,부천종합운동장,2784,2341,5125,2562.5
20240715,서해선,원종,4959,5058,10017,5008.5
20240715,서해선,김포공항,3069,4027,7096,3548
20240715,분당선,매교,5835,5744,11579,5789.5
20240715,분당선,수원시청,14451,15436,29887,14943.5
20240715,분당선,매탄권선,5897,5774,11671,5835.5
20240715,분당선,망포,16773,16088,32861,16430.5
20240715,분당선,영통,9080,9272,18352,9176
20240715,분당선,청명,4987,4779,9766,4883
20240715,분당선,상갈,5596,5387,10983,5491.5
20240715,분당선,기흥,10917,10040,20957,10478.5
20240715,분당선,신갈,5199,5123,10322,5161
20240715,분당선,구성,6717,6710,13427,6713.5
20240715,분당선,죽전,13104,14646,27750,13875
20240715,분당선,보정,2966,2761,5727,2863.5
20240715,분당선,이매,6091,5638,11729,5864.5
20240715,분당선,오리,12461,11025,23486,11743
20240715,분당선,미금,16799,17340,34139,17069.5
20240715,분당선,정자,20006,20673,40679,20339.5
20240715,분당선,수내,15176,15493,30669,15334.5
20240715,분당선,서현,26044,26721,52765,26382.5
20240715,분당선,야탑,27020,28533,55553,27776.5
20240715,분당선,모란,20857,20850,41707,20853.5
20240715,분당선,태평,13917,13248,27165,13582.5
20240715,분당선,가천대,7559,7912,15471,7735.5
20240715,분당선,선정릉,8789,9259,18048,9024
20240715,분당선,강남구청,10552,12090,22642,11321
20240715,분당선,압구정로데오,19137,20596,39733,19866.5
20240715,분당선,서울숲,13301,13198,26499,13249.5
20240715,분당선,수원,7906,7369,15275,7637.5
20240715,분당선,복정,2,0,2,1
20240715,분당선,수서,17787,18453,36240,18120
20240715,분당선,대모산입구,6690,6256,12946,6473
20240715,분당선,개포동,4926,5072,9998,4999
20240715,분당선,구룡,4107,4025,8132,4066
20240715,분당선,도곡,8574,8776,17350,8675
20240715,분당선,한티,16457,18161,34618,17309
20240715,분당선,선릉,15091,23188,38279,19139.5
20240715,과천선,범계,27949,27918,55867,27933.5
20240715,과천선,평촌,19613,19234,38847,19423.5
20240715,과천선,인덕원,26455,27242,53697,26848.5
20240715,과천선,정부과천청사,13807,14269,28076,14038
20240715,과천선,과천,7002,6477,13479,6739.5
20240715,과천선,대공원,2110,2114,4224,2112
20240715,공항철도 1호선,김포공항,10355,6239,16594,8297
20240715,공항철도 1호선,마곡나루(서울식물원),12602,12106,24708,12354
20240715,공항철도 1호선,디지털미디어시티,15658,14970,30628,15314
20240715,공항철도 1호선,홍대입구,15585,14752,30337,15168.5
20240715,공항철도 1호선,공덕,3246,4037,7283,3641.5
20240715,공항철도 1호선,서울역,14659,12772,27431,13715.5
20240715,경춘선,춘천,1333,1182,2515,1257.5
20240715,경춘선,남춘천,2503,2591,5094,2547
20240715,경춘선,김유정,398,417,815,407.5
20240715,경춘선,강촌,378,456,834,417
20240715,경춘선,백양리,94,75,169,84.5
20240715,경춘선,굴봉산,113,114,227,113.5
20240715,경춘선,가평,2307,2725,5032,2516
20240715,경춘선,상천,273,261,534,267
20240715,경춘선,청평,1968,2162,4130,2065
20240715,경춘선,대성리,620,727,1347,673.5
20240715,경춘선,마석,3948,3761,7709,3854.5
20240715,경춘선,천마산,1617,1506,3123,1561.5
20240715,경춘선,평내호평,6511,6238,12749,6374.5
20240715,경춘선,금곡,1622,1587,3209,1604.5
20240715,경춘선,사릉,2224,2170,4394,2197
20240715,경춘선,퇴계원,3911,3527,7438,3719
20240715,경춘선,별내,3744,3552,7296,3648
20240715,경춘선,갈매,3297,2847,6144,3072
20240715,경춘선,신내,3023,2727,5750,2875
20240715,경인선,도화,4403,4130,8533,4266.5
20240715,경인선,중동,9885,9271,19156,9578
20240715,경인선,온수(성공회대입구),6842,6472,13314,6657
20240715,경인선,도원,3737,3750,7487,3743.5
20240715,경인선,간석,6407,6113,12520,6260
20240715,경인선,부개,9382,8892,18274,9137
20240715,경인선,소사,7794,7460,15254,7627
20240715,경인선,구일,6652,6689,13341,6670.5
20240715,경인선,인천,3655,2867,6522,3261
20240715,경인선,동인천,14344,13339,27683,13841.5
20240715,경인선,제물포,11154,10888,22042,11021
20240715,경인선,주안,18963,16968,35931,17965.5
20240715,경인선,동암,16310,16408,32718,16359
20240715,경인선,백운,7992,7705,15697,7848.5
20240715,경인선,부평,29529,30262,59791,29895.5
20240715,경인선,송내,28429,27978,56407,28203.5
20240715,경인선,부천,32117,31953,64070,32035
20240715,경인선,역곡,27021,27008,54029,27014.5
20240715,경인선,오류동,12265,11583,23848,11924
20240715,경인선,개봉,22761,22545,45306,22653
20240715,경의선,운천,2,3,5,2.5
20240715,경의선,임진강,13,7,20,10
20240715,경의선,문산,6077,5285,11362,5681
20240715,경의선,파주,1378,1005,2383,1191.5
20240715,경의선,월롱,2041,1922,3963,1981.5
20240715,경의선,금촌,6952,6510,13462,6731
20240715,경의선,금릉,5861,5564,11425,5712.5
20240715,경의선,운정,8353,7851,16204,8102
20240715,경의선,야당,9173,9118,18291,9145.5
20240715,경의선,탄현,8398,8065,16463,8231.5
20240715,경의선,일산,11492,11386,22878,11439
20240715,경의선,풍산,6589,6222,12811,6405.5
20240715,경의선,백마,8055,7811,15866,7933
20240715,경의선,곡산,737,804,1541,770.5
20240715,경의선,능곡,5084,4682,9766,4883
20240715,경의선,행신,8583,8619,17202,8601
20240715,경의선,강매,3558,2903,6461,3230.5
20240715,경의선,한국항공대,2178,2056,4234,2117
20240715,경의선,수색,3778,3821,7599,3799.5
20240715,경의선,디지털미디어시티,2938,2677,5615,2807.5
20240715,경의선,가좌,6344,6183,12527,6263.5
20240715,경의선,홍대입구,2185,2643,4828,2414
20240715,경의선,서강대,2317,2225,4542,2271
20240715,경의선,공덕,4467,3840,8307,4153.5
20240715,경의선,효창공원앞,3421,4001,7422,3711
20240715,경의선,신촌,1132,1425,2557,1278.5
20240715,경의선,서울역,5203,6686,11889,5944.5
20240715,경원선,연천,1265,1032,2297,1148.5
20240715,경원선,전곡,1163,945,2108,1054
20240715,경원선,청산,200,140,340,170
20240715,경원선,소요산,1824,1728,3552,1776
20240715,경원선,동두천,1847,1754,3601,1800.5
20240715,경원선,보산,1621,1431,3052,1526
20240715,경원선,동두천중앙,3423,3335,6758,3379
20240715,경원선,지행,6995,6939,13934,6967
20240715,경원선,덕정,6420,6083,12503,6251.5
20240715,경원선,덕계,6425,5791,12216,6108
20240715,경원선,양주,7549,7188,14737,7368.5
20240715,경원선,녹양,4649,4458,9107,4553.5
20240715,경원선,가능,6910,6775,13685,6842.5
20240715,경원선,의정부,19083,19036,38119,19059.5
20240715,경원선,회룡,13970,13595,27565,13782.5
20240715,경원선,망월사,7655,7764,15419,7709.5
20240715,경원선,도봉산,7752,4819,12571,6285.5
20240715,경원선,도봉,6507,6311,12818,6409
20240715,경원선,방학,10622,10370,20992,10496
20240715,경원선,창동,3,0,3,1.5
20240715,경원선,녹천,4996,4162,9158,4579
20240715,경원선,월계,7125,6556,13681,6840.5
20240715,경원선,광운대,8314,8024,16338,8169
20240715,경원선,석계,7557,8781,16338,8169
20240715,경원선,신이문,9086,8386,17472,8736
20240715,경원선,외대앞,9057,8805,17862,8931
20240715,경원선,청량리(서울시립대입구),16128,17177,33305,16652.5
20240715,경원선,왕십리(성동구청),16739,16969,33708,16854
20240715,경원선,응봉,2138,1781,3919,1959.5
20240715,경원선,옥수,49,46,95,47.5
20240715,경원선,한남,4213,4065,8278,4139
20240715,경원선,서빙고,2245,2094,4339,2169.5
20240715,경원선,이촌(국립중앙박물관),4379,3468,7847,3923.5
20240715,경부선,광명,4049,3487,7536,3768
20240715,경부선,서동탄,1722,1349,3071,1535.5
20240715,경부선,당정,6348,6010,12358,6179
20240715,경부선,천안,5687,5974,11661,5830.5
20240715,경부선,두정,6498,6725,13223,6611.5
20240715,경부선,직산,1111,1071,2182,1091
20240715,경부선,성환,4013,4125,8138,4069
20240715,경부선,평택,12310,12067,24377,12188.5
20240715,경부선,평택지제,4430,4316,8746,4373
20240715,경부선,서정리,8464,8079,16543,8271.5
20240715,경부선,송탄,4549,4493,9042,4521
20240715,경부선,진위,1923,1784,3707,1853.5
20240715,경부선,오산,10107,10100,20207,10103.5
20240715,경부선,오산대,3652,3457,7109,3554.5
20240715,경부선,수원,34951,35958,70909,35454.5
20240715,경부선,화서,11907,11373,23280,11640
20240715,경부선,성균관대,15322,15247,30569,15284.5
20240715,경부선,의왕,9543,9619,19162,9581
20240715,경부선,군포,7737,7813,15550,7775
20240715,경부선,금정,29553,29944,59497,29748.5
20240715,경부선,명학,9263,9248,18511,9255.5
20240715,경부선,안양,21740,21658,43398,21699
20240715,경부선,관악,7589,7278,14867,7433.5
20240715,경부선,석수,9054,8364,17418,8709
20240715,경부선,금천구청,11799,11975,23774,11887
20240715,경부선,가산디지털단지,19421,22556,41977,20988.5
20240715,경부선,구로,18756,18840,37596,18798
20240715,경부선,신길,9327,7946,17273,8636.5
20240715,경부선,신도림,4175,4387,8562,4281
20240715,경부선,영등포,39820,40451,80271,40135.5
20240715,경부선,대방,11400,12557,23957,11978.5
20240715,경부선,노량진,7938,7902,15840,7920
20240715,경부선,용산,38798,39782,78580,39290
20240715,경부선,남영,10263,10697,20960,10480
20240715,경부선,서울역,9091,3287,12378,6189
20240715,경강선,성남,1009,976,1985,992.5
20240715,경강선,여주,2845,2698,5543,2771.5
20240715,경강선,세종대왕릉,328,342,670,335
20240715,경강선,부발,2293,2272,4565,2282.5
20240715,경강선,이천,3015,3108,6123,3061.5
20240715,경강선,신둔도예촌,1566,1490,3056,1528
20240715,경강선,곤지암,2341,2262,4603,2301.5
20240715,경강선,초월,3705,3665,7370,3685
20240715,경강선,경기광주,8409,8100,16509,8254.5
20240715,경강선,삼동,2778,2607,5385,2692.5
20240715,경강선,이매,1182,1053,2235,1117.5
20240715,경강선,판교,6238,6100,12338,6169
20240715,9호선2~3단계,중앙보훈병원,13558,11950,25508,12754
20240715,9호선2~3단계,둔촌오륜,1588,1519,3107,1553.5
20240715,9호선2~3단계,올림픽공원(한국체대),5520,4900,10420,5210
20240715,9호선2~3단계,한성백제,3308,2967,6275,3137.5
20240715,9호선2~3단계,송파나루,5862,6360,12222,6111
20240715,9호선2~3단계,석촌,10182,9030,19212,9606
20240715,9호선2~3단계,석촌고분,7784,7568,15352,7676
20240715,9호선2~3단계,삼전,8694,8089,16783,8391.5
20240715,9호선2~3단계,종합운동장,5312,5150,10462,5231
20240715,9호선2~3단계,봉은사,20065,20889,40954,20477
20240715,9호선2~3단계,삼성중앙,9101,9422,18523,9261.5
20240715,9호선2~3단계,선정릉,11104,11890,22994,11497
20240715,9호선2~3단계,언주,13178,13524,26702,13351
20240715,9호선,신논현,32833,32781,65614,32807
20240715,9호선,사평,4418,4272,8690,4345
20240715,9호선,고속터미널,14796,19437,34233,17116.5
20240715,9호선,신반포,4574,4380,8954,4477
20240715,9호선,구반포,1514,1422,2936,1468
20240715,9호선,동작(현충원),1846,1590,3436,1718
20240715,9호선,흑석(중앙대입구),9818,10085,19903,9951.5
20240715,9호선,노들,5115,4313,9428,4714
20240715,9호선,노량진,26612,26329,52941,26470.5
20240715,9호선,샛강,7309,7479,14788,7394
20240715,9호선,여의도,31857,31048,62905,31452.5
20240715,9호선,국회의사당,18239,19050,37289,18644.5
20240715,9호선,당산,20638,20581,41219,20609.5
20240715,9호선,선유도,9946,9593,19539,9769.5
20240715,9호선,신목동,4964,4492,9456,4728
20240715,9호선,염창,19382,18715,38097,19048.5
20240715,9호선,등촌,13819,13424,27243,13621.5
20240715,9호선,증미,9130,9001,18131,9065.5
20240715,9호선,가양,24116,23792,47908,23954
20240715,9호선,양천향교,11008,11193,22201,11100.5
20240715,9호선,마곡나루(서울식물원),14782,14533,29315,14657.5
20240715,9호선,신방화,7786,7759,15545,7772.5
20240715,9호선,공항시장,3322,3630,6952,3476
20240715,9호선,김포공항,7521,10667,18188,9094
20240715,9호선,개화,3168,2145,5313,2656.5
20240715,8호선,남위례,7897,8009,15906,7953
20240715,8호선,모란,5024,4011,9035,4517.5
20240715,8호선,수진,5879,5473,11352,5676
20240715,8호선,신흥,5445,5702,11147,5573.5
20240715,8호선,단대오거리,12664,12388,25052,12526
20240715,8호선,남한산성입구(성남법원.검찰청),14014,12630,26644,13322
20240715,7호선,남구로,16657,17289,33946,16973
20240715,7호선,대림(구로구청),9570,9627,19197,9598.5
20240715,7호선,신풍,12196,11352,23548,11774
20240715,7호선,보라매,7127,7607,14734,7367
20240715,7호선,신대방삼거리,16391,16052,32443,16221.5
20240715,7호선,장승배기,10039,10046,20085,10042.5
20240715,7호선,상도,12575,12286,24861,12430.5
20240715,7호선,숭실대입구(살피재),13219,13385,26604,13302
20240715,7호선,남성,12373,11847,24220,12110
20240715,7호선,이수,17410,16998,34408,17204
20240715,7호선,내방,16451,16440,32891,16445.5
20240715,7호선,고속터미널,17249,14746,31995,15997.5
20240715,7호선,반포,6851,6558,13409,6704.5
20240715,7호선,논현,20912,21365,42277,21138.5
20240715,7호선,학동,26568,27551,54119,27059.5
20240715,7호선,강남구청,17320,19085,36405,18202.5
20240715,7호선,청담,21100,22701,43801,21900.5
20240715,7호선,자양(뚝섬한강공원),9758,9411,19169,9584.5
20240715,7호선,건대입구,13484,13693,27177,13588.5
20240715,7호선,어린이대공원(세종대),14300,14208,28508,14254
20240715,7호선,군자(능동),16513,13168,29681,14840.5
20240715,7호선,중곡,11996,11339,23335,11667.5
20240715,7호선,용마산(용마폭포공원),6179,5974,12153,6076.5
20240715,7호선,사가정,17164,17311,34475,17237.5
20240715,7호선,면목,15830,15584,31414,15707
20240715,7호선,상봉,18301,17706,36007,18003.5
20240715,7호선,중화,11218,10987,22205,11102.5
20240715,7호선,먹골,11050,10989,22039,11019.5
20240715,7호선,태릉입구,9295,8795,18090,9045
20240715,7호선,공릉(서울과학기술대),12644,12708,25352,12676
20240715,7호선,하계,19523,18182,37705,18852.5
20240715,7호선,중계,15986,14869,30855,15427.5
20240715,7호선,노원,25818,26814,52632,26316
20240715,7호선,마들,14043,13343,27386,13693
20240715,7호선,수락산,13128,13073,26201,13100.5
20240715,7호선,도봉산,9311,10714,20025,10012.5
20240715,7호선,장암,3062,1192,4254,2127
20240715,6호선,봉화산(서울의료원),9648,9064,18712,9356
20240715,6호선,화랑대(서울여대입구),12493,9724,22217,11108.5
20240715,6호선,태릉입구,5873,6573,12446,6223
20240715,6호선,석계,13259,13759,27018,13509
20240715,6호선,돌곶이,10971,10082,21053,10526.5
20240715,6호선,상월곡(한국과학기술연구원),6716,6089,12805,6402.5
20240715,6호선,월곡(동덕여대),12541,12438,24979,12489.5
20240715,6호선,고려대(종암),8876,8578,17454,8727
20240715,6호선,안암(고대병원앞),12014,12111,24125,12062.5
20240715,6호선,보문,8735,7902,16637,8318.5
20240715,6호선,창신,3811,3129,6940,3470
20240715,6호선,동묘앞,8269,8675,16944,8472
20240715,6호선,신당,8925,9531,18456,9228
20240715,6호선,청구,4267,4226,8493,4246.5
20240715,6호선,약수,4243,4002,8245,4122.5
20240715,수인선,신포,1936,1988,3924,1962
20240715,1호선,동묘앞,8606,8651,17257,8628.5
20240715,2호선,시청,29463,28110,57573,28786.5
20240715,2호선,을지로입구,52973,55096,108069,54034.5
20240715,2호선,을지로3가,27551,27437,54988,27494
20240715,2호선,을지로4가,15679,15399,31078,15539
20240715,2호선,동대문역사문화공원(DDP),14758,16873,31631,15815.5
20240715,2호선,신당,15167,15759,30926,15463
20240715,2호선,상왕십리,15620,15743,31363,15681.5
20240715,2호선,왕십리(성동구청),16386,14368,30754,15377
20240715,2호선,한양대,9613,10552,20165,10082.5
20240715,2호선,뚝섬,26092,27415,53507,26753.5
20240715,2호선,성수,46466,50873,97339,48669.5
20240715,2호선,건대입구,35223,37072,72295,36147.5
20240715,2호선,구의(광진구청),26944,26404,53348,26674
20240715,2호선,강변(동서울터미널),31884,29158,61042,30521
20240715,2호선,잠실나루,17156,16585,33741,16870.5
20240715,2호선,잠실(송파구청),79299,78823,158122,79061
20240715,2호선,잠실새내,25481,24492,49973,24986.5
20240715,2호선,종합운동장,8223,8567,16790,8395
20240715,2호선,삼성(무역센터),56985,58652,115637,57818.5
20240715,2호선,선릉,66307,58379,124686,62343
20240715,2호선,역삼,59883,68103,127986,63993
20240715,2호선,강남,90027,87854,177881,88940.5
20240715,2호선,교대(법원.검찰청),34919,41889,76808,38404
20240715,2호선,서초,23596,22882,46478,23239
20240715,2호선,방배,17015,17460,34475,17237.5
20240715,2호선,사당,40905,44063,84968,42484
20240715,2호선,낙성대(강감찬),29167,29120,58287,29143.5
20240715,2호선,봉천,26111,25034,51145,25572.5
20240715,2호선,신림,56753,55083,111836,55918
20240715,2호선,신대방,26550,25668,52218,26109
20240715,2호선,구로디지털단지,62069,61918,123987,61993.5
20240715,2호선,대림(구로구청),25874,26469,52343,26171.5
20240715,2호선,신도림,51928,49996,101924,50962
20240715,2호선,문래,25622,26129,51751,25875.5
20240715,2호선,영등포구청,24773,25286,50059,25029.5
20240715,2호선,당산,18787,22104,40891,20445.5
20240715,2호선,합정,32364,34450,66814,33407
20240715,2호선,홍대입구,70611,74159,144770,72385
20240715,2호선,신촌,39136,39959,79095,39547.5
20240715,2호선,이대,16411,18056,34467,17233.5
20240715,2호선,아현,12148,11222,23370,11685
20240715,2호선,충정로(경기대입구),11158,11807,22965,11482.5
20240715,2호선,용답,3118,3024,6142,3071
20240715,2호선,신답,1789,2030,3819,1909.5
20240715,2호선,신설동,3588,3423,7011,3505.5
20240715,2호선,도림천,1569,1634,3203,1601.5
20240715,3호선,홍제,18943,18161,37104,18552
20240715,3호선,무악재,4817,4713,9530,4765
20240715,3호선,독립문,7921,7966,15887,7943.5
20240715,3호선,경복궁(정부서울청사),24773,25187,49960,24980
20240715,3호선,안국,27908,28228,56136,28068
20240715,3호선,종로3가,12047,13373,25420,12710
20240715,3호선,을지로3가,12903,12836,25739,12869.5
20240715,3호선,충무로,5,0,5,2.5
20240715,3호선,동대입구,8470,9257,17727,8863.5
20240715,3호선,약수,13835,13703,27538,13769
20240715,3호선,금호,8602,8062,16664,8332
20240715,3호선,옥수,9496,9711,19207,9603.5
20240715,3호선,압구정,34865,36870,71735,35867.5
20240715,3호선,신사,29840,30950,60790,30395
20240715,3호선,잠원,5651,5412,11063,5531.5
20240715,3호선,고속터미널,45685,42314,87999,43999.5
20240715,3호선,교대(법원.검찰청),18951,11441,30392,15196
20240715,3호선,남부터미널(예술의전당),31450,31967,63417,31708.5
20240715,3호선,양재(서초구청),40855,43812,84667,42333.5
20240715,3호선,매봉,14300,13683,27983,13991.5
20240715,3호선,도곡,6674,6617,13291,6645.5
20240715,3호선,대치,13607,13704,27311,13655.5
20240715,3호선,학여울,2095,2104,4199,2099.5
20240715,3호선,대청,12079,11449,23528,11764
20240715,3호선,일원,12454,12217,24671,12335.5
20240715,3호선,수서,19307,19610,38917,19458.5
20240715,3호선,가락시장,10035,9710,19745,9872.5
20240715,3호선,경찰병원,8741,8967,17708,8854
20240715,3호선,오금,7280,6311,13591,6795.5
20240715,4호선,당고개,10176,8626,18802,9401
20240715,4호선,상계,20656,19322,39978,19989
20240715,4호선,노원,29904,33039,62943,31471.5
20240715,4호선,창동,27553,29062,56615,28307.5
20240715,4호선,쌍문,31331,29132,60463,30231.5
20240715,4호선,수유(강북구청),35599,35476,71075,35537.5
20240715,4호선,미아(서울사이버대학),16498,16035,32533,16266.5
20240715,4호선,미아사거리,28862,27860,56722,28361
20240715,4호선,길음,22421,22036,44457,22228.5
20240715,4호선,성신여대입구(돈암),22273,21014,43287,21643.5
20240715,4호선,한성대입구(삼선교),13751,13098,26849,13424.5
20240715,4호선,혜화,31531,31693,63224,31612
20240715,4호선,동대문,22101,22827,44928,22464
20240715,4호선,동대문역사문화공원(DDP),19478,16905,36383,18191.5
20240715,4호선,충무로,32366,33189,65555,32777.5
20240715,4호선,명동,34323,36080,70403,35201.5
20240715,4호선,회현(남대문시장),29231,30102,59333,29666.5
20240715,4호선,서울역,14298,22801,37099,18549.5
20240715,5호선,목동,17774,19466,37240,18620
20240715,5호선,오목교(목동운동장앞),22091,23680,45771,22885.5
20240715,5호선,영등포구청,5192,5178,10370,5185
20240715,5호선,영등포시장,12050,12366,24416,12208
20240715,5호선,신길,5327,5459,10786,5393
20240715,5호선,여의도,30537,32548,63085,31542.5
20240715,5호선,여의나루,12090,12918,25008,12504
20240715,5호선,마포,16363,16690,33053,16526.5
20240715,5호선,공덕,16257,16931,33188,16594
20240715,5호선,애오개,7621,7664,15285,7642.5
20240715,5호선,충정로(경기대입구),5276,5345,10621,5310.5
20240715,5호선,서대문,22430,22517,44947,22473.5
20240715,5호선,광화문(세종문화회관),34864,36921,71785,35892.5
20240715,5호선,종로3가,14849,14914,29763,14881.5
20240715,5호선,을지로4가,7179,7034,14213,7106.5
20240715,5호선,동대문역사문화공원(DDP),3278,3625,6903,3451.5
20240715,5호선,청구,4165,3903,8068,4034
20240715,5호선,신금호,7041,7486,14527,7263.5
20240715,5호선,행당,8719,7800,16519,8259.5
20240715,5호선,왕십리(성동구청),4709,5445,10154,5077
20240715,5호선,마장,6160,5748,11908,5954
20240715,5호선,답십리,17228,15873,33101,16550.5
20240715,5호선,장한평,20839,20645,41484,20742
20240715,5호선,군자(능동),11794,13077,24871,12435.5
20240715,5호선,아차산(어린이대공원후문),15396,15005,30401,15200.5
20240715,5호선,광나루(장신대),13912,12971,26883,13441.5
20240715,5호선,하남검단산,6825,6545,13370,6685
20240715,6호선,응암,18662,18607,37269,18634.5
20240715,6호선,역촌,4245,4828,9073,4536.5
20240715,6호선,불광,5067,4984,10051,5025.5
20240715,6호선,독바위,3100,3175,6275,3137.5
20240715,6호선,연신내,5,0,5,2.5
20240715,6호선,구산,9037,7203,16240,8120
20240715,6호선,새절(신사),13752,12713,26465,13232.5
20240715,6호선,증산(명지대앞),10386,10317,20703,10351.5
20240715,6호선,디지털미디어시티,16125,17670,33795,16897.5
20240715,6호선,월드컵경기장(성산),4275,4342,8617,4308.5
20240715,6호선,마포구청,15476,14179,29655,14827.5
20240715,6호선,망원,15262,16131,31393,15696.5
20240715,6호선,합정,13714,13189,26903,13451.5
20240715,6호선,상수,10451,10971,21422,10711
20240715,6호선,광흥창(서강),10362,10013,20375,10187.5
20240715,6호선,대흥(서강대앞),9600,10099,19699,9849.5
20240715,6호선,공덕,21336,20672,42008,21004
20240715,6호선,효창공원앞,7615,6789,14404,7202
20240715,6호선,삼각지,7094,6548,13642,6821
20240715,6호선,녹사평(용산구청),5064,4938,10002,5001
20240715,6호선,이태원,10360,10427,20787,10393.5
20240715,경부선,세마,3473,3264,6737,3368.5
20240715,경부선,병점,15044,14827,29871,14935.5
20240715,경부선,세류,3534,3247,6781,3390.5
20240715,경부선,독산,19167,19792,38959,19479.5
20240715,6호선,한강진,8055,9422,17477,8738.5
20240715,8호선,산성,6765,6941,13706,6853
20240715,8호선,복정,9804,8443,18247,9123.5
20240715,6호선,버티고개,2277,2336,4613,2306.5
20240716,서해선,김포공항,3055,4081,7136,3568
20240716,서해선,원종,4805,5697,10502,5251
20240716,서해선,부천종합운동장,2997,2332,5329,2664.5
20240716,수인선,고색,5845,5423,11268,5634
20240716,수인선,오목천,4206,3674,7880,3940
20240716,수인선,어천,1262,1246,2508,1254
20240716,수인선,야목,431,433,864,432
20240716,수인선,사리,5244,4504,9748,4874
20240716,수인선,달월,127,69,196,98
20240716,수인선,월곶,2909,2599,5508,2754
20240716,수인선,소래포구,4660,4307,8967,4483.5
20240716,수인선,인천논현,5753,6000,11753,5876.5
20240716,수인선,호구포,4054,4229,8283,4141.5
20240716,수인선,남동인더스파크,2546,2962,5508,2754
20240716,수인선,원인재,4544,4704,9248,4624
20240716,수인선,연수,4835,4794,9629,4814.5
20240716,수인선,송도,2520,2303,4823,2411.5
20240716,수인선,인하대,6705,6314,13019,6509.5
20240716,수인선,숭의,4401,4072,8473,4236.5
20240716,수인선,신포,1880,1921,3801,1900.5
20240716,수인선,인천,974,1612,2586,1293
20240716,신림선,샛강,3291,3870,7161,3580.5
20240716,신림선,대방,3126,2563,5689,2844.5
20240716,신림선,서울지방병무청,3498,3922,7420,3710
20240716,신림선,보라매,4887,4389,9276,4638
20240716,2호선,잠실새내,25724,25041,50765,25382.5
20240716,2호선,종합운동장,9203,10102,19305,9652.5
20240716,2호선,삼성(무역센터),59732,61197,120929,60464.5
20240716,2호선,선릉,67156,58941,126097,63048.5
20240716,2호선,역삼,63008,70341,133349,66674.5
20240716,2호선,강남,91782,88398,180180,90090
20240716,2호선,교대(법원.검찰청),35504,41991,77495,38747.5
20240716,2호선,서초,24165,23492,47657,23828.5
20240716,2호선,방배,16815,17500,34315,17157.5
20240716,2호선,사당,42284,45203,87487,43743.5
20240716,2호선,낙성대(강감찬),29717,29057,58774,29387
20240716,2호선,서울대입구(관악구청),48730,47487,96217,48108.5
20240716,2호선,봉천,26080,24771,50851,25425.5
20240716,경부선,수원,34265,36002,70267,35133.5
20240716,경부선,화서,11628,11262,22890,11445
20240716,경부선,성균관대,15302,15002,30304,15152
20240716,경부선,의왕,9538,9638,19176,9588
20240716,경부선,군포,7661,7607,15268,7634
20240716,경부선,금정,29659,29991,59650,29825
20240716,경부선,명학,9395,9339,18734,9367
20240716,경부선,안양,21363,21330,42693,21346.5
20240716,경부선,관악,7561,7468,15029,7514.5
20240716,경부선,석수,9156,8395,17551,8775.5
20240716,경부선,금천구청,11741,12014,23755,11877.5
20240716,경부선,가산디지털단지,19364,22387,41751,20875.5
20240716,경부선,구로,18353,18726,37079,18539.5
20240716,경부선,신길,9185,7876,17061,8530.5
20240716,경부선,신도림,3996,4235,8231,4115.5
20240716,경부선,영등포,40442,40836,81278,40639
20240716,경부선,대방,11265,12400,23665,11832.5
20240716,경강선,여주,2643,2633,5276,2638
20240716,경강선,성남,973,951,1924,962
20240716,신림선,보라매공원,2620,2759,5379,2689.5
20240716,신림선,보라매병원,9168,9531,18699,9349.5
20240716,신림선,당곡,5392,5359,10751,5375.5
20240716,신림선,신림,2124,2764,4888,2444
20240716,신림선,서원,3725,3511,7236,3618
20240716,신림선,서울대벤처타운,9935,9399,19334,9667
20240716,신림선,관악산(서울대),2967,3020,5987,2993.5
20240716,안산선,산본,16943,17834,34777,17388.5
20240716,안산선,대야미,5219,4672,9891,4945.5
20240716,안산선,반월,4521,4377,8898,4449
20240716,안산선,상록수,15113,15471,30584,15292
20240716,안산선,한대앞,9129,9383,18512,9256
20240716,안산선,중앙,18269,18942,37211,18605.5
20240716,안산선,고잔,9257,8775,18032,9016
20240716,안산선,초지,5271,5425,10696,5348
20240716,안산선,안산,12186,11000,23186,11593
20240716,안산선,신길온천,2115,1904,4019,2009.5
20240716,안산선,정왕,9041,9321,18362,9181
20240716,안산선,오이도,7872,7662,15534,7767
20240716,안산선,수리산,4390,3647,8037,4018.5
20240716,우이신설선,북한산우이,2821,2577,5398,2699
20240716,우이신설선,솔밭공원,2845,2777,5622,2811
20240716,우이신설선,4.19민주묘지,3174,2981,6155,3077.5
20240716,우이신설선,가오리,4578,4847,9425,4712.5
20240716,우이신설선,화계,3840,3750,7590,3795
20240716,우이신설선,삼양,2112,2320,4432,2216
20240716,우이신설선,삼양사거리,2686,2847,5533,2766.5
20240716,5호선,왕십리(성동구청),4939,5546,10485,5242.5
20240716,5호선,마장,6141,5779,11920,5960
20240716,5호선,답십리,17406,15987,33393,16696.5
20240716,5호선,장한평,20517,20716,41233,20616.5
20240716,5호선,군자(능동),11941,13094,25035,12517.5
20240716,5호선,아차산(어린이대공원후문),15288,15004,30292,15146
20240716,경강선,부발,2231,2168,4399,2199.5
20240716,경강선,세종대왕릉,351,330,681,340.5
20240716,9호선,공항시장,3316,3580,6896,3448
20240716,9호선,신방화,7976,8068,16044,8022
20240716,9호선,마곡나루(서울식물원),15374,14874,30248,15124
20240716,9호선,양천향교,11235,11600,22835,11417.5
20240716,9호선,가양,24305,23944,48249,24124.5
20240716,9호선,증미,9300,9059,18359,9179.5
20240716,9호선,등촌,13751,13505,27256,13628
20240716,9호선,염창,19395,18735,38130,19065
20240716,9호선,신목동,5102,4615,9717,4858.5
20240716,9호선,선유도,10271,9749,20020,10010
20240716,9호선,당산,21141,21300,42441,21220.5
20240716,9호선,국회의사당,20017,20221,40238,20119
20240716,9호선,여의도,35246,33232,68478,34239
20240716,9호선,샛강,7656,7715,15371,7685.5
20240716,9호선,노량진,27234,26209,53443,26721.5
20240716,9호선,노들,5251,4521,9772,4886
20240716,9호선,흑석(중앙대입구),9344,9696,19040,9520
20240716,9호선,동작(현충원),1828,1478,3306,1653
20240716,9호선,구반포,1446,1395,2841,1420.5
20240716,9호선,신반포,4399,4260,8659,4329.5
20240716,9호선,고속터미널,14608,19312,33920,16960
20240716,9호선,사평,4528,4508,9036,4518
20240716,9호선,신논현,33277,33207,66484,33242
20240716,9호선2~3단계,언주,13810,13832,27642,13821
20240716,9호선2~3단계,선정릉,11451,12254,23705,11852.5
20240716,9호선2~3단계,삼성중앙,9418,9774,19192,9596
20240716,9호선2~3단계,봉은사,21659,22097,43756,21878
20240716,9호선2~3단계,종합운동장,5524,5440,10964,5482
20240716,9호선2~3단계,삼전,8738,8492,17230,8615
20240716,9호선2~3단계,석촌고분,7896,7934,15830,7915
20240716,경원선,도봉산,7314,4505,11819,5909.5
20240716,경원선,망월사,7407,7621,15028,7514
20240716,경원선,회룡,13832,13379,27211,13605.5
20240716,경원선,의정부,18603,18637,37240,18620
20240716,경원선,가능,6913,6714,13627,6813.5
20240716,경원선,녹양,4467,4251,8718,4359
20240716,경원선,양주,7497,7108,14605,7302.5
20240716,경원선,덕계,6383,5878,12261,6130.5
20240716,경원선,덕정,6262,6002,12264,6132
20240716,경원선,지행,6600,6711,13311,6655.5
20240716,경원선,동두천중앙,3144,3014,6158,3079
20240716,경원선,보산,1511,1439,2950,1475
20240716,경원선,동두천,1824,1756,3580,1790
20240716,경원선,소요산,1579,1536,3115,1557.5
20240716,경원선,청산,176,147,323,161.5
20240716,경원선,전곡,1094,946,2040,1020
20240716,경원선,연천,1149,1057,2206,1103
20240716,경의선,서울역,4949,6334,11283,5641.5
20240716,경의선,신촌,1154,1411,2565,1282.5
20240716,경의선,효창공원앞,3478,4012,7490,3745
20240716,경의선,공덕,4640,3713,8353,4176.5
20240716,경의선,서강대,2277,2258,4535,2267.5
20240716,경의선,홍대입구,1989,2433,4422,2211
20240716,경의선,가좌,6288,6185,12473,6236.5
20240716,경의선,디지털미디어시티,3005,2816,5821,2910.5
20240716,우이신설선,솔샘,6252,6195,12447,6223.5
20240716,경의선,계양,1,0,1,0.5
20240716,경부선,병점,14815,14568,29383,14691.5
20240716,9호선,김포공항,7290,10700,17990,8995
20240716,경부선,세마,3383,3268,6651,3325.5
20240716,경부선,오산대,3664,3321,6985,3492.5
20240716,9호선,개화,3241,2189,5430,2715
20240716,8호선,남위례,8058,7950,16008,8004
20240716,8호선,모란,4938,3767,8705,4352.5
20240716,8호선,수진,5714,5362,11076,5538
20240716,8호선,신흥,5340,5466,10806,5403
20240716,8호선,단대오거리,12529,12349,24878,12439
20240716,8호선,남한산성입구(성남법원.검찰청),13937,12622,26559,13279.5
20240716,8호선,산성,6727,6902,13629,6814.5
20240716,8호선,복정,10293,8826,19119,9559.5
20240716,8호선,장지,18502,17148,35650,17825
20240716,8호선,문정,25582,26495,52077,26038.5
20240716,8호선,가락시장,8556,9315,17871,8935.5
20240716,8호선,송파,10572,10765,21337,10668.5
20240716,8호선,석촌,8683,9998,18681,9340.5
20240716,8호선,잠실(송파구청),17364,19810,37174,18587
20240716,8호선,몽촌토성(평화의문),7645,7979,15624,7812
20240716,8호선,강동구청,11567,12067,23634,11817
20240716,8호선,천호(풍납토성),16014,17965,33979,16989.5
20240716,8호선,암사,20426,18063,38489,19244.5
20240716,7호선,온수(성공회대입구),10688,9679,20367,10183.5
20240716,7호선,천왕,13150,12692,25842,12921
20240716,7호선,광명사거리,20958,20593,41551,20775.5
20240716,7호선,철산,23055,23526,46581,23290.5
20240716,7호선,가산디지털단지,51809,51724,103533,51766.5
20240716,7호선,남구로,16327,17169,33496,16748
20240716,7호선,대림(구로구청),9284,9534,18818,9409
20240716,7호선,신풍,12574,11876,24450,12225
20240716,7호선,보라매,7243,7718,14961,7480.5
20240716,7호선,신대방삼거리,16259,15754,32013,16006.5
20240716,7호선,장승배기,10238,10164,20402,10201
20240716,7호선,상도,12198,12018,24216,12108
20240716,7호선,숭실대입구(살피재),13290,13395,26685,13342.5
20240716,7호선,남성,12494,12019,24513,12256.5
20240716,7호선,이수,17802,17471,35273,17636.5
20240716,7호선,내방,16521,16646,33167,16583.5
20240716,7호선,고속터미널,16851,15081,31932,15966
20240716,7호선,반포,6884,6643,13527,6763.5
20240716,7호선,논현,20669,21379,42048,21024
20240716,7호선,학동,27635,28642,56277,28138.5
20240716,7호선,강남구청,18245,20035,38280,19140
20240716,7호선,청담,21127,23049,44176,22088
20240716,7호선,자양(뚝섬한강공원),8488,8458,16946,8473
20240716,7호선,건대입구,13516,13743,27259,13629.5
20240716,7호선,어린이대공원(세종대),14344,14131,28475,14237.5
20240716,7호선,군자(능동),16315,13170,29485,14742.5
20240716,7호선,중곡,12003,11455,23458,11729
20240716,7호선,용마산(용마폭포공원),6146,6010,12156,6078
20240716,7호선,사가정,17260,17323,34583,17291.5
20240716,7호선,면목,15604,15523,31127,15563.5
20240716,7호선,상봉,18375,17513,35888,17944
20240716,7호선,중화,11045,10950,21995,10997.5
20240716,7호선,먹골,11028,10906,21934,10967
20240716,7호선,태릉입구,9213,8584,17797,8898.5
20240716,7호선,공릉(서울과학기술대),12814,12554,25368,12684
20240716,7호선,하계,19076,18094,37170,18585
20240716,7호선,중계,15604,14667,30271,15135.5
20240716,7호선,노원,25836,26262,52098,26049
20240716,7호선,마들,14118,13634,27752,13876
20240716,7호선,수락산,13116,13014,26130,13065
20240716,7호선,도봉산,9350,10720,20070,10035
20240716,7호선,장암,2987,1275,4262,2131
20240716,6호선,봉화산(서울의료원),9717,9226,18943,9471.5
20240716,6호선,화랑대(서울여대입구),12547,10020,22567,11283.5
20240716,6호선,태릉입구,5934,6318,12252,6126
20240716,6호선,석계,13237,13737,26974,13487
20240716,6호선,돌곶이,10835,10101,20936,10468
20240716,6호선,상월곡(한국과학기술연구원),6761,6175,12936,6468
20240716,6호선,월곡(동덕여대),12462,12508,24970,12485
20240716,6호선,고려대(종암),9086,8711,17797,8898.5
20240716,6호선,안암(고대병원앞),12290,12345,24635,12317.5
20240716,6호선,보문,8434,7941,16375,8187.5
20240716,6호선,창신,3732,3189,6921,3460.5
20240716,6호선,동묘앞,8358,8901,17259,8629.5
20240716,6호선,신당,9745,10350,20095,10047.5
20240716,6호선,청구,4353,4309,8662,4331
20240716,6호선,약수,4415,3953,8368,4184
20240716,6호선,버티고개,2319,2439,4758,2379
20240716,6호선,한강진,9856,11340,21196,10598
20240716,6호선,이태원,10042,10270,20312,10156
20240716,6호선,녹사평(용산구청),5141,5042,10183,5091.5
20240716,6호선,삼각지,7554,6827,14381,7190.5
20240716,6호선,효창공원앞,7717,7073,14790,7395
20240716,6호선,공덕,21595,20964,42559,21279.5
20240716,6호선,대흥(서강대앞),9956,10486,20442,10221
20240716,6호선,광흥창(서강),10495,10235,20730,10365
20240716,6호선,상수,10060,10850,20910,10455
20240716,6호선,합정,14091,13507,27598,13799
20240716,6호선,망원,15733,16749,32482,16241
20240716,6호선,마포구청,15940,14722,30662,15331
20240716,6호선,월드컵경기장(성산),4294,4320,8614,4307
20240716,6호선,디지털미디어시티,16445,18287,34732,17366
20240716,6호선,증산(명지대앞),10533,10634,21167,10583.5
20240716,6호선,새절(신사),13773,12836,26609,13304.5
20240716,6호선,구산,9033,7221,16254,8127
20240716,6호선,연신내,4,0,4,2
20240716,6호선,독바위,3105,3327,6432,3216
20240716,6호선,불광,5257,5083,10340,5170
20240716,6호선,역촌,4124,4739,8863,4431.5
20240716,6호선,응암,18696,18691,37387,18693.5
20240716,5호선,하남검단산,6856,6546,13402,6701
20240716,5호선,하남시청(덕풍·신장),8921,8437,17358,8679
20240716,5호선,하남풍산,4801,4869,9670,4835
20240716,5호선,미사,18616,18963,37579,18789.5
20240716,5호선,강일,6443,6083,12526,6263
20240716,5호선,마천,8231,7428,15659,7829.5
20240716,5호선,거여,11209,11126,22335,11167.5
20240716,5호선,개롱,7357,7574,14931,7465.5
20240716,5호선,오금,4078,4208,8286,4143
20240716,5호선,방이,7726,8232,15958,7979
20240716,5호선,올림픽공원(한국체대),6004,4777,10781,5390.5
20240716,5호선,둔촌동,9522,9601,19123,9561.5
20240716,5호선,상일동,16284,15690,31974,15987
20240716,5호선,고덕,12067,11582,23649,11824.5
20240716,5호선,명일,9606,9995,19601,9800.5
20240716,5호선,굽은다리(강동구민회관앞),10319,10038,20357,10178.5
20240716,5호선,길동,8798,9069,17867,8933.5
20240716,5호선,강동,19729,19403,39132,19566
20240716,5호선,천호(풍납토성),19819,19535,39354,19677
20240716,5호선,광나루(장신대),14533,13525,28058,14029
20240716,5호선,행당,8761,8035,16796,8398
20240716,5호선,신금호,7209,7676,14885,7442.5
20240716,5호선,청구,4307,4125,8432,4216
20240716,5호선,동대문역사문화공원(DDP),3725,4138,7863,3931.5
20240716,5호선,을지로4가,7186,7230,14416,7208
20240716,5호선,종로3가,14990,14803,29793,14896.5
20240716,5호선,광화문(세종문화회관),37538,38341,75879,37939.5
20240716,5호선,서대문,23457,23174,46631,23315.5
20240716,5호선,충정로(경기대입구),5556,5602,11158,5579
20240716,5호선,애오개,7708,7853,15561,7780.5
20240716,5호선,공덕,16462,17294,33756,16878
20240716,5호선,마포,16588,17012,33600,16800
20240716,5호선,여의나루,11345,13758,25103,12551.5
20240716,5호선,여의도,35151,35081,70232,35116
20240716,5호선,신길,5265,5711,10976,5488
20240716,5호선,영등포시장,12058,12630,24688,12344
20240716,5호선,영등포구청,5335,5193,10528,5264
20240716,5호선,양평,8817,8718,17535,8767.5
20240716,5호선,오목교(목동운동장앞),22770,24273,47043,23521.5
20240716,5호선,목동,18178,19613,37791,18895.5
20240716,5호선,신정(은행정),14590,12456,27046,13523
20240716,5호선,까치산,29445,28671,58116,29058
20240716,5호선,화곡,30440,28446,58886,29443
20240716,5호선,우장산,16351,16398,32749,16374.5
20240716,5호선,발산,24970,25439,50409,25204.5
20240716,5호선,마곡,13885,14023,27908,13954
20240716,5호선,송정,6779,6488,13267,6633.5
20240716,5호선,김포공항,11339,8100,19439,9719.5
20240716,5호선,개화산,6632,6374,13006,6503
20240716,5호선,방화,7851,7423,15274,7637
20240716,4호선,남태령,1455,1285,2740,1370
20240716,4호선,사당,27053,23585,50638,25319
20240716,4호선,총신대입구(이수),20791,22057,42848,21424
20240716,4호선,동작(현충원),1317,1430,2747,1373.5
20240716,4호선,이촌(국립중앙박물관),9053,10102,19155,9577.5
20240716,4호선,신용산,21260,22474,43734,21867
20240716,4호선,삼각지,6530,7157,13687,6843.5
20240716,4호선,숙대입구(갈월),14984,14751,29735,14867.5
20240716,4호선,서울역,14337,21817,36154,18077
20240716,4호선,회현(남대문시장),30049,30419,60468,30234
20240716,4호선,명동,31824,33731,65555,32777.5
20240716,4호선,충무로,32709,33237,65946,32973
20240716,4호선,동대문역사문화공원(DDP),19323,17156,36479,18239.5
20240716,4호선,동대문,21858,22169,44027,22013.5
20240716,4호선,혜화,35226,35182,70408,35204
20240716,4호선,한성대입구(삼선교),14134,13714,27848,13924
20240716,4호선,성신여대입구(돈암),21583,21187,42770,21385
20240716,4호선,길음,22412,22318,44730,22365
20240716,4호선,미아사거리,28286,27980,56266,28133
20240716,4호선,미아(서울사이버대학),16589,15818,32407,16203.5
20240716,4호선,수유(강북구청),34862,35231,70093,35046.5
20240716,4호선,쌍문,31278,29261,60539,30269.5
20240716,4호선,창동,27578,29351,56929,28464.5
20240716,4호선,노원,29757,33111,62868,31434
20240716,4호선,상계,20620,19211,39831,19915.5
20240716,4호선,당고개,10085,8677,18762,9381
20240716,3호선,오금,7458,6578,14036,7018
20240716,3호선,경찰병원,8697,8826,17523,8761.5
20240716,3호선,가락시장,9962,9522,19484,9742
20240716,3호선,수서,19276,19400,38676,19338
20240716,3호선,일원,12652,12372,25024,12512
20240716,3호선,대청,12134,11346,23480,11740
20240716,3호선,학여울,2126,2268,4394,2197
20240716,3호선,대치,13840,13772,27612,13806
20240716,3호선,도곡,6605,6564,13169,6584.5
20240716,3호선,매봉,14369,13818,28187,14093.5
20240716,3호선,양재(서초구청),42186,45126,87312,43656
20240716,3호선,남부터미널(예술의전당),31944,32629,64573,32286.5
20240716,3호선,교대(법원.검찰청),18939,11555,30494,15247
20240716,3호선,고속터미널,46061,42585,88646,44323
20240716,3호선,잠원,5711,5451,11162,5581
20240716,3호선,신사,30552,31489,62041,31020.5
20240716,3호선,압구정,35434,37557,72991,36495.5
20240716,3호선,옥수,9367,9781,19148,9574
20240716,3호선,금호,8590,8123,16713,8356.5
20240716,3호선,약수,13496,13493,26989,13494.5
20240716,3호선,동대입구,9572,10062,19634,9817
20240716,3호선,충무로,10,0,10,5
20240716,2호선,양천구청,7330,8049,15379,7689.5
20240716,2호선,도림천,1564,1669,3233,1616.5
20240716,2호선,신설동,3596,3372,6968,3484
20240716,2호선,신답,1795,2078,3873,1936.5
20240716,2호선,용답,3077,3049,6126,3063
20240716,2호선,충정로(경기대입구),11438,12013,23451,11725.5
20240716,2호선,아현,12062,11444,23506,11753
20240716,2호선,이대,16514,18126,34640,17320
20240716,2호선,신촌,39500,39779,79279,39639.5
20240716,2호선,홍대입구,68233,71457,139690,69845
20240716,2호선,합정,32846,34687,67533,33766.5
20240716,2호선,당산,19082,22152,41234,20617
20240716,2호선,영등포구청,24854,25354,50208,25104
20240716,2호선,문래,25989,26358,52347,26173.5
20240716,2호선,신도림,53272,51326,104598,52299
20240716,2호선,대림(구로구청),25335,25811,51146,25573
20240716,2호선,구로디지털단지,62584,62126,124710,62355
20240716,2호선,신대방,26637,26094,52731,26365.5
20240716,2호선,신림,57108,55358,112466,56233
20240716,2호선,잠실나루,17245,16837,34082,17041
20240716,2호선,강변(동서울터미널),30477,28289,58766,29383
20240716,2호선,구의(광진구청),27082,26378,53460,26730
20240716,2호선,건대입구,34906,36015,70921,35460.5
20240716,2호선,성수,47216,50851,98067,49033.5
20240716,2호선,뚝섬,26200,27681,53881,26940.5
20240716,2호선,한양대,9265,9781,19046,9523
20240716,2호선,왕십리(성동구청),16344,14638,30982,15491
20240716,2호선,상왕십리,15695,15800,31495,15747.5
20240716,2호선,신당,15473,16200,31673,15836.5
20240716,2호선,동대문역사문화공원(DDP),14752,16886,31638,15819
20240716,2호선,을지로4가,15983,15653,31636,15818
20240716,2호선,을지로3가,28194,27404,55598,27799
20240716,2호선,을지로입구,53912,55554,109466,54733
20240716,2호선,시청,31952,30179,62131,31065.5
20240716,1호선,동묘앞,8257,8459,16716,8358
20240716,1호선,청량리(서울시립대입구),22331,22014,44345,22172.5
20240716,1호선,제기동,16714,16726,33440,16720
20240716,1호선,신설동,15011,14678,29689,14844.5
20240716,1호선,동대문,11469,11208,22677,11338.5
20240716,1호선,종로5가,25402,24440,49842,24921
20240716,1호선,종로3가,25483,23677,49160,24580
20240716,우이신설선,북한산보국문,6257,6172,12429,6214.5
20240716,우이신설선,정릉,4783,4615,9398,4699
20240716,우이신설선,성신여대입구(돈암),3751,3911,7662,3831
20240716,우이신설선,보문,1779,1818,3597,1798.5
20240716,우이신설선,신설동,2537,2377,4914,2457
20240716,일산선,원흥,12259,11729,23988,11994
20240716,일산선,지축,2,0,2,1
20240716,일산선,삼송,20064,19307,39371,19685.5
20240716,경부선,오산,9529,9709,19238,9619
20240716,경부선,진위,1916,1760,3676,1838
20240716,경부선,송탄,4212,4088,8300,4150
20240716,경부선,서정리,7995,7441,15436,7718
20240716,1호선,종각,44823,42980,87803,43901.5
20240716,1호선,시청,29171,28838,58009,29004.5
20240716,1호선,서울역,56435,53204,109639,54819.5
20240716,일산선,원당,11642,11099,22741,11370.5
20240716,일산선,화정,17765,18244,36009,18004.5
20240716,일산선,대곡,3220,2394,5614,2807
20240716,일산선,백석,10514,10824,21338,10669
20240716,일산선,마두,8874,9222,18096,9048
20240716,일산선,정발산,7243,7194,14437,7218.5
20240716,일산선,주엽,10515,10620,21135,10567.5
20240716,일산선,대화,14090,10895,24985,12492.5
20240716,장항선,봉명,1492,1531,3023,1511.5
20240716,장항선,쌍용(나사렛대),2226,2125,4351,2175.5
20240716,장항선,아산,3395,3108,6503,3251.5
20240716,장항선,탕정,1634,1521,3155,1577.5
20240716,장항선,배방,1216,1118,2334,1167
20240716,장항선,온양온천,4038,4033,8071,4035.5
20240716,장항선,신창(순천향대),1248,1162,2410,1205
20240716,중앙선,회기,25186,24197,49383,24691.5
20240716,중앙선,중랑,6055,5860,11915,5957.5
20240716,중앙선,상봉,5981,6020,12001,6000.5
20240716,중앙선,망우,7798,7611,15409,7704.5
20240716,중앙선,양원,3456,3486,6942,3471
20240716,중앙선,구리,13757,14044,27801,13900.5
20240716,중앙선,도농,11781,10941,22722,11361
20240716,중앙선,양정,650,515,1165,582.5
20240716,중앙선,덕소,5529,5509,11038,5519
20240716,중앙선,도심,2609,2111,4720,2360
20240716,중앙선,팔당,784,798,1582,791
20240716,중앙선,운길산,685,626,1311,655.5
20240716,중앙선,양수,2371,2454,4825,2412.5
20240716,중앙선,신원,246,234,480,240
20240716,중앙선,국수,727,677,1404,702
20240716,중앙선,아신,532,539,1071,535.5
20240716,중앙선,오빈,369,357,726,363
20240716,중앙선,양평,3163,3145,6308,3154
20240716,중앙선,원덕,355,305,660,330
20240716,중앙선,용문,1970,1940,3910,1955
20240716,중앙선,지평,76,79,155,77.5
20240716,3호선,녹번,16482,15377,31859,15929.5
20240716,3호선,불광,17637,18787,36424,18212
20240716,3호선,연신내,35829,34200,70029,35014.5
20240716,3호선,구파발,23242,22697,45939,22969.5
20240716,3호선,지축,8365,8152,16517,8258.5
20240716,2호선,용두(동대문구청),2757,2806,5563,2781.5
20240716,2호선,신정네거리,10888,11376,22264,11132
20240716,분당선,모란,20600,20853,41453,20726.5
20240716,분당선,야탑,27387,29068,56455,28227.5
20240716,분당선,서현,25662,26196,51858,25929
20240716,분당선,수내,15284,15823,31107,15553.5
20240716,분당선,정자,20529,21585,42114,21057
20240716,분당선,미금,16420,17068,33488,16744
20240716,분당선,오리,12535,10657,23192,11596
20240716,분당선,이매,6293,5897,12190,6095
20240716,분당선,보정,2966,2675,5641,2820.5
20240716,분당선,죽전,13210,14629,27839,13919.5
20240716,분당선,구성,6812,6938,13750,6875
20240716,분당선,신갈,5176,5015,10191,5095.5
20240716,분당선,기흥,11041,10124,21165,10582.5
20240716,분당선,상갈,5608,5491,11099,5549.5
20240716,경강선,이매,1153,1045,2198,1099
20240716,경강선,판교,6162,6126,12288,6144
20240716,9호선2~3단계,중앙보훈병원,13896,12353,26249,13124.5
20240716,9호선2~3단계,둔촌오륜,1632,1506,3138,1569
20240716,9호선2~3단계,올림픽공원(한국체대),5542,5810,11352,5676
20240716,9호선2~3단계,한성백제,3539,3180,6719,3359.5
20240716,9호선2~3단계,송파나루,6078,6604,12682,6341
20240716,9호선2~3단계,석촌,10420,9233,19653,9826.5
20240716,2호선,잠실(송파구청),81552,80275,161827,80913.5
20240716,경부선,노량진,7665,7780,15445,7722.5
20240716,경부선,용산,38029,39026,77055,38527.5
20240716,경부선,남영,10358,10910,21268,10634
20240716,경부선,평택지제,4179,4048,8227,4113.5
20240716,경부선,평택,11502,11422,22924,11462
20240716,경부선,성환,3974,4010,7984,3992
20240716,경부선,직산,1051,998,2049,1024.5
20240716,경부선,두정,6250,6330,12580,6290
20240716,경부선,천안,5407,5524,10931,5465.5
20240716,경부선,당정,6295,6087,12382,6191
20240716,경부선,서동탄,1653,1384,3037,1518.5
20240716,경부선,광명,3692,3273,6965,3482.5
20240716,경원선,이촌(국립중앙박물관),4313,3465,7778,3889
20240716,경원선,서빙고,2368,2171,4539,2269.5
20240716,경원선,한남,4113,3926,8039,4019.5
20240716,경원선,옥수,52,43,95,47.5
20240716,경원선,응봉,1977,1677,3654,1827
20240716,경원선,왕십리(성동구청),16897,17009,33906,16953
20240716,경원선,청량리(서울시립대입구),15637,16552,32189,16094.5
20240716,경원선,외대앞,8815,8729,17544,8772
20240716,경원선,신이문,9080,8638,17718,8859
20240716,경원선,석계,7496,8645,16141,8070.5
20240716,경원선,광운대,8332,7764,16096,8048
20240716,경원선,월계,7097,6684,13781,6890.5
20240716,경원선,녹천,4909,4150,9059,4529.5
20240716,경원선,창동,2,0,2,1
20240716,경원선,방학,10458,10106,20564,10282
20240716,경원선,도봉,6558,6428,12986,6493
20240716,경의선,수색,3711,3892,7603,3801.5
20240716,경의선,한국항공대,2193,2101,4294,2147
20240716,경의선,강매,3539,2994,6533,3266.5
20240716,경의선,행신,8425,8304,16729,8364.5
20240716,경의선,능곡,5001,4777,9778,4889
20240716,경의선,곡산,728,759,1487,743.5
20240716,경의선,백마,7963,7672,15635,7817.5
20240716,3호선,을지로3가,13461,13042,26503,13251.5
20240716,경강선,이천,2789,2994,5783,2891.5
20240716,경의선,풍산,6384,6079,12463,6231.5
20240716,경의선,일산,11290,11275,22565,11282.5
20240716,경의선,탄현,8346,8115,16461,8230.5
20240716,경의선,야당,9074,8930,18004,9002
20240716,경의선,운정,8310,7761,16071,8035.5
20240716,경의선,금릉,5589,5299,10888,5444
20240716,경의선,금촌,6786,6607,13393,6696.5
20240716,경의선,월롱,2096,1955,4051,2025.5
20240716,경의선,파주,1229,881,2110,1055
20240716,경의선,문산,5570,5218,10788,5394
20240716,경의선,임진강,15,13,28,14
20240716,경의선,운천,6,5,11,5.5
20240716,경인선,개봉,22522,22701,45223,22611.5
20240716,경인선,오류동,12195,11490,23685,11842.5
20240716,경인선,역곡,26579,26665,53244,26622
20240716,경인선,부천,30903,30731,61634,30817
20240716,경인선,송내,28050,27853,55903,27951.5
20240716,경인선,부평,28698,29603,58301,29150.5
20240716,경인선,백운,7770,7550,15320,7660
20240716,경인선,동암,15824,16019,31843,15921.5
20240716,경인선,주안,18653,16905,35558,17779
20240716,경인선,제물포,11083,10836,21919,10959.5
20240716,경인선,동인천,14162,13190,27352,13676
20240716,경인선,인천,3499,2635,6134,3067
20240716,경인선,구일,9627,10033,19660,9830
20240716,경인선,소사,7684,7327,15011,7505.5
20240716,경인선,부개,9307,8627,17934,8967
20240716,경인선,간석,6157,5934,12091,6045.5
20240716,경인선,도원,3628,3734,7362,3681
20240716,경인선,온수(성공회대입구),6895,6536,13431,6715.5
20240716,경인선,중동,9758,9132,18890,9445
20240716,경인선,도화,4377,4092,8469,4234.5
20240716,경춘선,신내,3025,2746,5771,2885.5
20240716,경춘선,갈매,3189,2742,5931,2965.5
20240716,경춘선,별내,3596,3365,6961,3480.5
20240716,경춘선,퇴계원,3714,3322,7036,3518
20240716,경춘선,사릉,2136,2055,4191,2095.5
20240716,경춘선,금곡,1536,1521,3057,1528.5
20240716,경춘선,평내호평,6269,6103,12372,6186
20240716,경춘선,천마산,1511,1423,2934,1467
20240716,경춘선,마석,3727,3662,7389,3694.5
20240716,경춘선,대성리,734,700,1434,717
20240716,경춘선,청평,2079,1834,3913,1956.5
20240716,경춘선,상천,240,233,473,236.5
20240716,경춘선,가평,2428,2162,4590,2295
20240716,경춘선,굴봉산,148,138,286,143
20240716,경춘선,백양리,83,70,153,76.5
20240716,경춘선,강촌,527,411,938,469
20240716,경춘선,김유정,361,332,693,346.5
20240716,경춘선,남춘천,2394,2367,4761,2380.5
20240716,경춘선,춘천,1227,1037,2264,1132
20240716,공항철도 1호선,서울역,12842,11288,24130,12065
20240716,공항철도 1호선,공덕,3143,4104,7247,3623.5
20240716,공항철도 1호선,홍대입구,13923,13445,27368,13684
20240716,공항철도 1호선,디지털미디어시티,15864,15084,30948,15474
20240716,공항철도 1호선,마곡나루(서울식물원),12844,12068,24912,12456
20240716,공항철도 1호선,김포공항,10273,6725,16998,8499
20240716,공항철도 1호선,계양,14246,13511,27757,13878.5
20240716,공항철도 1호선,검암,6740,6841,13581,6790.5
20240716,공항철도 1호선,청라국제도시,8134,7726,15860,7930
20240716,공항철도 1호선,운서,9689,9989,19678,9839
20240716,공항철도 1호선,공항화물청사,2263,2442,4705,2352.5
20240716,공항철도 1호선,인천공항1터미널,14179,15017,29196,14598
20240716,공항철도 1호선,인천공항2터미널,7449,6705,14154,7077
20240716,공항철도 1호선,영종,4490,4325,8815,4407.5
20240716,과천선,선바위,8035,7161,15196,7598
20240716,과천선,경마공원,1518,1546,3064,1532
20240716,과천선,대공원,2971,3008,5979,2989.5
20240716,과천선,과천,7067,6735,13802,6901
20240716,과천선,정부과천청사,13796,14444,28240,14120
20240716,과천선,인덕원,27058,28036,55094,27547
20240716,과천선,평촌,19591,19238,38829,19414.5
20240716,과천선,범계,28298,28323,56621,28310.5
20240716,분당선,선릉,15523,23367,38890,19445
20240716,분당선,한티,16858,18591,35449,17724.5
20240716,분당선,도곡,8474,8680,17154,8577
20240716,분당선,구룡,4048,3994,8042,4021
20240716,분당선,개포동,5006,5313,10319,5159.5
20240716,분당선,대모산입구,6928,6680,13608,6804
20240716,경부선,서울역,8105,3113,11218,5609
20240716,분당선,청명,4919,4777,9696,4848
20240716,분당선,영통,8976,9070,18046,9023
20240716,분당선,수서,17728,18579,36307,18153.5
20240716,분당선,복정,5,0,5,2.5
20240716,분당선,수원,7895,7173,15068,7534
20240716,분당선,서울숲,13239,13302,26541,13270.5
20240716,분당선,압구정로데오,20538,21755,42293,21146.5
20240716,분당선,강남구청,10968,12658,23626,11813
20240716,분당선,선정릉,9081,9400,18481,9240.5
20240716,분당선,가천대,8252,8464,16716,8358
20240716,분당선,망포,16666,15986,32652,16326
20240716,분당선,매탄권선,6038,5956,11994,5997
20240716,분당선,수원시청,14433,15512,29945,14972.5
20240716,분당선,매교,5814,5787,11601,5800.5
20240716,경부선,세류,3501,3248,6749,3374.5
20240716,경부선,독산,19155,19909,39064,19532
20240716,경강선,신둔도예촌,1511,1418,2929,1464.5
20240716,경강선,곤지암,2232,2205,4437,2218.5
20240716,경강선,초월,3683,3466,7149,3574.5
20240716,경강선,경기광주,8421,8047,16468,8234
20240716,경강선,삼동,2838,2615,5453,2726.5
20240716,분당선,태평,13720,13103,26823,13411.5
20240716,3호선,종로3가,12580,13495,26075,13037.5
20240716,3호선,안국,28435,29080,57515,28757.5
20240716,3호선,경복궁(정부서울청사),24198,23971,48169,24084.5
20240716,3호선,독립문,8081,8133,16214,8107
20240716,3호선,무악재,4844,4845,9689,4844.5
20240716,3호선,홍제,18833,18139,36972,18486
20240717,우이신설선,정릉,4522,4299,8821,4410.5
20240717,분당선,복정,5,0,5,2.5
20240717,1호선,서울역,54801,51416,106217,53108.5
20240717,1호선,시청,27149,27172,54321,27160.5
20240717,1호선,종각,42716,41868,84584,42292
20240717,1호선,종로3가,23566,21293,44859,22429.5
20240717,1호선,종로5가,22862,22254,45116,22558
20240717,1호선,동대문,10709,9978,20687,10343.5
20240717,1호선,신설동,14289,13821,28110,14055
20240717,1호선,제기동,14201,14031,28232,14116
20240717,1호선,청량리(서울시립대입구),20265,19340,39605,19802.5
20240717,1호선,동묘앞,7085,7145,14230,7115
20240717,2호선,시청,29973,28860,58833,29416.5
20240717,2호선,을지로입구,51753,53501,105254,52627
20240717,2호선,을지로3가,28070,27546,55616,27808
20240717,2호선,을지로4가,14869,14778,29647,14823.5
20240717,2호선,동대문역사문화공원(DDP),16132,18599,34731,17365.5
20240717,2호선,신당,14954,15450,30404,15202
20240717,2호선,상왕십리,15462,15455,30917,15458.5
20240717,2호선,왕십리(성동구청),15845,14332,30177,15088.5
20240717,2호선,한양대,8937,9528,18465,9232.5
20240717,2호선,뚝섬,25464,26909,52373,26186.5
20240717,2호선,성수,44520,48734,93254,46627
20240717,2호선,건대입구,34000,35248,69248,34624
20240717,2호선,구의(광진구청),26188,25582,51770,25885
20240717,2호선,강변(동서울터미널),29223,27136,56359,28179.5
20240717,2호선,잠실나루,16913,16244,33157,16578.5
20240717,2호선,잠실(송파구청),77520,76949,154469,77234.5
20240717,2호선,잠실새내,24894,23577,48471,24235.5
20240717,2호선,종합운동장,13010,14129,27139,13569.5
20240717,2호선,삼성(무역센터),59456,61783,121239,60619.5
20240717,2호선,선릉,65327,57439,122766,61383
20240717,2호선,역삼,59560,67714,127274,63637
20240717,2호선,강남,88007,85570,173577,86788.5
20240717,2호선,교대(법원.검찰청),34879,41492,76371,38185.5
20240717,2호선,서초,23681,23002,46683,23341.5
20240717,2호선,방배,16544,17072,33616,16808
20240717,2호선,사당,41146,43664,84810,42405
20240717,2호선,낙성대(강감찬),29311,28530,57841,28920.5
20240717,2호선,서울대입구(관악구청),47771,46404,94175,47087.5
20240717,2호선,봉천,25725,24375,50100,25050
20240717,2호선,신림,56859,54941,111800,55900
20240717,2호선,신대방,26364,25383,51747,25873.5
20240717,2호선,구로디지털단지,61208,61021,122229,61114.5
20240717,2호선,대림(구로구청),24804,25347,50151,25075.5
20240717,2호선,신도림,52279,51142,103421,51710.5
20240717,2호선,문래,25263,25828,51091,25545.5
20240717,2호선,영등포구청,24083,24804,48887,24443.5
20240717,2호선,당산,18165,21849,40014,20007
20240717,2호선,합정,31345,33551,64896,32448
20240717,2호선,홍대입구,65168,68899,134067,67033.5
20240717,2호선,신촌,37052,37889,74941,37470.5
20240717,2호선,이대,15621,17142,32763,16381.5
20240717,2호선,아현,11505,10730,22235,11117.5
20240717,2호선,충정로(경기대입구),11225,11673,22898,11449
20240717,2호선,용답,2979,2897,5876,2938
20240717,2호선,신답,1766,2006,3772,1886
20240717,2호선,신설동,3678,3633,7311,3655.5
20240717,2호선,도림천,1540,1531,3071,1535.5
20240717,2호선,양천구청,7127,7617,14744,7372
20240717,2호선,신정네거리,10322,10907,21229,10614.5
20240717,2호선,용두(동대문구청),2634,2657,5291,2645.5
20240717,3호선,지축,7650,7674,15324,7662
20240717,3호선,구파발,22105,21188,43293,21646.5
20240717,3호선,연신내,33536,31889,65425,32712.5
20240717,3호선,불광,16418,17500,33918,16959
20240717,3호선,녹번,15889,14634,30523,15261.5
20240717,3호선,홍제,17772,16956,34728,17364
20240717,3호선,무악재,4592,4477,9069,4534.5
20240717,3호선,독립문,7540,7418,14958,7479
20240717,3호선,경복궁(정부서울청사),24004,24046,48050,24025
20240717,3호선,안국,26409,26575,52984,26492
20240717,3호선,종로3가,11691,12596,24287,12143.5
20240717,3호선,을지로3가,12882,13056,25938,12969
20240717,3호선,충무로,14,0,14,7
20240717,3호선,동대입구,9122,9800,18922,9461
20240717,3호선,약수,13377,13327,26704,13352
20240717,3호선,금호,8370,7771,16141,8070.5
20240717,3호선,옥수,8992,9245,18237,9118.5
20240717,3호선,압구정,33033,35142,68175,34087.5
20240717,3호선,신사,28988,29972,58960,29480
20240717,3호선,잠원,5797,5317,11114,5557
20240717,3호선,고속터미널,44026,41012,85038,42519
20240717,3호선,교대(법원.검찰청),18655,11135,29790,14895
20240717,3호선,남부터미널(예술의전당),31174,32142,63316,31658
20240717,3호선,양재(서초구청),40611,43998,84609,42304.5
20240717,3호선,매봉,14102,13615,27717,13858.5
20240717,3호선,도곡,6510,6405,12915,6457.5
20240717,3호선,대치,12581,12645,25226,12613
20240717,3호선,학여울,2117,2172,4289,2144.5
20240717,3호선,대청,11934,11061,22995,11497.5
20240717,3호선,일원,12132,11957,24089,12044.5
20240717,3호선,수서,18902,19084,37986,18993
20240717,3호선,가락시장,9520,9188,18708,9354
20240717,3호선,경찰병원,8457,8614,17071,8535.5
20240717,3호선,오금,7123,6402,13525,6762.5
20240717,4호선,당고개,9440,7972,17412,8706
20240717,4호선,상계,19547,18330,37877,18938.5
20240717,4호선,노원,28918,32023,60941,30470.5
20240717,4호선,창동,26405,27895,54300,27150
20240717,4호선,쌍문,30853,28066,58919,29459.5
20240717,4호선,수유(강북구청),33046,33165,66211,33105.5
20240717,4호선,미아(서울사이버대학),15478,14939,30417,15208.5
20240717,4호선,미아사거리,26761,26287,53048,26524
20240717,4호선,길음,21523,21167,42690,21345
20240717,4호선,성신여대입구(돈암),20646,20088,40734,20367
20240717,4호선,한성대입구(삼선교),13400,12814,26214,13107
20240717,4호선,혜화,35557,35497,71054,35527
20240717,4호선,동대문,19683,20092,39775,19887.5
20240717,4호선,동대문역사문화공원(DDP),21372,19036,40408,20204
20240717,4호선,충무로,31633,32090,63723,31861.5
20240717,4호선,명동,30979,33058,64037,32018.5
20240717,4호선,회현(남대문시장),26387,27023,53410,26705
20240717,4호선,서울역,14428,22253,36681,18340.5
20240717,4호선,숙대입구(갈월),14441,14305,28746,14373
20240717,4호선,삼각지,6304,7151,13455,6727.5
20240717,4호선,신용산,20846,22167,43013,21506.5
20240717,4호선,이촌(국립중앙박물관),9027,9869,18896,9448
20240717,4호선,동작(현충원),1211,1342,2553,1276.5
20240717,4호선,총신대입구(이수),19657,21279,40936,20468
20240717,4호선,사당,25891,22974,48865,24432.5
20240717,4호선,남태령,1404,1212,2616,1308
20240717,5호선,방화,7045,6883,13928,6964
20240717,5호선,개화산,6236,5935,12171,6085.5
20240717,5호선,김포공항,11112,7955,19067,9533.5
20240717,5호선,송정,6459,6106,12565,6282.5
20240717,5호선,마곡,13505,13648,27153,13576.5
20240717,5호선,발산,24091,24492,48583,24291.5
20240717,5호선,우장산,15398,15094,30492,15246
20240717,5호선,화곡,29523,27792,57315,28657.5
20240717,5호선,까치산,28493,27359,55852,27926
20240717,5호선,신정(은행정),14175,11878,26053,13026.5
20240717,5호선,목동,17394,18866,36260,18130
20240717,5호선,오목교(목동운동장앞),21776,22932,44708,22354
20240717,5호선,양평,8638,8484,17122,8561
20240717,5호선,영등포구청,5047,4998,10045,5022.5
20240717,5호선,영등포시장,11721,11790,23511,11755.5
20240717,5호선,신길,5376,5506,10882,5441
20240717,5호선,여의도,33752,35422,69174,34587
20240717,5호선,여의나루,11166,12987,24153,12076.5
20240717,5호선,마포,15889,16358,32247,16123.5
20240717,5호선,공덕,16112,16899,33011,16505.5
20240717,5호선,애오개,7750,7555,15305,7652.5
20240717,5호선,충정로(경기대입구),5264,5354,10618,5309
20240717,5호선,서대문,23115,23095,46210,23105
20240717,5호선,광화문(세종문화회관),35723,37630,73353,36676.5
20240717,5호선,종로3가,13973,13839,27812,13906
20240717,5호선,을지로4가,6836,6733,13569,6784.5
20240717,5호선,동대문역사문화공원(DDP),3580,4021,7601,3800.5
20240717,5호선,청구,4200,3912,8112,4056
20240717,5호선,신금호,7221,7486,14707,7353.5
20240717,5호선,행당,8762,7781,16543,8271.5
20240717,5호선,왕십리(성동구청),4886,5710,10596,5298
20240717,5호선,마장,6185,5661,11846,5923
20240717,5호선,답십리,16929,15496,32425,16212.5
20240717,5호선,장한평,21227,21014,42241,21120.5
20240717,5호선,군자(능동),11867,13044,24911,12455.5
20240717,5호선,아차산(어린이대공원후문),14685,14226,28911,14455.5
20240717,5호선,광나루(장신대),13603,12368,25971,12985.5
20240717,5호선,천호(풍납토성),18920,18849,37769,18884.5
20240717,5호선,강동,19305,18931,38236,19118
20240717,5호선,길동,8629,8804,17433,8716.5
20240717,5호선,굽은다리(강동구민회관앞),10498,10097,20595,10297.5
20240717,5호선,명일,9104,9354,18458,9229
20240717,5호선,고덕,11378,11033,22411,11205.5
20240717,5호선,상일동,15620,14800,30420,15210
20240717,5호선,둔촌동,9158,9290,18448,9224
20240717,5호선,올림픽공원(한국체대),5659,4629,10288,5144
20240717,5호선,방이,7711,8179,15890,7945
20240717,5호선,오금,4001,4045,8046,4023
20240717,5호선,개롱,7168,7343,14511,7255.5
20240717,5호선,거여,11006,10699,21705,10852.5
20240717,5호선,마천,8017,7195,15212,7606
20240717,5호선,강일,6284,5807,12091,6045.5
20240717,5호선,미사,18183,18492,36675,18337.5
20240717,5호선,하남풍산,4583,4570,9153,4576.5
20240717,5호선,하남시청(덕풍·신장),8378,7932,16310,8155
20240717,5호선,하남검단산,6626,6137,12763,6381.5
20240717,6호선,응암,17860,17787,35647,17823.5
20240717,6호선,역촌,3974,4525,8499,4249.5
20240717,6호선,불광,4727,4489,9216,4608
20240717,6호선,독바위,2991,3084,6075,3037.5
20240717,6호선,연신내,5,0,5,2.5
20240717,6호선,구산,8623,6747,15370,7685
20240717,6호선,새절(신사),13141,12027,25168,12584
20240717,6호선,증산(명지대앞),9877,9951,19828,9914
20240717,6호선,디지털미디어시티,15732,17645,33377,16688.5
20240717,6호선,월드컵경기장(성산),3706,3910,7616,3808
20240717,6호선,마포구청,15419,14028,29447,14723.5
20240717,6호선,망원,14407,15192,29599,14799.5
20240717,6호선,합정,13280,13061,26341,13170.5
20240717,6호선,상수,9646,10741,20387,10193.5
20240717,6호선,광흥창(서강),10149,9813,19962,9981
20240717,6호선,대흥(서강대앞),9446,9938,19384,9692
20240717,6호선,공덕,20496,20133,40629,20314.5
20240717,6호선,효창공원앞,7523,6765,14288,7144
20240717,6호선,삼각지,7633,6772,14405,7202.5
20240717,6호선,녹사평(용산구청),4947,4828,9775,4887.5
20240717,6호선,이태원,10000,10381,20381,10190.5
20240717,6호선,한강진,10424,11662,22086,11043
20240717,6호선,버티고개,2265,2221,4486,2243
20240717,6호선,약수,4020,3677,7697,3848.5
20240717,6호선,청구,4210,4175,8385,4192.5
20240717,6호선,신당,9380,9731,19111,9555.5
20240717,6호선,동묘앞,7577,7955,15532,7766
20240717,6호선,창신,3670,3080,6750,3375
20240717,6호선,보문,8227,7623,15850,7925
20240717,6호선,안암(고대병원앞),11833,11752,23585,11792.5
20240717,6호선,고려대(종암),9008,8606,17614,8807
20240717,6호선,월곡(동덕여대),12046,11830,23876,11938
20240717,6호선,상월곡(한국과학기술연구원),6669,5974,12643,6321.5
20240717,6호선,돌곶이,10645,9860,20505,10252.5
20240717,6호선,석계,13186,13162,26348,13174
20240717,6호선,태릉입구,5561,6016,11577,5788.5
20240717,6호선,화랑대(서울여대입구),12316,9776,22092,11046
20240717,6호선,봉화산(서울의료원),9504,8831,18335,9167.5
20240717,7호선,장암,2995,1082,4077,2038.5
20240717,7호선,도봉산,9510,10756,20266,10133
20240717,7호선,수락산,12683,12213,24896,12448
20240717,7호선,마들,13707,12848,26555,13277.5
20240717,7호선,노원,24160,25390,49550,24775
20240717,7호선,중계,15889,14902,30791,15395.5
20240717,7호선,하계,19073,18006,37079,18539.5
20240717,7호선,공릉(서울과학기술대),11926,11971,23897,11948.5
20240717,7호선,태릉입구,8792,8044,16836,8418
20240717,7호선,먹골,10723,10626,21349,10674.5
20240717,7호선,중화,10896,10697,21593,10796.5
20240717,7호선,상봉,18043,17125,35168,17584
20240717,7호선,면목,15276,14858,30134,15067
20240717,7호선,사가정,16293,16389,32682,16341
20240717,7호선,용마산(용마폭포공원),6117,5864,11981,5990.5
20240717,7호선,중곡,11685,11005,22690,11345
20240717,7호선,군자(능동),16133,12788,28921,14460.5
20240717,7호선,어린이대공원(세종대),14241,13923,28164,14082
20240717,7호선,건대입구,13360,13439,26799,13399.5
20240717,7호선,자양(뚝섬한강공원),8097,7911,16008,8004
20240717,7호선,청담,20182,22040,42222,21111
20240717,7호선,강남구청,17761,19708,37469,18734.5
20240717,7호선,학동,27244,28192,55436,27718
20240717,7호선,논현,20390,20694,41084,20542
20240717,7호선,반포,6719,6446,13165,6582.5
20240717,7호선,고속터미널,16502,14669,31171,15585.5
20240717,7호선,내방,16091,16269,32360,16180
20240717,7호선,이수,17292,16800,34092,17046
20240717,7호선,남성,12183,11485,23668,11834
20240717,7호선,숭실대입구(살피재),12870,12863,25733,12866.5
20240717,7호선,상도,11786,11471,23257,11628.5
20240717,7호선,장승배기,9765,9551,19316,9658
20240717,7호선,신대방삼거리,15688,15069,30757,15378.5
20240717,7호선,보라매,6867,7373,14240,7120
20240717,7호선,신풍,11895,11198,23093,11546.5
20240717,7호선,대림(구로구청),8959,8934,17893,8946.5
20240717,7호선,남구로,16020,16683,32703,16351.5
20240717,7호선,가산디지털단지,50574,51019,101593,50796.5
20240717,7호선,철산,22283,22575,44858,22429
20240717,7호선,광명사거리,20180,19807,39987,19993.5
20240717,7호선,천왕,12518,12019,24537,12268.5
20240717,7호선,온수(성공회대입구),10475,9516,19991,9995.5
20240717,8호선,암사,19971,17716,37687,18843.5
20240717,8호선,천호(풍납토성),15785,17516,33301,16650.5
20240717,8호선,강동구청,11133,11801,22934,11467
20240717,8호선,몽촌토성(평화의문),7347,7482,14829,7414.5
20240717,8호선,잠실(송파구청),16547,19198,35745,17872.5
20240717,8호선,석촌,8655,9876,18531,9265.5
20240717,8호선,송파,10736,10532,21268,10634
20240717,8호선,가락시장,8168,8987,17155,8577.5
20240717,8호선,문정,25122,26525,51647,25823.5
20240717,8호선,장지,18555,17056,35611,17805.5
20240717,8호선,복정,10041,8450,18491,9245.5
20240717,8호선,산성,6584,6780,13364,6682
20240717,8호선,남한산성입구(성남법원.검찰청),13753,12372,26125,13062.5
20240717,8호선,단대오거리,12526,12383,24909,12454.5
20240717,8호선,신흥,5426,5591,11017,5508.5
20240717,8호선,수진,6048,5699,11747,5873.5
20240717,8호선,모란,4854,3625,8479,4239.5
20240717,8호선,남위례,7934,7955,15889,7944.5
20240717,9호선,개화,3087,2020,5107,2553.5
20240717,9호선,김포공항,7167,10416,17583,8791.5
20240717,9호선,공항시장,3243,3507,6750,3375
20240717,9호선,신방화,7791,7710,15501,7750.5
20240717,9호선,마곡나루(서울식물원),14563,14276,28839,14419.5
20240717,9호선,양천향교,10727,11148,21875,10937.5
20240717,9호선,가양,22944,22493,45437,22718.5
20240717,9호선,증미,9218,9027,18245,9122.5
20240717,9호선,등촌,13315,12806,26121,13060.5
20240717,9호선,염창,18581,18180,36761,18380.5
20240717,9호선,선유도,10058,9630,19688,9844
20240717,9호선,당산,20887,20737,41624,20812
20240717,9호선,국회의사당,19095,20034,39129,19564.5
20240717,9호선,여의도,34747,33117,67864,33932
20240717,9호선,샛강,7503,7646,15149,7574.5
20240717,9호선,노량진,26511,25747,52258,26129
20240717,9호선,노들,5138,4336,9474,4737
20240717,9호선,흑석(중앙대입구),8988,9400,18388,9194
20240717,9호선,동작(현충원),1731,1375,3106,1553
20240717,9호선,구반포,1389,1345,2734,1367
20240717,9호선,신반포,4337,4216,8553,4276.5
20240717,9호선,고속터미널,14026,18281,32307,16153.5
20240717,9호선,사평,4458,4293,8751,4375.5
20240717,9호선,신논현,31985,31227,63212,31606
20240717,9호선2~3단계,언주,13212,13513,26725,13362.5
20240717,9호선2~3단계,선정릉,11059,11668,22727,11363.5
20240717,9호선2~3단계,삼성중앙,8992,9408,18400,9200
20240717,9호선2~3단계,봉은사,22352,23336,45688,22844
20240717,9호선2~3단계,종합운동장,5390,5292,10682,5341
20240717,9호선2~3단계,삼전,8854,8287,17141,8570.5
20240717,9호선2~3단계,석촌고분,7814,7657,15471,7735.5
20240717,9호선2~3단계,석촌,10025,8811,18836,9418
20240717,9호선2~3단계,송파나루,6058,6597,12655,6327.5
20240717,9호선2~3단계,한성백제,3382,3008,6390,3195
20240717,9호선2~3단계,올림픽공원(한국체대),5270,5458,10728,5364
20240717,9호선2~3단계,둔촌오륜,1575,1435,3010,1505
20240717,9호선2~3단계,중앙보훈병원,13221,11564,24785,12392.5
20240717,경강선,판교,5981,6051,12032,6016
20240717,경강선,이매,1157,1033,2190,1095
20240717,경강선,삼동,2727,2469,5196,2598
20240717,경강선,경기광주,8278,7870,16148,8074
20240717,경강선,초월,3583,3455,7038,3519
20240717,경강선,곤지암,2190,2108,4298,2149
20240717,경강선,신둔도예촌,1509,1358,2867,1433.5
20240717,경강선,이천,2748,2920,5668,2834
20240717,경강선,부발,2192,2137,4329,2164.5
20240717,경강선,세종대왕릉,331,304,635,317.5
20240717,경강선,여주,2495,2520,5015,2507.5
20240717,경강선,성남,969,886,1855,927.5
20240717,경부선,서울역,8587,3229,11816,5908
20240717,경부선,남영,9975,10299,20274,10137
20240717,경부선,용산,38266,39099,77365,38682.5
20240717,경부선,노량진,7522,7586,15108,7554
20240717,경부선,대방,10830,11780,22610,11305
20240717,경부선,영등포,39281,39894,79175,39587.5
20240717,경부선,신도림,3706,4115,7821,3910.5
20240717,경부선,신길,8930,7459,16389,8194.5
20240717,경부선,구로,18060,18612,36672,18336
20240717,경부선,가산디지털단지,19103,22191,41294,20647
20240717,경부선,금천구청,11338,11607,22945,11472.5
20240717,경부선,석수,8747,8003,16750,8375
20240717,공항철도 1호선,공덕,3159,4085,7244,3622
20240717,공항철도 1호선,홍대입구,13773,13065,26838,13419
20240717,공항철도 1호선,디지털미디어시티,15721,14796,30517,15258.5
20240717,공항철도 1호선,마곡나루(서울식물원),12277,11549,23826,11913
20240717,공항철도 1호선,김포공항,10216,6399,16615,8307.5
20240717,공항철도 1호선,계양,13439,12881,26320,13160
20240717,공항철도 1호선,검암,6185,6327,12512,6256
20240717,공항철도 1호선,청라국제도시,7726,7309,15035,7517.5
20240717,공항철도 1호선,운서,9170,9526,18696,9348
20240717,공항철도 1호선,공항화물청사,2222,2343,4565,2282.5
20240717,공항철도 1호선,인천공항1터미널,14310,14338,28648,14324
20240717,공항철도 1호선,인천공항2터미널,6867,6093,12960,6480
20240717,공항철도 1호선,영종,4028,3996,8024,4012
20240717,과천선,선바위,7974,6960,14934,7467
20240717,과천선,경마공원,1583,1612,3195,1597.5
20240717,과천선,대공원,2095,2219,4314,2157
20240717,과천선,과천,6772,6331,13103,6551.5
20240717,과천선,정부과천청사,13346,13791,27137,13568.5
20240717,과천선,인덕원,26601,27767,54368,27184
20240717,과천선,평촌,19148,18821,37969,18984.5
20240717,과천선,범계,28020,27818,55838,27919
20240717,분당선,선릉,14858,22818,37676,18838
20240717,분당선,한티,16394,17975,34369,17184.5
20240717,분당선,도곡,8230,8416,16646,8323
20240717,분당선,구룡,3974,3960,7934,3967
20240717,분당선,개포동,4978,5118,10096,5048
20240717,분당선,대모산입구,6653,6135,12788,6394
20240717,분당선,수서,17653,18088,35741,17870.5
20240717,중앙선,원덕,286,257,543,271.5
20240717,분당선,수원,7913,7158,15071,7535.5
20240717,분당선,서울숲,12591,12832,25423,12711.5
20240717,분당선,압구정로데오,19306,20916,40222,20111
20240717,분당선,강남구청,10754,12260,23014,11507
20240717,분당선,선정릉,8625,9090,17715,8857.5
20240717,분당선,가천대,7357,7693,15050,7525
20240717,분당선,태평,13747,13088,26835,13417.5
20240717,분당선,모란,20158,20438,40596,20298
20240717,분당선,야탑,26784,28466,55250,27625
20240717,분당선,서현,25407,26010,51417,25708.5
20240717,분당선,수내,15389,15790,31179,15589.5
20240717,분당선,정자,20284,21324,41608,20804
20240717,분당선,미금,16512,17286,33798,16899
20240717,분당선,오리,12366,10716,23082,11541
20240717,분당선,이매,6180,5678,11858,5929
20240717,분당선,보정,2958,2550,5508,2754
20240717,분당선,죽전,13112,14370,27482,13741
20240717,분당선,구성,6471,6615,13086,6543
20240717,분당선,신갈,5090,4910,10000,5000
20240717,분당선,기흥,10701,9883,20584,10292
20240717,분당선,상갈,5554,5426,10980,5490
20240717,분당선,청명,4984,4765,9749,4874.5
20240717,분당선,영통,9132,9241,18373,9186.5
20240717,분당선,망포,16472,15845,32317,16158.5
20240717,분당선,매탄권선,5743,5537,11280,5640
20240717,분당선,수원시청,14718,15877,30595,15297.5
20240717,분당선,매교,5922,5754,11676,5838
20240717,서해선,김포공항,3005,3813,6818,3409
20240717,서해선,원종,4699,4790,9489,4744.5
20240717,서해선,부천종합운동장,2728,2230,4958,2479
20240717,수인선,고색,5787,5338,11125,5562.5
20240717,수인선,오목천,4032,3620,7652,3826
20240717,수인선,어천,1256,1225,2481,1240.5
20240717,수인선,야목,454,359,813,406.5
20240717,수인선,사리,5203,4548,9751,4875.5
20240717,수인선,달월,107,68,175,87.5
20240717,수인선,월곶,3331,2974,6305,3152.5
20240717,수인선,소래포구,4423,4005,8428,4214
20240717,수인선,인천논현,5631,5948,11579,5789.5
20240717,수인선,호구포,4098,4295,8393,4196.5
20240717,수인선,남동인더스파크,2539,2926,5465,2732.5
20240717,수인선,원인재,4397,4525,8922,4461
20240717,수인선,연수,4685,4703,9388,4694
20240717,수인선,송도,2471,2292,4763,2381.5
20240717,수인선,인하대,6592,6072,12664,6332
20240717,수인선,숭의,4217,3898,8115,4057.5
20240717,수인선,신포,1767,1915,3682,1841
20240717,수인선,인천,1009,1525,2534,1267
20240717,신림선,샛강,3328,3685,7013,3506.5
20240717,신림선,대방,3036,2526,5562,2781
20240717,신림선,서울지방병무청,3339,3720,7059,3529.5
20240717,신림선,보라매,4681,4160,8841,4420.5
20240717,신림선,보라매공원,2395,2586,4981,2490.5
20240717,신림선,보라매병원,8865,9267,18132,9066
20240717,신림선,당곡,5263,5162,10425,5212.5
20240717,신림선,신림,2116,2769,4885,2442.5
20240717,중앙선,지평,44,38,82,41
20240717,신림선,서원,3816,3387,7203,3601.5
20240717,신림선,서울대벤처타운,9903,9169,19072,9536
20240717,신림선,관악산(서울대),2558,2497,5055,2527.5
20240717,안산선,산본,16634,17586,34220,17110
20240717,안산선,대야미,5145,4576,9721,4860.5
20240717,안산선,반월,4537,4412,8949,4474.5
20240717,안산선,상록수,15072,15596,30668,15334
20240717,안산선,한대앞,9242,9262,18504,9252
20240717,안산선,중앙,18316,19211,37527,18763.5
20240717,안산선,고잔,9356,8728,18084,9042
20240717,안산선,초지,5163,5171,10334,5167
20240717,안산선,안산,12010,11037,23047,11523.5
20240717,안산선,신길온천,2058,1792,3850,1925
20240717,안산선,정왕,9057,9185,18242,9121
20240717,안산선,오이도,7579,7403,14982,7491
20240717,안산선,수리산,4307,3575,7882,3941
20240717,우이신설선,북한산우이,2370,2098,4468,2234
20240717,우이신설선,솔밭공원,2577,2591,5168,2584
20240717,우이신설선,4.19민주묘지,2834,2697,5531,2765.5
20240717,우이신설선,가오리,4351,4457,8808,4404
20240717,우이신설선,화계,3591,3439,7030,3515
20240717,우이신설선,삼양,2078,2115,4193,2096.5
20240717,우이신설선,삼양사거리,2472,2498,4970,2485
20240717,우이신설선,솔샘,6130,5989,12119,6059.5
20240717,우이신설선,북한산보국문,5959,5902,11861,5930.5
20240717,우이신설선,성신여대입구(돈암),3486,3649,7135,3567.5
20240717,우이신설선,보문,1635,1605,3240,1620
20240717,우이신설선,신설동,2340,2211,4551,2275.5
20240717,일산선,원흥,11192,10692,21884,10942
20240717,일산선,지축,3,0,3,1.5
20240717,일산선,삼송,18657,18048,36705,18352.5
20240717,일산선,원당,10560,9912,20472,10236
20240717,일산선,화정,16702,17101,33803,16901.5
20240717,일산선,대곡,2826,2160,4986,2493
20240717,일산선,백석,9540,9686,19226,9613
20240717,일산선,마두,8092,8200,16292,8146
20240717,일산선,정발산,7046,6957,14003,7001.5
20240717,일산선,주엽,9385,9499,18884,9442
20240717,일산선,대화,13545,10511,24056,12028
20240717,장항선,봉명,1553,1586,3139,1569.5
20240717,장항선,쌍용(나사렛대),2264,2143,4407,2203.5
20240717,장항선,아산,3442,3129,6571,3285.5
20240717,장항선,탕정,1651,1517,3168,1584
20240717,장항선,배방,1259,1162,2421,1210.5
20240717,장항선,온양온천,3950,4027,7977,3988.5
20240717,장항선,신창(순천향대),1113,1066,2179,1089.5
20240717,중앙선,회기,23664,22515,46179,23089.5
20240717,중앙선,중랑,5408,5139,10547,5273.5
20240717,중앙선,상봉,5600,5837,11437,5718.5
20240717,중앙선,망우,7028,6806,13834,6917
20240717,중앙선,양원,3131,3210,6341,3170.5
20240717,중앙선,구리,12468,12790,25258,12629
20240717,중앙선,도농,10956,10392,21348,10674
20240717,중앙선,양정,521,498,1019,509.5
20240717,중앙선,덕소,5009,5052,10061,5030.5
20240717,중앙선,도심,2370,1925,4295,2147.5
20240717,중앙선,팔당,694,626,1320,660
20240717,중앙선,운길산,543,530,1073,536.5
20240717,중앙선,양수,1633,1756,3389,1694.5
20240717,중앙선,신원,133,122,255,127.5
20240717,중앙선,국수,644,625,1269,634.5
20240717,중앙선,아신,414,429,843,421.5
20240717,중앙선,오빈,267,265,532,266
20240717,중앙선,양평,2765,2715,5480,2740
20240717,중앙선,용문,1550,1570,3120,1560
20240717,경부선,진위,1879,1739,3618,1809
20240717,경부선,송탄,4296,4211,8507,4253.5
20240717,경부선,서정리,8315,7783,16098,8049
20240717,경부선,평택지제,3989,3904,7893,3946.5
20240717,경부선,평택,11633,11439,23072,11536
20240717,경부선,성환,3877,3860,7737,3868.5
20240717,경부선,직산,1016,950,1966,983
20240717,경부선,두정,6464,6485,12949,6474.5
20240717,경부선,천안,5459,5658,11117,5558.5
20240717,경부선,당정,6184,5844,12028,6014
20240717,경부선,서동탄,1604,1288,2892,1446
20240717,경부선,광명,3517,3153,6670,3335
20240717,경원선,이촌(국립중앙박물관),4013,3216,7229,3614.5
20240717,경원선,서빙고,2272,2022,4294,2147
20240717,경원선,한남,4008,3706,7714,3857
20240717,경원선,옥수,50,49,99,49.5
20240717,경원선,응봉,1853,1779,3632,1816
20240717,경원선,왕십리(성동구청),16519,16729,33248,16624
20240717,경원선,청량리(서울시립대입구),13986,14809,28795,14397.5
20240717,경원선,외대앞,8132,7925,16057,8028.5
20240717,경원선,신이문,8653,7996,16649,8324.5
20240717,경원선,석계,6538,8025,14563,7281.5
20240717,경원선,광운대,7827,7626,15453,7726.5
20240717,경원선,월계,6296,6019,12315,6157.5
20240717,경원선,녹천,4449,4227,8676,4338
20240717,경원선,창동,4,0,4,2
20240717,경원선,방학,9233,9016,18249,9124.5
20240717,경원선,도봉,5426,6018,11444,5722
20240717,경원선,도봉산,7168,5167,12335,6167.5
20240717,경원선,망월사,6799,6927,13726,6863
20240717,경원선,회룡,11719,13141,24860,12430
20240717,경원선,의정부,15840,16112,31952,15976
20240717,경원선,가능,5735,5644,11379,5689.5
20240717,경원선,녹양,4141,3561,7702,3851
20240717,경원선,양주,6491,6339,12830,6415
20240717,경원선,덕계,5411,4985,10396,5198
20240717,경원선,덕정,5239,4909,10148,5074
20240717,경원선,지행,5197,5360,10557,5278.5
20240717,경원선,동두천중앙,2305,2163,4468,2234
20240717,경원선,보산,1093,994,2087,1043.5
20240717,경원선,동두천,1391,1353,2744,1372
20240717,경원선,소요산,691,718,1409,704.5
20240717,경원선,청산,92,93,185,92.5
20240717,경원선,전곡,628,593,1221,610.5
20240717,경원선,연천,571,615,1186,593
20240717,경의선,서울역,4871,5428,10299,5149.5
20240717,경의선,신촌,1041,1243,2284,1142
20240717,경의선,효창공원앞,3394,3897,7291,3645.5
20240717,경의선,공덕,4603,3503,8106,4053
20240717,경의선,서강대,2215,2031,4246,2123
20240717,경의선,홍대입구,1910,2270,4180,2090
20240717,경의선,가좌,5897,5696,11593,5796.5
20240717,경의선,디지털미디어시티,2917,2629,5546,2773
20240717,9호선,신목동,4734,4317,9051,4525.5
20240717,경의선,수색,3456,3614,7070,3535
20240717,경의선,한국항공대,2038,1861,3899,1949.5
20240717,경의선,강매,3339,2713,6052,3026
20240717,경의선,행신,7907,7981,15888,7944
20240717,경의선,능곡,4630,4417,9047,4523.5
20240717,경의선,곡산,585,666,1251,625.5
20240717,경의선,백마,7340,7236,14576,7288
20240717,경의선,풍산,5820,5583,11403,5701.5
20240717,경의선,일산,10457,10490,20947,10473.5
20240717,경의선,탄현,7557,7413,14970,7485
20240717,경의선,야당,8289,8484,16773,8386.5
20240717,경의선,운정,7689,7315,15004,7502
20240717,경의선,금릉,5117,4942,10059,5029.5
20240717,경의선,금촌,5949,5696,11645,5822.5
20240717,경의선,월롱,1916,1686,3602,1801
20240717,경의선,파주,1122,801,1923,961.5
20240717,경의선,문산,4549,4427,8976,4488
20240717,경의선,임진강,6,3,9,4.5
20240717,경의선,운천,3,2,5,2.5
20240717,경인선,개봉,21715,21206,42921,21460.5
20240717,경인선,오류동,11376,10721,22097,11048.5
20240717,경인선,역곡,25538,25432,50970,25485
20240717,경인선,부천,29995,29981,59976,29988
20240717,경인선,송내,27099,26898,53997,26998.5
20240717,경인선,부평,27814,28731,56545,28272.5
20240717,경인선,백운,7639,7420,15059,7529.5
20240717,경인선,동암,15105,15327,30432,15216
20240717,경인선,주안,18274,16710,34984,17492
20240717,경인선,제물포,10772,10479,21251,10625.5
20240717,경인선,동인천,13801,12916,26717,13358.5
20240717,경인선,인천,3153,2525,5678,2839
20240717,경인선,구일,8515,8679,17194,8597
20240717,경인선,소사,7431,7077,14508,7254
20240717,경인선,부개,8766,8342,17108,8554
20240717,경인선,간석,5883,5688,11571,5785.5
20240717,경인선,도원,3616,3614,7230,3615
20240717,경인선,온수(성공회대입구),6715,6428,13143,6571.5
20240717,경인선,중동,9348,8706,18054,9027
20240717,경인선,도화,4147,3800,7947,3973.5
20240717,경춘선,신내,2786,2692,5478,2739
20240717,경춘선,갈매,2861,2480,5341,2670.5
20240717,경춘선,별내,3251,3087,6338,3169
20240717,경춘선,퇴계원,3271,3009,6280,3140
20240717,경춘선,사릉,1910,1942,3852,1926
20240717,경춘선,금곡,1340,1273,2613,1306.5
20240717,경춘선,평내호평,5614,5627,11241,5620.5
20240717,경춘선,천마산,1337,1280,2617,1308.5
20240717,경춘선,마석,3155,3021,6176,3088
20240717,경춘선,대성리,501,730,1231,615.5
20240717,경춘선,청평,1451,1515,2966,1483
20240717,경춘선,상천,190,171,361,180.5
20240717,경춘선,가평,1882,1759,3641,1820.5
20240717,경춘선,굴봉산,92,69,161,80.5
20240717,경춘선,백양리,48,33,81,40.5
20240717,경춘선,강촌,290,279,569,284.5
20240717,경춘선,김유정,227,235,462,231
20240717,경춘선,남춘천,2054,1977,4031,2015.5
20240717,경춘선,춘천,853,721,1574,787
20240717,공항철도 1호선,서울역,12435,11014,23449,11724.5
20240717,경부선,관악,7290,6885,14175,7087.5
20240717,경부선,안양,21252,21196,42448,21224
20240717,경부선,명학,9064,8973,18037,9018.5
20240717,경부선,금정,29342,29714,59056,29528
20240717,경부선,군포,7575,7417,14992,7496
20240717,경부선,의왕,9287,9239,18526,9263
20240717,경부선,성균관대,15326,15029,30355,15177.5
20240717,경부선,화서,11487,11047,22534,11267
20240717,경부선,수원,34041,35577,69618,34809
20240717,경부선,독산,18566,19173,37739,18869.5
20240717,경부선,세류,3552,3170,6722,3361
20240717,경부선,병점,14701,14516,29217,14608.5
20240717,경부선,세마,3322,3160,6482,3241
20240717,경부선,오산대,3702,3334,7036,3518
20240717,경부선,오산,9641,9697,19338,9669
20240718,경원선,신이문,8249,7544,15793,7896.5
20240718,중앙선,지평,35,33,68,34
20240718,1호선,서울역,54410,51906,106316,53158
20240718,1호선,시청,26350,26736,53086,26543
20240718,1호선,종각,40368,41213,81581,40790.5
20240718,1호선,종로3가,22421,20259,42680,21340
20240718,1호선,종로5가,21395,21107,42502,21251
20240718,1호선,동대문,10101,9390,19491,9745.5
20240718,1호선,신설동,14175,13488,27663,13831.5
20240718,1호선,제기동,13174,12590,25764,12882
20240718,1호선,청량리(서울시립대입구),19144,18310,37454,18727
20240718,1호선,동묘앞,6111,6304,12415,6207.5
20240718,2호선,시청,29495,29267,58762,29381
20240718,2호선,을지로입구,51581,54775,106356,53178
20240718,2호선,을지로3가,27081,27307,54388,27194
20240718,2호선,을지로4가,14905,14798,29703,14851.5
20240718,2호선,동대문역사문화공원(DDP),15356,18014,33370,16685
20240718,2호선,신당,14561,15090,29651,14825.5
20240718,2호선,상왕십리,15323,15007,30330,15165
20240718,2호선,왕십리(성동구청),15693,14165,29858,14929
20240718,2호선,한양대,8917,9562,18479,9239.5
20240718,2호선,뚝섬,24999,26949,51948,25974
20240718,2호선,성수,43517,47896,91413,45706.5
20240718,2호선,건대입구,32834,34841,67675,33837.5
20240718,2호선,구의(광진구청),25480,24746,50226,25113
20240718,2호선,강변(동서울터미널),28598,27124,55722,27861
20240718,2호선,잠실나루,16255,15456,31711,15855.5
20240718,2호선,잠실(송파구청),77326,77517,154843,77421.5
20240718,2호선,잠실새내,24689,23497,48186,24093
20240718,2호선,종합운동장,8761,9012,17773,8886.5
20240718,2호선,삼성(무역센터),60088,62287,122375,61187.5
20240718,2호선,선릉,63432,56028,119460,59730
20240718,2호선,역삼,58777,67501,126278,63139
20240718,2호선,강남,84502,82951,167453,83726.5
20240718,2호선,교대(법원.검찰청),34262,41246,75508,37754
20240718,2호선,서초,22939,22677,45616,22808
20240718,2호선,방배,16107,16544,32651,16325.5
20240718,2호선,사당,39318,41908,81226,40613
20240718,2호선,낙성대(강감찬),28116,26954,55070,27535
20240718,2호선,서울대입구(관악구청),45528,44398,89926,44963
20240718,2호선,봉천,24497,22995,47492,23746
20240718,2호선,신림,54652,52203,106855,53427.5
20240718,2호선,신대방,24832,24056,48888,24444
20240718,2호선,구로디지털단지,59934,59588,119522,59761
20240718,2호선,대림(구로구청),22978,23441,46419,23209.5
20240718,2호선,신도림,51367,50271,101638,50819
20240718,2호선,문래,24637,25248,49885,24942.5
20240718,2호선,영등포구청,23399,24291,47690,23845
20240718,2호선,당산,17666,20984,38650,19325
20240718,2호선,합정,31154,33250,64404,32202
20240718,2호선,홍대입구,62162,67596,129758,64879
20240718,2호선,신촌,36384,37365,73749,36874.5
20240718,2호선,이대,15871,17035,32906,16453
20240718,2호선,아현,11248,10188,21436,10718
20240718,2호선,충정로(경기대입구),11068,11373,22441,11220.5
20240718,2호선,용답,2888,2844,5732,2866
20240718,2호선,신답,1797,1974,3771,1885.5
20240718,2호선,신설동,3648,3810,7458,3729
20240718,2호선,도림천,1492,1537,3029,1514.5
20240718,2호선,양천구청,7046,7452,14498,7249
20240718,2호선,신정네거리,10258,10797,21055,10527.5
20240718,2호선,용두(동대문구청),2491,2509,5000,2500
20240718,3호선,지축,7592,7577,15169,7584.5
20240718,3호선,구파발,22086,20859,42945,21472.5
20240718,3호선,연신내,33048,31250,64298,32149
20240718,3호선,불광,15910,16992,32902,16451
20240718,3호선,녹번,15860,14327,30187,15093.5
20240718,3호선,홍제,17360,16213,33573,16786.5
20240718,3호선,무악재,4622,4422,9044,4522
20240718,3호선,독립문,6904,6849,13753,6876.5
20240718,3호선,경복궁(정부서울청사),22655,22570,45225,22612.5
20240718,3호선,안국,24938,25829,50767,25383.5
20240718,3호선,종로3가,11087,12472,23559,11779.5
20240718,3호선,을지로3가,12407,13223,25630,12815
20240718,3호선,충무로,5,0,5,2.5
20240718,3호선,동대입구,8932,9577,18509,9254.5
20240718,3호선,약수,13195,12787,25982,12991
20240718,3호선,금호,8289,7644,15933,7966.5
20240718,3호선,옥수,8871,9096,17967,8983.5
20240718,3호선,압구정,32767,35097,67864,33932
20240718,3호선,신사,28562,30196,58758,29379
20240718,3호선,잠원,5270,4929,10199,5099.5
20240718,3호선,고속터미널,43651,40774,84425,42212.5
20240718,3호선,교대(법원.검찰청),18952,11346,30298,15149
20240718,3호선,남부터미널(예술의전당),30509,31156,61665,30832.5
20240718,3호선,양재(서초구청),40223,42957,83180,41590
20240718,3호선,매봉,13699,13223,26922,13461
20240718,3호선,도곡,6310,6284,12594,6297
20240718,3호선,대치,12895,12723,25618,12809
20240718,3호선,학여울,2020,2053,4073,2036.5
20240718,3호선,대청,11533,10662,22195,11097.5
20240718,3호선,일원,12264,12085,24349,12174.5
20240718,3호선,수서,18719,18795,37514,18757
20240718,3호선,가락시장,9248,8852,18100,9050
20240718,3호선,경찰병원,8347,8628,16975,8487.5
20240718,3호선,오금,7043,6135,13178,6589
20240718,4호선,당고개,9271,7708,16979,8489.5
20240718,4호선,상계,19673,18454,38127,19063.5
20240718,4호선,노원,29033,32157,61190,30595
20240718,4호선,창동,25847,27727,53574,26787
20240718,4호선,쌍문,30343,28325,58668,29334
20240718,4호선,수유(강북구청),32737,32817,65554,32777
20240718,4호선,미아(서울사이버대학),15299,14820,30119,15059.5
20240718,4호선,미아사거리,26793,26029,52822,26411
20240718,4호선,길음,21460,20796,42256,21128
20240718,4호선,성신여대입구(돈암),20241,19710,39951,19975.5
20240718,4호선,한성대입구(삼선교),13220,12575,25795,12897.5
20240718,4호선,혜화,33943,34556,68499,34249.5
20240718,4호선,동대문,18768,19412,38180,19090
20240718,4호선,동대문역사문화공원(DDP),21024,18487,39511,19755.5
20240718,4호선,충무로,31696,32214,63910,31955
20240718,4호선,명동,30230,31952,62182,31091
20240718,4호선,회현(남대문시장),24663,25589,50252,25126
20240718,4호선,서울역,14111,22973,37084,18542
20240718,4호선,숙대입구(갈월),14073,13997,28070,14035
20240718,4호선,삼각지,6438,7048,13486,6743
20240718,4호선,신용산,20711,22233,42944,21472
20240718,4호선,이촌(국립중앙박물관),8741,9669,18410,9205
20240718,4호선,동작(현충원),1052,1136,2188,1094
20240718,4호선,총신대입구(이수),18554,19676,38230,19115
20240718,4호선,사당,24914,21819,46733,23366.5
20240718,4호선,남태령,1301,1194,2495,1247.5
20240718,5호선,방화,6901,6616,13517,6758.5
20240718,5호선,개화산,6238,5930,12168,6084
20240718,5호선,김포공항,10979,7774,18753,9376.5
20240718,5호선,송정,6272,5869,12141,6070.5
20240718,5호선,마곡,12919,13405,26324,13162
20240718,5호선,발산,22949,23862,46811,23405.5
20240718,5호선,우장산,15119,14631,29750,14875
20240718,5호선,화곡,28456,26393,54849,27424.5
20240718,5호선,까치산,27892,26708,54600,27300
20240718,5호선,신정(은행정),13980,11581,25561,12780.5
20240718,5호선,목동,17147,18464,35611,17805.5
20240718,5호선,오목교(목동운동장앞),21415,22888,44303,22151.5
20240718,5호선,양평,8377,8221,16598,8299
20240718,5호선,영등포구청,4935,4948,9883,4941.5
20240718,5호선,영등포시장,11525,11459,22984,11492
20240718,5호선,신길,5389,5523,10912,5456
20240718,5호선,여의도,33124,35908,69032,34516
20240718,5호선,여의나루,10408,12070,22478,11239
20240718,5호선,마포,15853,16240,32093,16046.5
20240718,5호선,공덕,16132,17020,33152,16576
20240718,5호선,애오개,7618,7506,15124,7562
20240718,5호선,충정로(경기대입구),5296,5427,10723,5361.5
20240718,5호선,서대문,22459,22936,45395,22697.5
20240718,5호선,광화문(세종문화회관),34894,37578,72472,36236
20240718,5호선,종로3가,13634,13426,27060,13530
20240718,5호선,을지로4가,6622,6705,13327,6663.5
20240718,5호선,동대문역사문화공원(DDP),3602,4095,7697,3848.5
20240718,5호선,청구,4023,3846,7869,3934.5
20240718,5호선,신금호,6908,7301,14209,7104.5
20240718,5호선,행당,8648,7537,16185,8092.5
20240718,5호선,왕십리(성동구청),4733,5371,10104,5052
20240718,5호선,마장,6309,5742,12051,6025.5
20240718,5호선,답십리,16949,15142,32091,16045.5
20240718,5호선,장한평,21275,20902,42177,21088.5
20240718,5호선,군자(능동),11642,12509,24151,12075.5
20240718,5호선,아차산(어린이대공원후문),14379,13898,28277,14138.5
20240718,5호선,광나루(장신대),13357,12300,25657,12828.5
20240718,5호선,천호(풍납토성),18351,18337,36688,18344
20240718,5호선,강동,19025,18468,37493,18746.5
20240718,5호선,길동,8304,8585,16889,8444.5
20240718,5호선,굽은다리(강동구민회관앞),9923,9697,19620,9810
20240718,5호선,명일,8922,9195,18117,9058.5
20240718,5호선,고덕,11412,10926,22338,11169
20240718,5호선,상일동,15723,14744,30467,15233.5
20240718,5호선,둔촌동,8948,8954,17902,8951
20240718,5호선,올림픽공원(한국체대),5268,4392,9660,4830
20240718,5호선,방이,7634,7797,15431,7715.5
20240718,5호선,오금,3955,4016,7971,3985.5
20240718,5호선,개롱,6917,7123,14040,7020
20240718,5호선,거여,10647,10410,21057,10528.5
20240718,5호선,마천,7729,6905,14634,7317
20240718,5호선,강일,5883,5585,11468,5734
20240718,5호선,미사,17910,17837,35747,17873.5
20240718,5호선,하남풍산,4423,4520,8943,4471.5
20240718,5호선,하남시청(덕풍·신장),8091,7667,15758,7879
20240718,5호선,하남검단산,6390,6081,12471,6235.5
20240718,6호선,응암,17609,17391,35000,17500
20240718,6호선,역촌,3920,4311,8231,4115.5
20240718,6호선,불광,4562,4383,8945,4472.5
20240718,6호선,독바위,3045,3077,6122,3061
20240718,6호선,연신내,5,0,5,2.5
20240718,6호선,구산,8383,6439,14822,7411
20240718,6호선,새절(신사),13063,11958,25021,12510.5
20240718,6호선,증산(명지대앞),9930,9708,19638,9819
20240718,6호선,디지털미디어시티,16191,17947,34138,17069
20240718,6호선,월드컵경기장(성산),3597,3692,7289,3644.5
20240718,6호선,마포구청,15169,13705,28874,14437
20240718,6호선,망원,14473,15522,29995,14997.5
20240718,6호선,합정,13214,12981,26195,13097.5
20240718,6호선,상수,9425,10461,19886,9943
20240718,6호선,광흥창(서강),10124,9736,19860,9930
20240718,6호선,대흥(서강대앞),9501,9916,19417,9708.5
20240718,6호선,공덕,20634,20118,40752,20376
20240718,6호선,효창공원앞,7380,6521,13901,6950.5
20240718,6호선,삼각지,7536,6729,14265,7132.5
20240718,6호선,녹사평(용산구청),4876,4792,9668,4834
20240718,6호선,이태원,9723,10374,20097,10048.5
20240718,6호선,한강진,9022,10823,19845,9922.5
20240718,6호선,버티고개,2296,2157,4453,2226.5
20240718,6호선,약수,3810,3732,7542,3771
20240718,6호선,청구,4247,4047,8294,4147
20240718,6호선,신당,9080,9496,18576,9288
20240718,6호선,동묘앞,7722,7853,15575,7787.5
20240718,6호선,창신,3757,2960,6717,3358.5
20240718,6호선,보문,8220,7481,15701,7850.5
20240718,6호선,안암(고대병원앞),11932,11902,23834,11917
20240718,6호선,고려대(종암),9073,8513,17586,8793
20240718,6호선,월곡(동덕여대),12224,11893,24117,12058.5
20240718,6호선,상월곡(한국과학기술연구원),7304,6632,13936,6968
20240718,6호선,돌곶이,10994,9750,20744,10372
20240718,6호선,석계,13217,13234,26451,13225.5
20240718,6호선,태릉입구,5545,6305,11850,5925
20240718,6호선,화랑대(서울여대입구),12297,9567,21864,10932
20240718,6호선,봉화산(서울의료원),9544,8841,18385,9192.5
20240718,7호선,장암,3229,1684,4913,2456.5
20240718,7호선,도봉산,11360,14594,25954,12977
20240718,7호선,수락산,13338,13297,26635,13317.5
20240718,7호선,마들,14302,13162,27464,13732
20240718,7호선,노원,25006,26764,51770,25885
20240718,7호선,중계,15696,14101,29797,14898.5
20240718,7호선,하계,19306,17845,37151,18575.5
20240718,7호선,공릉(서울과학기술대),12369,12220,24589,12294.5
20240718,7호선,태릉입구,8864,8252,17116,8558
20240718,7호선,먹골,10697,10386,21083,10541.5
20240718,7호선,중화,11044,10833,21877,10938.5
20240718,7호선,상봉,18030,16898,34928,17464
20240718,7호선,면목,15072,14404,29476,14738
20240718,7호선,사가정,16269,16267,32536,16268
20240718,7호선,용마산(용마폭포공원),6017,5669,11686,5843
20240718,7호선,중곡,11477,10834,22311,11155.5
20240718,7호선,군자(능동),15952,12464,28416,14208
20240718,7호선,어린이대공원(세종대),13874,13499,27373,13686.5
20240718,7호선,건대입구,13458,13473,26931,13465.5
20240718,7호선,자양(뚝섬한강공원),7837,7610,15447,7723.5
20240718,7호선,청담,20376,22223,42599,21299.5
20240718,7호선,강남구청,17759,19568,37327,18663.5
20240718,7호선,학동,26740,28028,54768,27384
20240718,7호선,논현,19841,20101,39942,19971
20240718,7호선,반포,6594,6278,12872,6436
20240718,7호선,고속터미널,16339,14348,30687,15343.5
20240718,7호선,내방,15525,15695,31220,15610
20240718,7호선,이수,16180,15991,32171,16085.5
20240718,7호선,남성,11780,10954,22734,11367
20240718,7호선,숭실대입구(살피재),12376,12168,24544,12272
20240718,7호선,상도,11311,11064,22375,11187.5
20240718,7호선,장승배기,9223,8962,18185,9092.5
20240718,7호선,신대방삼거리,15164,14288,29452,14726
20240718,7호선,보라매,6703,6917,13620,6810
20240718,7호선,신풍,11456,10561,22017,11008.5
20240718,7호선,대림(구로구청),8308,8339,16647,8323.5
20240718,7호선,남구로,15544,16118,31662,15831
20240718,7호선,가산디지털단지,49431,50186,99617,49808.5
20240718,7호선,철산,21626,21786,43412,21706
20240718,7호선,광명사거리,19082,18851,37933,18966.5
20240718,7호선,천왕,12045,11669,23714,11857
20240718,7호선,온수(성공회대입구),10097,9165,19262,9631
20240718,8호선,암사,19522,17334,36856,18428
20240718,8호선,천호(풍납토성),15262,17215,32477,16238.5
20240718,8호선,강동구청,11107,11602,22709,11354.5
20240718,8호선,몽촌토성(평화의문),7096,7215,14311,7155.5
20240718,8호선,잠실(송파구청),16329,19258,35587,17793.5
20240718,8호선,석촌,8457,9350,17807,8903.5
20240718,8호선,송파,10923,10349,21272,10636
20240718,8호선,가락시장,8118,8824,16942,8471
20240718,8호선,문정,24818,26397,51215,25607.5
20240718,8호선,장지,17680,16233,33913,16956.5
20240718,8호선,복정,9528,8077,17605,8802.5
20240718,8호선,산성,6523,6520,13043,6521.5
20240718,8호선,남한산성입구(성남법원.검찰청),13174,11780,24954,12477
20240718,8호선,단대오거리,11837,11694,23531,11765.5
20240718,8호선,신흥,5303,5353,10656,5328
20240718,8호선,수진,5728,5211,10939,5469.5
20240718,8호선,모란,4659,3619,8278,4139
20240718,8호선,남위례,7544,7522,15066,7533
20240718,9호선,개화,3053,1966,5019,2509.5
20240718,9호선,김포공항,7095,10424,17519,8759.5
20240718,9호선,공항시장,3150,3361,6511,3255.5
20240718,9호선,신방화,7707,7462,15169,7584.5
20240718,9호선,마곡나루(서울식물원),14336,14267,28603,14301.5
20240718,9호선,양천향교,10691,11008,21699,10849.5
20240718,9호선,가양,22624,22092,44716,22358
20240718,9호선,증미,9112,8887,17999,8999.5
20240718,9호선,등촌,13102,12345,25447,12723.5
20240718,9호선,염창,18469,17682,36151,18075.5
20240718,9호선,신목동,4797,4196,8993,4496.5
20240718,9호선,선유도,9752,9327,19079,9539.5
20240718,9호선,당산,20742,20248,40990,20495
20240718,9호선,국회의사당,19376,20682,40058,20029
20240718,9호선,여의도,33700,33172,66872,33436
20240718,9호선,샛강,7202,7376,14578,7289
20240718,9호선,노량진,25773,24914,50687,25343.5
20240718,9호선,노들,5074,4113,9187,4593.5
20240718,9호선,흑석(중앙대입구),9017,9318,18335,9167.5
20240718,9호선,동작(현충원),1695,1409,3104,1552
20240718,9호선,구반포,1340,1280,2620,1310
20240718,9호선,신반포,4235,4111,8346,4173
20240718,9호선,고속터미널,13678,18181,31859,15929.5
20240718,9호선,사평,4634,4358,8992,4496
20240718,9호선,신논현,30400,30341,60741,30370.5
20240718,9호선2~3단계,언주,13003,13553,26556,13278
20240718,9호선2~3단계,선정릉,10936,11402,22338,11169
20240718,9호선2~3단계,삼성중앙,8869,9187,18056,9028
20240718,9호선2~3단계,봉은사,22344,23623,45967,22983.5
20240718,9호선2~3단계,종합운동장,5188,5204,10392,5196
20240718,9호선2~3단계,삼전,8804,8213,17017,8508.5
20240718,9호선2~3단계,석촌고분,7744,7432,15176,7588
20240718,9호선2~3단계,석촌,9680,8743,18423,9211.5
20240718,9호선2~3단계,송파나루,6016,6477,12493,6246.5
20240718,9호선2~3단계,한성백제,3183,2949,6132,3066
20240718,9호선2~3단계,올림픽공원(한국체대),5173,5263,10436,5218
20240718,9호선2~3단계,둔촌오륜,1531,1374,2905,1452.5
20240718,9호선2~3단계,중앙보훈병원,13108,11418,24526,12263
20240718,경강선,판교,5782,5736,11518,5759
20240718,경강선,이매,1051,924,1975,987.5
20240718,경강선,삼동,2644,2398,5042,2521
20240718,경강선,경기광주,7743,7252,14995,7497.5
20240718,경강선,초월,3358,3277,6635,3317.5
20240718,경강선,곤지암,1985,1936,3921,1960.5
20240718,경강선,신둔도예촌,1355,1254,2609,1304.5
20240718,경강선,이천,2446,2676,5122,2561
20240718,경강선,부발,1940,1882,3822,1911
20240718,경강선,세종대왕릉,287,255,542,271
20240718,경강선,여주,2190,2163,4353,2176.5
20240718,경강선,성남,1081,899,1980,990
20240718,경부선,서울역,8499,3641,12140,6070
20240718,경부선,남영,9678,9812,19490,9745
20240718,경부선,용산,37311,38751,76062,38031
20240718,경부선,노량진,7088,7290,14378,7189
20240718,경부선,대방,10375,11191,21566,10783
20240718,경부선,영등포,36825,37485,74310,37155
20240718,경부선,신도림,3329,3871,7200,3600
20240718,경부선,신길,8780,7062,15842,7921
20240718,경부선,구로,17093,17909,35002,17501
20240718,경부선,가산디지털단지,18334,21176,39510,19755
20240718,경부선,금천구청,10319,10392,20711,10355.5
20240718,경부선,석수,8119,7398,15517,7758.5
20240718,경부선,관악,6604,6465,13069,6534.5
20240718,경부선,안양,19331,19164,38495,19247.5
20240718,경부선,명학,8790,8917,17707,8853.5
20240718,경부선,금정,27434,28029,55463,27731.5
20240718,경부선,군포,7000,7122,14122,7061
20240718,경부선,의왕,8580,8685,17265,8632.5
20240718,경부선,성균관대,14018,13680,27698,13849
20240718,경부선,화서,9951,9427,19378,9689
20240718,경부선,수원,30181,31756,61937,30968.5
20240718,경부선,독산,17638,18533,36171,18085.5
20240718,경부선,세류,3045,2797,5842,2921
20240718,경부선,병점,12950,12820,25770,12885
20240718,경부선,세마,2914,2756,5670,2835
20240718,경부선,오산대,3029,2840,5869,2934.5
20240718,경부선,오산,8050,8030,16080,8040
20240718,경부선,진위,1449,1352,2801,1400.5
20240718,경부선,송탄,3543,3420,6963,3481.5
20240718,경부선,서정리,6555,6223,12778,6389
20240718,경부선,평택지제,3568,3506,7074,3537
20240718,경부선,평택,8990,8703,17693,8846.5
20240718,경부선,성환,3038,3040,6078,3039
20240718,경부선,직산,813,938,1751,875.5
20240718,경부선,두정,5378,5283,10661,5330.5
20240718,경부선,천안,4158,4234,8392,4196
20240718,경부선,당정,5708,5614,11322,5661
20240718,경부선,서동탄,1335,1094,2429,1214.5
20240718,경부선,광명,3643,3226,6869,3434.5
20240718,경원선,이촌(국립중앙박물관),3986,2987,6973,3486.5
20240718,경원선,서빙고,2031,1854,3885,1942.5
20240718,경원선,한남,3594,3434,7028,3514
20240718,경원선,옥수,22,28,50,25
20240718,경원선,응봉,1554,1398,2952,1476
20240718,경원선,왕십리(성동구청),16217,16256,32473,16236.5
20240718,경원선,청량리(서울시립대입구),13915,14864,28779,14389.5
20240718,경원선,외대앞,7986,7626,15612,7806
20240718,경원선,석계,6396,8011,14407,7203.5
20240718,경원선,광운대,7467,8181,15648,7824
20240718,경원선,월계,6472,5415,11887,5943.5
20240718,경원선,녹천,4183,3624,7807,3903.5
20240718,경원선,창동,3,0,3,1.5
20240718,경원선,방학,8405,8546,16951,8475.5
20240718,경원선,도봉,5576,6526,12102,6051
20240718,경원선,도봉산,10759,10581,21340,10670
20240718,경원선,망월사,4769,3758,8527,4263.5
20240718,경원선,회룡,8976,6347,15323,7661.5
20240718,경원선,의정부,9545,9548,19093,9546.5
20240718,경원선,가능,3902,3038,6940,3470
20240718,경원선,녹양,2461,1901,4362,2181
20240718,경원선,양주,5243,3932,9175,4587.5
20240718,경원선,덕계,3310,2027,5337,2668.5
20240718,경원선,덕정,3735,3466,7201,3600.5
20240718,경원선,지행,336,684,1020,510
20240718,경원선,동두천중앙,134,251,385,192.5
20240718,경원선,보산,80,156,236,118
20240718,경원선,동두천,70,131,201,100.5
20240718,경원선,소요산,18,30,48,24
20240718,경원선,청산,2,6,8,4
20240718,경원선,전곡,31,65,96,48
20240718,경원선,연천,8,28,36,18
20240718,경의선,서울역,4120,3589,7709,3854.5
20240718,경의선,신촌,791,868,1659,829.5
20240718,경의선,효창공원앞,3317,3745,7062,3531
20240718,경의선,공덕,4447,3237,7684,3842
20240718,경의선,서강대,1965,1841,3806,1903
20240718,경의선,홍대입구,1827,2341,4168,2084
20240718,경의선,가좌,5099,5055,10154,5077
20240718,경의선,디지털미디어시티,3082,2649,5731,2865.5
20240718,경의선,수색,3276,3400,6676,3338
20240718,경의선,한국항공대,2015,1749,3764,1882
20240718,경의선,강매,2849,2524,5373,2686.5
20240718,경의선,행신,7659,7285,14944,7472
20240718,경의선,능곡,4594,4285,8879,4439.5
20240718,경의선,곡산,564,576,1140,570
20240718,경의선,백마,6177,6465,12642,6321
20240718,경의선,풍산,5096,5343,10439,5219.5
20240718,경의선,일산,9062,10137,19199,9599.5
20240718,경의선,탄현,6289,6737,13026,6513
20240718,경의선,야당,7085,7538,14623,7311.5
20240718,경의선,운정,6207,6148,12355,6177.5
20240718,경의선,금릉,4364,4272,8636,4318
20240718,경의선,금촌,5167,5194,10361,5180.5
20240718,경의선,월롱,1987,1460,3447,1723.5
20240718,경의선,파주,722,620,1342,671
20240718,경의선,문산,4074,4001,8075,4037.5
20240718,경인선,개봉,20380,19573,39953,19976.5
20240718,경인선,오류동,10849,9968,20817,10408.5
20240718,경인선,역곡,23945,23774,47719,23859.5
20240718,경인선,부천,27838,28472,56310,28155
20240718,경인선,송내,25853,25503,51356,25678
20240718,경인선,부평,25923,27629,53552,26776
20240718,경인선,백운,7022,6539,13561,6780.5
20240718,경인선,동암,14081,14156,28237,14118.5
20240718,경인선,주안,17069,15719,32788,16394
20240718,경인선,제물포,9796,9644,19440,9720
20240718,경인선,동인천,12583,11714,24297,12148.5
20240718,경인선,인천,2724,1990,4714,2357
20240718,경인선,구일,8544,8385,16929,8464.5
20240718,경인선,소사,6647,6418,13065,6532.5
20240718,경인선,부개,8112,7545,15657,7828.5
20240718,경인선,간석,5571,5268,10839,5419.5
20240718,경인선,도원,3272,3233,6505,3252.5
20240718,경인선,온수(성공회대입구),6247,5679,11926,5963
20240718,경인선,중동,8760,8160,16920,8460
20240718,경인선,도화,3815,3424,7239,3619.5
20240718,경춘선,신내,2807,2554,5361,2680.5
20240718,경춘선,갈매,2788,2547,5335,2667.5
20240718,경춘선,별내,3085,3009,6094,3047
20240718,경춘선,퇴계원,3150,2857,6007,3003.5
20240718,경춘선,사릉,1826,1786,3612,1806
20240718,경춘선,금곡,1254,1197,2451,1225.5
20240718,경춘선,평내호평,5750,6042,11792,5896
20240718,경춘선,천마산,1120,946,2066,1033
20240718,경춘선,마석,2747,2729,5476,2738
20240718,경춘선,대성리,897,929,1826,913
20240718,경춘선,청평,1266,1235,2501,1250.5
20240718,경춘선,상천,164,119,283,141.5
20240718,경춘선,가평,1598,1645,3243,1621.5
20240718,경춘선,굴봉산,72,61,133,66.5
20240718,경춘선,백양리,36,35,71,35.5
20240718,경춘선,강촌,257,258,515,257.5
20240718,경춘선,김유정,254,203,457,228.5
20240718,경춘선,남춘천,1871,1899,3770,1885
20240718,경춘선,춘천,797,717,1514,757
20240718,공항철도 1호선,서울역,12835,11544,24379,12189.5
20240718,공항철도 1호선,공덕,3132,4146,7278,3639
20240718,공항철도 1호선,홍대입구,13338,13473,26811,13405.5
20240718,공항철도 1호선,디지털미디어시티,16018,15331,31349,15674.5
20240718,공항철도 1호선,마곡나루(서울식물원),12196,11316,23512,11756
20240718,공항철도 1호선,김포공항,10390,6324,16714,8357
20240718,공항철도 1호선,계양,13378,12825,26203,13101.5
20240718,공항철도 1호선,검암,5684,6528,12212,6106
20240718,공항철도 1호선,청라국제도시,7654,7207,14861,7430.5
20240718,공항철도 1호선,운서,9116,9393,18509,9254.5
20240718,공항철도 1호선,공항화물청사,2187,2347,4534,2267
20240718,공항철도 1호선,인천공항1터미널,14965,14257,29222,14611
20240718,공항철도 1호선,인천공항2터미널,7780,6945,14725,7362.5
20240718,공항철도 1호선,영종,3739,3866,7605,3802.5
20240718,과천선,선바위,7364,6682,14046,7023
20240718,과천선,경마공원,1254,1230,2484,1242
20240718,과천선,대공원,1608,1806,3414,1707
20240718,과천선,과천,6670,6035,12705,6352.5
20240718,과천선,정부과천청사,12869,13422,26291,13145.5
20240718,과천선,인덕원,25488,26277,51765,25882.5
20240718,과천선,평촌,18512,17971,36483,18241.5
20240718,과천선,범계,26245,26057,52302,26151
20240718,분당선,선릉,14667,22682,37349,18674.5
20240718,분당선,한티,16199,17743,33942,16971
20240718,분당선,도곡,8136,8187,16323,8161.5
20240718,분당선,구룡,3836,3785,7621,3810.5
20240718,분당선,개포동,4601,4696,9297,4648.5
20240718,분당선,대모산입구,6391,6013,12404,6202
20240718,분당선,수서,17831,18181,36012,18006
20240718,분당선,복정,3,0,3,1.5
20240718,분당선,수원,7203,6596,13799,6899.5
20240718,분당선,서울숲,12142,12488,24630,12315
20240718,분당선,압구정로데오,19196,21654,40850,20425
20240718,분당선,강남구청,10661,12323,22984,11492
20240718,분당선,선정릉,8561,9167,17728,8864
20240718,분당선,가천대,7027,7387,14414,7207
20240718,분당선,태평,13068,12200,25268,12634
20240718,분당선,모란,18353,18627,36980,18490
20240718,분당선,야탑,25314,27006,52320,26160
20240718,분당선,서현,24061,24695,48756,24378
20240718,분당선,수내,14821,14952,29773,14886.5
20240718,분당선,정자,19612,20233,39845,19922.5
20240718,분당선,미금,14849,15415,30264,15132
20240718,분당선,오리,11763,10314,22077,11038.5
20240718,분당선,이매,5693,5301,10994,5497
20240718,분당선,보정,2618,2325,4943,2471.5
20240718,분당선,죽전,12127,13421,25548,12774
20240718,분당선,구성,6413,6301,12714,6357
20240718,분당선,신갈,4756,4517,9273,4636.5
20240718,분당선,기흥,10280,9236,19516,9758
20240718,분당선,상갈,5268,4856,10124,5062
20240718,분당선,청명,4786,4503,9289,4644.5
20240718,분당선,영통,8471,8388,16859,8429.5
20240718,분당선,망포,16054,15078,31132,15566
20240718,분당선,매탄권선,5370,5221,10591,5295.5
20240718,분당선,수원시청,13298,14121,27419,13709.5
20240718,분당선,매교,5334,5100,10434,5217
20240718,서해선,김포공항,3009,3529,6538,3269
20240718,서해선,원종,4509,4574,9083,4541.5
20240718,서해선,부천종합운동장,2638,2242,4880,2440
20240718,수인선,고색,5423,4919,10342,5171
20240718,수인선,오목천,3720,3353,7073,3536.5
20240718,수인선,어천,1156,1113,2269,1134.5
20240718,수인선,야목,455,341,796,398
20240718,수인선,사리,4911,4245,9156,4578
20240718,수인선,달월,117,58,175,87.5
20240718,수인선,월곶,2960,2739,5699,2849.5
20240718,수인선,소래포구,3956,3560,7516,3758
20240718,수인선,인천논현,5022,5305,10327,5163.5
20240718,수인선,호구포,3810,4018,7828,3914
20240718,수인선,남동인더스파크,2482,2848,5330,2665
20240718,수인선,원인재,4147,4162,8309,4154.5
20240718,수인선,연수,4363,4352,8715,4357.5
20240718,수인선,송도,2215,2059,4274,2137
20240718,수인선,인하대,6127,5778,11905,5952.5
20240718,수인선,숭의,3890,3617,7507,3753.5
20240718,수인선,신포,1675,1670,3345,1672.5
20240718,수인선,인천,899,1294,2193,1096.5
20240718,신림선,샛강,3231,3530,6761,3380.5
20240718,신림선,대방,2819,2300,5119,2559.5
20240718,신림선,서울지방병무청,3517,3667,7184,3592
20240718,신림선,보라매,4428,4060,8488,4244
20240718,신림선,보라매공원,2352,2508,4860,2430
20240718,신림선,보라매병원,8807,9235,18042,9021
20240718,신림선,당곡,5059,5015,10074,5037
20240718,신림선,신림,1980,2647,4627,2313.5
20240718,신림선,서원,3820,3272,7092,3546
20240718,신림선,서울대벤처타운,9472,8729,18201,9100.5
20240718,신림선,관악산(서울대),2189,2152,4341,2170.5
20240718,안산선,산본,15728,16135,31863,15931.5
20240718,안산선,대야미,4706,4158,8864,4432
20240718,안산선,반월,3995,3897,7892,3946
20240718,안산선,상록수,13955,14268,28223,14111.5
20240718,안산선,한대앞,8470,8459,16929,8464.5
20240718,안산선,중앙,16713,17322,34035,17017.5
20240718,안산선,고잔,8451,8023,16474,8237
20240718,안산선,초지,4884,4964,9848,4924
20240718,안산선,안산,10982,10080,21062,10531
20240718,안산선,신길온천,1921,1663,3584,1792
20240718,안산선,정왕,8247,8503,16750,8375
20240718,안산선,오이도,7010,6783,13793,6896.5
20240718,안산선,수리산,4007,3249,7256,3628
20240718,우이신설선,북한산우이,2267,1924,4191,2095.5
20240718,우이신설선,솔밭공원,2551,2432,4983,2491.5
20240718,우이신설선,4.19민주묘지,2718,2524,5242,2621
20240718,우이신설선,가오리,4333,4439,8772,4386
20240718,우이신설선,화계,3509,3289,6798,3399
20240718,우이신설선,삼양,2031,2072,4103,2051.5
20240718,우이신설선,삼양사거리,2531,2550,5081,2540.5
20240718,우이신설선,솔샘,6228,5861,12089,6044.5
20240718,우이신설선,북한산보국문,5857,5678,11535,5767.5
20240718,우이신설선,정릉,4484,4184,8668,4334
20240718,우이신설선,성신여대입구(돈암),3366,3670,7036,3518
20240718,우이신설선,보문,1578,1573,3151,1575.5
20240718,우이신설선,신설동,2343,2203,4546,2273
20240718,일산선,원흥,11235,10569,21804,10902
20240718,일산선,삼송,18850,17839,36689,18344.5
20240718,일산선,원당,10411,10006,20417,10208.5
20240718,일산선,화정,16589,16756,33345,16672.5
20240718,일산선,대곡,3209,2542,5751,2875.5
20240718,일산선,백석,9860,9529,19389,9694.5
20240718,일산선,마두,8151,7934,16085,8042.5
20240718,일산선,정발산,6674,6363,13037,6518.5
20240718,일산선,주엽,9829,9579,19408,9704
20240718,일산선,대화,14401,10141,24542,12271
20240718,장항선,봉명,1272,1365,2637,1318.5
20240718,장항선,쌍용(나사렛대),1804,1775,3579,1789.5
20240718,장항선,아산,3010,2620,5630,2815
20240718,장항선,탕정,1403,1242,2645,1322.5
20240718,장항선,배방,974,871,1845,922.5
20240718,장항선,온양온천,3030,3057,6087,3043.5
20240718,장항선,신창(순천향대),960,872,1832,916
20240718,중앙선,회기,23879,22521,46400,23200
20240718,중앙선,중랑,4985,4724,9709,4854.5
20240718,중앙선,상봉,5463,5755,11218,5609
20240718,중앙선,망우,6799,6345,13144,6572
20240718,중앙선,양원,2930,2860,5790,2895
20240718,중앙선,구리,12273,11963,24236,12118
20240718,중앙선,도농,10488,9410,19898,9949
20240718,중앙선,양정,500,406,906,453
20240718,중앙선,덕소,4736,4793,9529,4764.5
20240718,중앙선,도심,2192,1711,3903,1951.5
20240718,중앙선,팔당,612,613,1225,612.5
20240718,중앙선,운길산,452,448,900,450
20240718,중앙선,양수,1507,1527,3034,1517
20240718,중앙선,신원,117,96,213,106.5
20240718,중앙선,국수,517,518,1035,517.5
20240718,중앙선,아신,386,398,784,392
20240718,중앙선,오빈,208,226,434,217
20240718,중앙선,양평,2334,2372,4706,2353
20240718,중앙선,원덕,246,227,473,236.5
20240718,중앙선,용문,1258,1264,2522,1261
20240719,분당선,정자,21593,22436,44029,22014.5
20240719,분당선,미금,17744,18435,36179,18089.5
20240719,분당선,오리,13201,11175,24376,12188
20240719,분당선,이매,6941,6432,13373,6686.5
20240719,분당선,보정,3090,2717,5807,2903.5
20240719,분당선,죽전,14815,16166,30981,15490.5
20240719,분당선,구성,7299,7225,14524,7262
20240719,분당선,신갈,5520,5393,10913,5456.5
20240719,분당선,기흥,11542,10576,22118,11059
20240719,분당선,상갈,6236,5929,12165,6082.5
20240719,분당선,청명,5373,5113,10486,5243
20240719,분당선,영통,11016,10884,21900,10950
20240719,분당선,망포,18589,17272,35861,17930.5
20240719,분당선,매탄권선,6660,6175,12835,6417.5
20240719,분당선,수원시청,15894,18448,34342,17171
20240719,분당선,매교,6127,5992,12119,6059.5
20240719,서해선,김포공항,3334,4166,7500,3750
20240719,서해선,원종,5400,5344,10744,5372
20240719,서해선,부천종합운동장,2918,2381,5299,2649.5
20240719,수인선,고색,6398,5771,12169,6084.5
20240719,수인선,오목천,4817,3947,8764,4382
20240719,수인선,어천,1589,1458,3047,1523.5
20240719,수인선,야목,503,425,928,464
20240719,수인선,사리,5963,5038,11001,5500.5
20240719,수인선,달월,129,76,205,102.5
20240719,수인선,월곶,3273,2956,6229,3114.5
20240719,수인선,소래포구,5147,4725,9872,4936
20240719,수인선,인천논현,6448,6980,13428,6714
20240719,수인선,호구포,4455,4547,9002,4501
20240719,수인선,남동인더스파크,2727,2982,5709,2854.5
20240719,수인선,원인재,4927,4988,9915,4957.5
20240719,수인선,연수,5537,5514,11051,5525.5
20240719,수인선,송도,2835,2604,5439,2719.5
20240719,수인선,인하대,7223,6651,13874,6937
20240719,수인선,숭의,4611,4339,8950,4475
20240719,수인선,신포,2263,2423,4686,2343
20240719,수인선,인천,1226,1924,3150,1575
20240719,신림선,샛강,3126,3789,6915,3457.5
20240719,신림선,대방,3345,2629,5974,2987
20240719,신림선,서울지방병무청,3762,3928,7690,3845
20240719,신림선,보라매,4849,4394,9243,4621.5
20240719,신림선,보라매공원,2782,2859,5641,2820.5
20240719,신림선,보라매병원,8605,8895,17500,8750
20240719,신림선,당곡,5731,5354,11085,5542.5
20240719,신림선,신림,2277,2974,5251,2625.5
20240719,신림선,서원,4020,3422,7442,3721
20240719,신림선,서울대벤처타운,10794,9537,20331,10165.5
20240719,신림선,관악산(서울대),3339,3207,6546,3273
20240719,안산선,산본,18836,19867,38703,19351.5
20240719,안산선,대야미,5855,5033,10888,5444
20240719,안산선,반월,4926,4800,9726,4863
20240719,안산선,상록수,16613,16820,33433,16716.5
20240719,안산선,한대앞,10137,10174,20311,10155.5
20240719,안산선,중앙,21201,22806,44007,22003.5
20240719,안산선,고잔,9838,9360,19198,9599
20240719,안산선,초지,5539,5671,11210,5605
20240719,안산선,안산,13148,12392,25540,12770
20240719,안산선,신길온천,2282,2046,4328,2164
20240719,안산선,정왕,10531,10493,21024,10512
20240719,안산선,오이도,8730,8785,17515,8757.5
20240719,안산선,수리산,4660,3728,8388,4194
20240719,우이신설선,북한산우이,3150,2896,6046,3023
20240719,우이신설선,솔밭공원,3003,2887,5890,2945
20240719,우이신설선,4.19민주묘지,3267,3034,6301,3150.5
20240719,우이신설선,가오리,5013,4972,9985,4992.5
20240719,우이신설선,화계,3990,3768,7758,3879
20240719,우이신설선,삼양,2417,2525,4942,2471
20240719,우이신설선,삼양사거리,2995,2986,5981,2990.5
20240719,우이신설선,솔샘,6700,6241,12941,6470.5
20240719,우이신설선,북한산보국문,6870,6313,13183,6591.5
20240719,우이신설선,정릉,5184,4629,9813,4906.5
20240719,우이신설선,성신여대입구(돈암),4128,4463,8591,4295.5
20240719,우이신설선,보문,1881,1788,3669,1834.5
20240719,우이신설선,신설동,2675,2472,5147,2573.5
20240719,일산선,원흥,12906,12289,25195,12597.5
20240719,일산선,지축,1,0,1,0.5
20240719,일산선,삼송,21861,20896,42757,21378.5
20240719,일산선,원당,12360,11594,23954,11977
20240719,일산선,화정,19548,20005,39553,19776.5
20240719,일산선,대곡,3289,2562,5851,2925.5
20240719,일산선,백석,11300,11448,22748,11374
20240719,일산선,마두,9057,9361,18418,9209
20240719,일산선,정발산,8586,8953,17539,8769.5
20240719,일산선,주엽,11358,11677,23035,11517.5
20240719,일산선,대화,15328,12577,27905,13952.5
20240719,장항선,봉명,1593,1508,3101,1550.5
20240719,장항선,쌍용(나사렛대),2643,2498,5141,2570.5
20240719,장항선,아산,4342,4278,8620,4310
20240719,장항선,탕정,2116,1899,4015,2007.5
20240719,장항선,배방,1471,1448,2919,1459.5
20240719,장항선,온양온천,5730,5801,11531,5765.5
20240719,장항선,신창(순천향대),1402,1155,2557,1278.5
20240719,중앙선,회기,26849,24580,51429,25714.5
20240719,중앙선,중랑,6265,5869,12134,6067
20240719,중앙선,상봉,6875,6662,13537,6768.5
20240719,중앙선,망우,8538,8130,16668,8334
20240719,중앙선,양원,3589,3421,7010,3505
20240719,중앙선,구리,15071,15256,30327,15163.5
20240719,중앙선,도농,12341,11531,23872,11936
20240719,중앙선,양정,646,600,1246,623
20240719,중앙선,덕소,5986,5984,11970,5985
20240719,중앙선,도심,2765,2202,4967,2483.5
20240719,중앙선,팔당,1009,1095,2104,1052
20240719,중앙선,운길산,716,677,1393,696.5
20240719,중앙선,양수,2394,2340,4734,2367
20240719,중앙선,신원,159,167,326,163
20240719,중앙선,국수,847,805,1652,826
20240719,중앙선,아신,590,577,1167,583.5
20240719,중앙선,오빈,314,333,647,323.5
20240719,중앙선,양평,3594,3912,7506,3753
20240719,중앙선,원덕,391,421,812,406
20240719,중앙선,용문,2067,2384,4451,2225.5
20240719,중앙선,지평,123,94,217,108.5
20240719,5호선,여의도,32524,34635,67159,33579.5
20240719,경부선,영등포,47857,49420,97277,48638.5
20240719,1호선,종각,44368,44394,88762,44381
20240719,1호선,시청,28626,29489,58115,29057.5
20240719,1호선,서울역,63054,60329,123383,61691.5
20240719,경원선,창동,4,0,4,2
20240719,5호선,신길,5445,5551,10996,5498
20240719,5호선,영등포시장,13142,13178,26320,13160
20240719,5호선,영등포구청,5338,5240,10578,5289
20240719,경부선,신도림,4234,4648,8882,4441
20240719,경부선,신길,9633,7913,17546,8773
20240719,경부선,구로,19082,19561,38643,19321.5
20240719,경부선,가산디지털단지,19523,22089,41612,20806
20240719,경부선,금천구청,12292,12326,24618,12309
20240719,경부선,석수,9474,8510,17984,8992
20240719,경부선,관악,7903,7561,15464,7732
20240719,경부선,안양,23263,23232,46495,23247.5
20240719,경부선,명학,9428,9178,18606,9303
20240719,경부선,금정,31769,31902,63671,31835.5
20240719,경부선,군포,7895,7751,15646,7823
20240719,경부선,의왕,10155,9846,20001,10000.5
20240719,경부선,성균관대,17054,16490,33544,16772
20240719,경부선,화서,13141,12918,26059,13029.5
20240719,경부선,수원,40889,44493,85382,42691
20240719,경부선,독산,19172,19424,38596,19298
20240719,경부선,세류,3969,3586,7555,3777.5
20240719,경부선,병점,16758,16403,33161,16580.5
20240719,경부선,세마,3789,3537,7326,3663
20240719,경부선,오산대,4207,3816,8023,4011.5
20240719,5호선,천호(풍납토성),22621,22252,44873,22436.5
20240719,5호선,광나루(장신대),14961,13652,28613,14306.5
20240719,5호선,아차산(어린이대공원후문),16543,15948,32491,16245.5
20240719,5호선,군자(능동),12954,14343,27297,13648.5
20240719,5호선,장한평,22163,21715,43878,21939
20240719,5호선,답십리,18214,16315,34529,17264.5
20240719,5호선,마장,6521,5994,12515,6257.5
20240719,5호선,왕십리(성동구청),5265,6310,11575,5787.5
20240719,5호선,행당,9238,7935,17173,8586.5
20240719,5호선,신금호,7568,7826,15394,7697
20240719,5호선,청구,4513,4241,8754,4377
20240719,경부선,대방,11660,12350,24010,12005
20240719,경부선,노량진,8966,8804,17770,8885
20240719,경부선,용산,48811,49666,98477,49238.5
20240719,경부선,남영,10590,10993,21583,10791.5
20240719,경부선,서울역,11357,4767,16124,8062
20240719,경강선,성남,1189,1072,2261,1130.5
20240719,경강선,여주,3127,3310,6437,3218.5
20240719,경강선,세종대왕릉,401,422,823,411.5
20240719,경강선,부발,2953,2453,5406,2703
20240719,경강선,이천,3433,3646,7079,3539.5
20240719,경강선,신둔도예촌,1666,1547,3213,1606.5
20240719,경강선,곤지암,2611,2482,5093,2546.5
20240719,경강선,초월,3976,3655,7631,3815.5
20240719,경강선,경기광주,9149,8682,17831,8915.5
20240719,경강선,삼동,2905,2594,5499,2749.5
20240719,경강선,이매,1236,1041,2277,1138.5
20240719,경강선,판교,6614,6499,13113,6556.5
20240719,9호선2~3단계,중앙보훈병원,14081,12052,26133,13066.5
20240719,9호선2~3단계,둔촌오륜,1423,1345,2768,1384
20240719,9호선2~3단계,올림픽공원(한국체대),6194,6335,12529,6264.5
20240719,9호선2~3단계,한성백제,3282,2999,6281,3140.5
20240719,9호선2~3단계,송파나루,6629,7220,13849,6924.5
20240719,9호선2~3단계,석촌,11109,9619,20728,10364
20240719,9호선2~3단계,석촌고분,8265,7853,16118,8059
20240719,9호선2~3단계,삼전,9033,8229,17262,8631
20240719,9호선2~3단계,종합운동장,5844,5804,11648,5824
20240719,9호선2~3단계,봉은사,23317,23894,47211,23605.5
20240719,9호선2~3단계,삼성중앙,8926,9258,18184,9092
20240719,9호선2~3단계,선정릉,11652,12397,24049,12024.5
20240719,9호선2~3단계,언주,13277,13530,26807,13403.5
20240719,9호선,신논현,37113,38264,75377,37688.5
20240719,9호선,사평,5033,4756,9789,4894.5
20240719,9호선,고속터미널,17190,24027,41217,20608.5
20240719,9호선,신반포,5007,4630,9637,4818.5
20240719,9호선,구반포,1568,1535,3103,1551.5
20240719,9호선,동작(현충원),2325,1992,4317,2158.5
20240719,9호선,흑석(중앙대입구),9731,9905,19636,9818
20240719,4호선,이촌(국립중앙박물관),9093,10053,19146,9573
20240719,4호선,신용산,23242,25185,48427,24213.5
20240719,4호선,삼각지,7357,8668,16025,8012.5
20240719,4호선,숙대입구(갈월),16128,15760,31888,15944
20240719,4호선,서울역,14624,25406,40030,20015
20240719,4호선,회현(남대문시장),30034,31085,61119,30559.5
20240719,4호선,명동,35299,38277,73576,36788
20240719,4호선,충무로,33321,35200,68521,34260.5
20240719,4호선,동대문역사문화공원(DDP),22835,19335,42170,21085
20240719,4호선,동대문,22770,22433,45203,22601.5
20240719,4호선,혜화,38222,38975,77197,38598.5
20240719,4호선,한성대입구(삼선교),14890,14070,28960,14480
20240719,4호선,성신여대입구(돈암),23812,23042,46854,23427
20240719,4호선,길음,23557,22947,46504,23252
20240719,4호선,미아사거리,30792,30312,61104,30552
20240719,4호선,미아(서울사이버대학),17583,16740,34323,17161.5
20240719,4호선,수유(강북구청),37533,38185,75718,37859
20240719,4호선,쌍문,33199,30389,63588,31794
20240719,4호선,창동,30702,32422,63124,31562
20240719,4호선,노원,33216,37627,70843,35421.5
20240719,4호선,상계,21814,20329,42143,21071.5
20240719,4호선,당고개,10691,9090,19781,9890.5
20240719,3호선,오금,7666,6578,14244,7122
20240719,3호선,경찰병원,8891,8964,17855,8927.5
20240719,3호선,가락시장,10893,10349,21242,10621
20240719,3호선,수서,21436,21273,42709,21354.5
20240719,3호선,일원,12865,12264,25129,12564.5
20240719,3호선,대청,12521,11554,24075,12037.5
20240719,3호선,학여울,2617,2653,5270,2635
20240719,3호선,대치,14345,14304,28649,14324.5
20240719,3호선,도곡,6777,6752,13529,6764.5
20240719,3호선,매봉,14916,14353,29269,14634.5
20240719,3호선,양재(서초구청),42985,45341,88326,44163
20240719,3호선,남부터미널(예술의전당),34892,35458,70350,35175
20240719,3호선,교대(법원.검찰청),20651,12270,32921,16460.5
20240719,3호선,고속터미널,55319,56319,111638,55819
20240719,3호선,잠원,5942,5468,11410,5705
20240719,3호선,신사,32523,34851,67374,33687
20240719,3호선,압구정,36850,39821,76671,38335.5
20240719,3호선,옥수,10200,10162,20362,10181
20240719,3호선,금호,9094,8296,17390,8695
20240719,3호선,약수,14954,14401,29355,14677.5
20240719,3호선,동대입구,10132,11026,21158,10579
20240719,3호선,충무로,14,0,14,7
20240719,3호선,을지로3가,13768,14101,27869,13934.5
20240719,3호선,종로3가,12870,15286,28156,14078
20240719,3호선,안국,30710,31115,61825,30912.5
20240719,3호선,경복궁(정부서울청사),27770,28349,56119,28059.5
20240719,3호선,독립문,8412,8296,16708,8354
20240719,3호선,무악재,5005,4706,9711,4855.5
20240719,3호선,홍제,19907,18660,38567,19283.5
20240719,3호선,녹번,17399,15676,33075,16537.5
20240719,3호선,불광,18679,19965,38644,19322
20240719,3호선,연신내,39260,37117,76377,38188.5
20240719,3호선,구파발,25052,24125,49177,24588.5
20240719,3호선,지축,8599,8518,17117,8558.5
20240719,2호선,용두(동대문구청),2776,2791,5567,2783.5
20240719,2호선,신정네거리,11499,11877,23376,11688
20240719,2호선,양천구청,7635,8081,15716,7858
20240719,2호선,도림천,1568,1601,3169,1584.5
20240719,2호선,신설동,4295,4080,8375,4187.5
20240719,2호선,신답,1824,1944,3768,1884
20240719,2호선,용답,3210,3114,6324,3162
20240719,2호선,충정로(경기대입구),11482,12086,23568,11784
20240719,2호선,아현,12710,11321,24031,12015.5
20240719,2호선,이대,17039,18313,35352,17676
20240719,2호선,신촌,43763,45076,88839,44419.5
20240719,2호선,홍대입구,80739,91546,172285,86142.5
20240719,2호선,합정,36566,41115,77681,38840.5
20240719,2호선,당산,20135,23393,43528,21764
20240719,2호선,영등포구청,25386,26329,51715,25857.5
20240719,2호선,문래,26916,27855,54771,27385.5
20240719,2호선,신도림,57462,56229,113691,56845.5
20240719,2호선,대림(구로구청),26481,27031,53512,26756
20240719,2호선,구로디지털단지,64823,64207,129030,64515
20240719,2호선,신대방,28062,26467,54529,27264.5
20240719,2호선,신림,62045,59592,121637,60818.5
20240719,2호선,봉천,27422,25319,52741,26370.5
20240719,2호선,서울대입구(관악구청),52738,50182,102920,51460
20240719,2호선,낙성대(강감찬),31445,29182,60627,30313.5
20240719,2호선,사당,46287,50855,97142,48571
20240719,2호선,방배,17099,17374,34473,17236.5
20240719,2호선,서초,23877,23136,47013,23506.5
20240719,2호선,교대(법원.검찰청),36795,44842,81637,40818.5
20240719,2호선,강남,96539,95451,191990,95995
20240719,2호선,역삼,57896,65617,123513,61756.5
20240719,2호선,선릉,66440,58622,125062,62531
20240719,2호선,삼성(무역센터),61400,62112,123512,61756
20240719,2호선,종합운동장,21879,24563,46442,23221
20240719,2호선,잠실새내,28190,28023,56213,28106.5
20240719,2호선,잠실(송파구청),91412,90565,181977,90988.5
20240719,2호선,잠실나루,17464,16899,34363,17181.5
20240719,2호선,강변(동서울터미널),34269,34001,68270,34135
20240719,2호선,구의(광진구청),28354,27000,55354,27677
20240719,2호선,건대입구,40524,43796,84320,42160
20240719,2호선,성수,50095,55486,105581,52790.5
20240719,2호선,뚝섬,28153,29500,57653,28826.5
20240719,2호선,한양대,9434,9808,19242,9621
20240719,2호선,왕십리(성동구청),17826,16734,34560,17280
20240719,2호선,상왕십리,16506,16003,32509,16254.5
20240719,2호선,신당,17000,17821,34821,17410.5
20240719,2호선,동대문역사문화공원(DDP),17866,20289,38155,19077.5
20240719,2호선,을지로4가,16527,16420,32947,16473.5
20240719,2호선,을지로3가,29521,29943,59464,29732
20240719,2호선,을지로입구,55938,57584,113522,56761
20240719,2호선,시청,31367,30549,61916,30958
20240719,1호선,동묘앞,10248,10487,20735,10367.5
20240719,1호선,청량리(서울시립대입구),25417,24618,50035,25017.5
20240719,1호선,제기동,18192,18435,36627,18313.5
20240719,1호선,신설동,16048,15345,31393,15696.5
20240719,1호선,동대문,12543,11538,24081,12040.5
20240719,1호선,종로5가,26320,26065,52385,26192.5
20240719,1호선,종로3가,29742,27575,57317,28658.5
20240719,5호선,상일동,17266,15966,33232,16616
20240719,5호선,고덕,13096,12397,25493,12746.5
20240719,5호선,명일,10041,10348,20389,10194.5
20240719,5호선,굽은다리(강동구민회관앞),11363,10730,22093,11046.5
20240719,5호선,길동,9613,9887,19500,9750
20240719,5호선,강동,20243,19313,39556,19778
20240719,9호선,노들,5534,4537,10071,5035.5
20240719,5호선,동대문역사문화공원(DDP),3613,4251,7864,3932
20240719,5호선,을지로4가,7397,7618,15015,7507.5
20240719,5호선,종로3가,16872,17739,34611,17305.5
20240719,5호선,광화문(세종문화회관),37084,39641,76725,38362.5
20240719,5호선,서대문,22500,22745,45245,22622.5
20240719,5호선,충정로(경기대입구),5337,5258,10595,5297.5
20240719,5호선,애오개,7887,7632,15519,7759.5
20240719,5호선,공덕,16661,17502,34163,17081.5
20240719,5호선,마포,16638,17309,33947,16973.5
20240719,9호선,노량진,29161,28214,57375,28687.5
20240719,9호선,샛강,7392,7554,14946,7473
20240719,9호선,여의도,35294,33696,68990,34495
20240719,9호선,국회의사당,21034,21609,42643,21321.5
20240719,9호선,당산,22517,22340,44857,22428.5
20240719,9호선,선유도,10116,9326,19442,9721
20240719,9호선,신목동,5100,4408,9508,4754
20240719,9호선,염창,20337,18931,39268,19634
20240719,9호선,등촌,14115,13484,27599,13799.5
20240719,9호선,증미,9265,8595,17860,8930
20240719,9호선,가양,25083,24350,49433,24716.5
20240719,9호선,양천향교,11433,11260,22693,11346.5
20240719,9호선,마곡나루(서울식물원),15865,15708,31573,15786.5
20240719,9호선,신방화,8311,8013,16324,8162
20240719,9호선,공항시장,3550,3762,7312,3656
20240719,9호선,김포공항,7884,11191,19075,9537.5
20240719,9호선,개화,3132,2082,5214,2607
20240719,8호선,남위례,8531,8397,16928,8464
20240719,8호선,모란,6519,5360,11879,5939.5
20240719,8호선,수진,6312,5785,12097,6048.5
20240719,8호선,신흥,6027,6192,12219,6109.5
20240719,8호선,단대오거리,13426,12757,26183,13091.5
20240719,8호선,남한산성입구(성남법원.검찰청),14686,12608,27294,13647
20240719,8호선,산성,7217,7041,14258,7129
20240719,8호선,복정,10632,8838,19470,9735
20240719,8호선,장지,19942,18247,38189,19094.5
20240719,8호선,문정,25085,26191,51276,25638
20240719,8호선,가락시장,8851,9918,18769,9384.5
20240719,8호선,송파,10875,10427,21302,10651
20240719,8호선,석촌,9442,10816,20258,10129
20240719,8호선,잠실(송파구청),18986,22112,41098,20549
20240719,8호선,몽촌토성(평화의문),7579,7720,15299,7649.5
20240719,8호선,강동구청,11819,12094,23913,11956.5
20240719,8호선,천호(풍납토성),17476,20283,37759,18879.5
20240719,8호선,암사,21420,18751,40171,20085.5
20240719,7호선,온수(성공회대입구),10708,9558,20266,10133
20240719,7호선,천왕,13291,12438,25729,12864.5
20240719,7호선,광명사거리,23038,22727,45765,22882.5
20240719,7호선,철산,24772,25112,49884,24942
20240719,7호선,가산디지털단지,50400,50344,100744,50372
20240719,7호선,남구로,16203,16970,33173,16586.5
20240719,7호선,대림(구로구청),9704,10014,19718,9859
20240719,7호선,신풍,12609,11544,24153,12076.5
20240719,7호선,보라매,7603,7653,15256,7628
20240719,7호선,신대방삼거리,16993,15923,32916,16458
20240719,7호선,장승배기,10418,10028,20446,10223
20240719,7호선,상도,12731,11981,24712,12356
20240719,7호선,숭실대입구(살피재),13739,13190,26929,13464.5
20240719,7호선,남성,12736,11720,24456,12228
20240719,7호선,이수,19150,18788,37938,18969
20240719,7호선,내방,16587,16699,33286,16643
20240719,7호선,고속터미널,19415,16376,35791,17895.5
20240719,7호선,반포,7301,6968,14269,7134.5
20240719,7호선,논현,21216,22206,43422,21711
20240719,7호선,학동,26694,28015,54709,27354.5
20240719,7호선,강남구청,18411,20652,39063,19531.5
20240719,7호선,청담,20581,22663,43244,21622
20240719,7호선,자양(뚝섬한강공원),10103,9736,19839,9919.5
20240719,7호선,건대입구,14632,15030,29662,14831
20240719,7호선,어린이대공원(세종대),16085,15359,31444,15722
20240719,7호선,군자(능동),17626,13841,31467,15733.5
20240719,7호선,중곡,12230,11517,23747,11873.5
20240719,7호선,용마산(용마폭포공원),6388,6126,12514,6257
20240719,7호선,사가정,18239,18020,36259,18129.5
20240719,7호선,면목,16637,15838,32475,16237.5
20240719,7호선,상봉,19530,19383,38913,19456.5
20240719,7호선,중화,12046,11423,23469,11734.5
20240719,7호선,먹골,11690,11471,23161,11580.5
20240719,7호선,태릉입구,9827,9100,18927,9463.5
20240719,7호선,공릉(서울과학기술대),13854,13358,27212,13606
20240719,7호선,하계,19928,18362,38290,19145
20240719,7호선,중계,16132,14222,30354,15177
20240719,7호선,노원,28381,30141,58522,29261
20240719,7호선,마들,14988,13934,28922,14461
20240719,7호선,수락산,14039,13840,27879,13939.5
20240719,7호선,도봉산,9708,11288,20996,10498
20240719,7호선,장암,3149,1427,4576,2288
20240719,6호선,봉화산(서울의료원),9854,9189,19043,9521.5
20240719,6호선,화랑대(서울여대입구),13081,10114,23195,11597.5
20240719,6호선,태릉입구,6334,6939,13273,6636.5
20240719,6호선,석계,13885,14124,28009,14004.5
20240719,6호선,돌곶이,11519,10408,21927,10963.5
20240719,6호선,상월곡(한국과학기술연구원),7031,6221,13252,6626
20240719,6호선,월곡(동덕여대),13243,12563,25806,12903
20240719,6호선,고려대(종암),9264,8734,17998,8999
20240719,6호선,안암(고대병원앞),12007,11633,23640,11820
20240719,6호선,보문,8773,8028,16801,8400.5
20240719,6호선,창신,4017,3068,7085,3542.5
20240719,6호선,동묘앞,9470,9365,18835,9417.5
20240719,6호선,신당,10498,9968,20466,10233
20240719,6호선,청구,4456,4311,8767,4383.5
20240719,6호선,약수,4265,4168,8433,4216.5
20240719,6호선,버티고개,2490,2448,4938,2469
20240719,6호선,한강진,11490,13638,25128,12564
20240719,6호선,이태원,12375,16194,28569,14284.5
20240719,6호선,녹사평(용산구청),5887,6281,12168,6084
20240719,6호선,삼각지,8244,7566,15810,7905
20240719,6호선,효창공원앞,8291,7243,15534,7767
20240719,6호선,공덕,21636,21100,42736,21368
20240719,6호선,대흥(서강대앞),10292,10525,20817,10408.5
20240719,6호선,광흥창(서강),10861,10395,21256,10628
20240719,6호선,상수,11026,13040,24066,12033
20240719,6호선,합정,15403,15415,30818,15409
20240719,6호선,망원,17649,18991,36640,18320
20240719,6호선,마포구청,16462,14686,31148,15574
20240719,6호선,월드컵경기장(성산),4816,4918,9734,4867
20240719,6호선,디지털미디어시티,16410,17768,34178,17089
20240719,6호선,증산(명지대앞),10820,10655,21475,10737.5
20240719,6호선,새절(신사),14635,13298,27933,13966.5
20240719,6호선,구산,9592,7234,16826,8413
20240719,6호선,연신내,4,0,4,2
20240719,6호선,독바위,3196,3234,6430,3215
20240719,6호선,불광,5604,5262,10866,5433
20240719,6호선,역촌,4261,4700,8961,4480.5
20240719,6호선,응암,19730,19193,38923,19461.5
20240719,5호선,하남검단산,7598,7126,14724,7362
20240719,5호선,하남시청(덕풍·신장),9837,9175,19012,9506
20240719,5호선,하남풍산,5298,5148,10446,5223
20240719,5호선,미사,20759,21326,42085,21042.5
20240719,5호선,강일,6981,6337,13318,6659
20240719,5호선,마천,8516,7493,16009,8004.5
20240719,5호선,거여,11254,10692,21946,10973
20240719,5호선,개롱,7538,7534,15072,7536
20240719,5호선,오금,4213,4139,8352,4176
20240719,5호선,방이,8022,8551,16573,8286.5
20240719,5호선,올림픽공원(한국체대),6475,5166,11641,5820.5
20240719,5호선,둔촌동,9987,9899,19886,9943
20240719,경부선,오산,11427,10832,22259,11129.5
20240719,5호선,양평,8857,8331,17188,8594
20240719,5호선,오목교(목동운동장앞),24108,25767,49875,24937.5
20240719,5호선,목동,18801,19889,38690,19345
20240719,5호선,신정(은행정),15287,12351,27638,13819
20240719,5호선,까치산,31175,29516,60691,30345.5
20240719,5호선,화곡,32130,29505,61635,30817.5
20240719,5호선,우장산,17043,16387,33430,16715
20240719,5호선,발산,25704,27273,52977,26488.5
20240719,5호선,마곡,14179,14391,28570,14285
20240719,5호선,송정,7296,6793,14089,7044.5
20240719,5호선,김포공항,12538,8702,21240,10620
20240719,5호선,개화산,7016,6512,13528,6764
20240719,5호선,방화,7955,7562,15517,7758.5
20240719,4호선,남태령,1571,1292,2863,1431.5
20240719,4호선,사당,29743,26107,55850,27925
20240719,4호선,총신대입구(이수),22352,24398,46750,23375
20240719,4호선,동작(현충원),1634,1820,3454,1727
20240719,경부선,진위,2009,1687,3696,1848
20240719,경부선,송탄,5238,5026,10264,5132
20240719,경부선,서정리,10191,8528,18719,9359.5
20240719,경부선,평택지제,4995,4910,9905,4952.5
20240719,경부선,평택,15039,14315,29354,14677
20240719,경부선,성환,4663,4256,8919,4459.5
20240719,경부선,직산,1196,1084,2280,1140
20240719,경부선,두정,8078,7723,15801,7900.5
20240719,경부선,천안,6714,7073,13787,6893.5
20240719,경부선,당정,6774,6253,13027,6513.5
20240719,경부선,서동탄,1738,1456,3194,1597
20240719,경부선,광명,4435,4018,8453,4226.5
20240719,경원선,이촌(국립중앙박물관),4641,3450,8091,4045.5
20240719,경원선,서빙고,2467,2262,4729,2364.5
20240719,경원선,한남,4248,4149,8397,4198.5
20240719,경원선,옥수,71,40,111,55.5
20240719,경원선,응봉,2088,1717,3805,1902.5
20240719,경원선,왕십리(성동구청),18978,19165,38143,19071.5
20240719,경원선,청량리(서울시립대입구),18797,20411,39208,19604
20240719,경원선,외대앞,9394,8881,18275,9137.5
20240719,경원선,신이문,9328,8744,18072,9036
20240719,경원선,석계,8262,9329,17591,8795.5
20240719,경원선,광운대,8642,7980,16622,8311
20240719,경원선,월계,7347,6753,14100,7050
20240719,경원선,녹천,4769,3928,8697,4348.5
20240719,경원선,방학,11032,10696,21728,10864
20240719,경원선,도봉,6713,6527,13240,6620
20240719,경원선,도봉산,7966,4896,12862,6431
20240719,경원선,망월사,7797,7610,15407,7703.5
20240719,경원선,회룡,14215,13765,27980,13990
20240719,경원선,의정부,20643,21287,41930,20965
20240719,경원선,가능,7108,6869,13977,6988.5
20240719,경원선,녹양,4821,4498,9319,4659.5
20240719,경원선,양주,7910,7540,15450,7725
20240719,경원선,덕계,6269,5934,12203,6101.5
20240719,경원선,덕정,5913,5585,11498,5749
20240719,경원선,지행,7101,7343,14444,7222
20240719,경원선,동두천중앙,3338,3201,6539,3269.5
20240719,경원선,보산,1855,1563,3418,1709
20240719,경원선,동두천,1901,1803,3704,1852
20240719,경원선,소요산,1859,1948,3807,1903.5
20240719,경원선,청산,196,139,335,167.5
20240719,경원선,전곡,1217,1346,2563,1281.5
20240719,경원선,연천,1056,1235,2291,1145.5
20240719,경의선,서울역,5310,6346,11656,5828
20240719,경의선,신촌,1061,1372,2433,1216.5
20240719,경의선,효창공원앞,3492,3970,7462,3731
20240719,경의선,공덕,4816,4015,8831,4415.5
20240719,경의선,서강대,2372,2335,4707,2353.5
20240719,경의선,홍대입구,2495,3134,5629,2814.5
20240719,경의선,가좌,6540,6120,12660,6330
20240719,경의선,디지털미디어시티,3239,2874,6113,3056.5
20240719,경의선,수색,3749,3812,7561,3780.5
20240719,경의선,한국항공대,2335,2092,4427,2213.5
20240719,경의선,강매,3527,2916,6443,3221.5
20240719,경의선,행신,9121,8888,18009,9004.5
20240719,경의선,능곡,5276,5033,10309,5154.5
20240719,경의선,곡산,764,800,1564,782
20240719,경의선,백마,8423,8279,16702,8351
20240719,경의선,풍산,6908,6642,13550,6775
20240719,경의선,일산,11868,11833,23701,11850.5
20240719,경의선,탄현,8799,8515,17314,8657
20240719,경의선,야당,10422,11062,21484,10742
20240719,경의선,운정,8795,8079,16874,8437
20240719,경의선,금릉,6265,6029,12294,6147
20240719,경의선,금촌,7398,7309,14707,7353.5
20240719,경의선,월롱,2555,1756,4311,2155.5
20240719,경의선,파주,1435,986,2421,1210.5
20240719,경의선,문산,6384,6417,12801,6400.5
20240719,경의선,임진강,10,6,16,8
20240719,경의선,운천,6,4,10,5
20240719,경인선,개봉,23715,23229,46944,23472
20240719,경인선,오류동,12846,11723,24569,12284.5
20240719,경인선,역곡,27952,27850,55802,27901
20240719,경인선,부천,35287,35837,71124,35562
20240719,경인선,송내,29605,28978,58583,29291.5
20240719,경인선,부평,32435,35937,68372,34186
20240719,경인선,백운,8531,8314,16845,8422.5
20240719,경인선,동암,17035,17497,34532,17266
20240719,경인선,주안,20823,18573,39396,19698
20240719,경인선,제물포,12021,11390,23411,11705.5
20240719,경인선,동인천,15855,14893,30748,15374
20240719,경인선,인천,4427,3621,8048,4024
20240719,경인선,구일,7150,6996,14146,7073
20240719,경인선,소사,8022,7607,15629,7814.5
20240719,경인선,부개,9609,8930,18539,9269.5
20240719,경인선,간석,6731,6403,13134,6567
20240719,경인선,도원,3801,3995,7796,3898
20240719,경인선,온수(성공회대입구),7012,6464,13476,6738
20240719,경인선,중동,10340,9587,19927,9963.5
20240719,경인선,도화,4832,4463,9295,4647.5
20240719,경춘선,신내,3051,2759,5810,2905
20240719,경춘선,갈매,3310,2887,6197,3098.5
20240719,경춘선,별내,3986,3698,7684,3842
20240719,경춘선,퇴계원,4067,3705,7772,3886
20240719,5호선,여의나루,14195,15818,30013,15006.5
20240719,경춘선,사릉,2244,2115,4359,2179.5
20240719,경춘선,금곡,1659,1534,3193,1596.5
20240719,경춘선,평내호평,6681,6571,13252,6626
20240719,경춘선,천마산,1606,1515,3121,1560.5
20240719,경춘선,마석,4073,4035,8108,4054
20240719,경춘선,대성리,902,1086,1988,994
20240719,경춘선,청평,2171,2459,4630,2315
20240719,경춘선,상천,300,293,593,296.5
20240719,경춘선,가평,2378,2428,4806,2403
20240719,경춘선,굴봉산,126,125,251,125.5
20240719,경춘선,백양리,96,68,164,82
20240719,경춘선,강촌,415,487,902,451
20240719,경춘선,김유정,375,435,810,405
20240719,경춘선,남춘천,2814,2953,5767,2883.5
20240719,경춘선,춘천,1460,1345,2805,1402.5
20240719,공항철도 1호선,서울역,15565,14273,29838,14919
20240719,공항철도 1호선,공덕,3465,4439,7904,3952
20240719,공항철도 1호선,홍대입구,17376,17099,34475,17237.5
20240719,공항철도 1호선,디지털미디어시티,15467,14482,29949,14974.5
20240719,공항철도 1호선,마곡나루(서울식물원),12793,11539,24332,12166
20240719,공항철도 1호선,김포공항,10967,6207,17174,8587
20240719,공항철도 1호선,계양,14678,13750,28428,14214
20240719,공항철도 1호선,검암,7148,7460,14608,7304
20240719,공항철도 1호선,청라국제도시,8473,7778,16251,8125.5
20240719,공항철도 1호선,운서,10385,10538,20923,10461.5
20240719,공항철도 1호선,공항화물청사,2238,2363,4601,2300.5
20240719,공항철도 1호선,인천공항1터미널,16182,14659,30841,15420.5
20240719,공항철도 1호선,인천공항2터미널,8030,6627,14657,7328.5
20240719,공항철도 1호선,영종,4484,4822,9306,4653
20240719,과천선,선바위,8643,7215,15858,7929
20240719,과천선,경마공원,7799,7981,15780,7890
20240719,과천선,대공원,3231,3184,6415,3207.5
20240719,과천선,과천,7651,6956,14607,7303.5
20240719,과천선,정부과천청사,13926,14274,28200,14100
20240719,과천선,인덕원,28764,29482,58246,29123
20240719,과천선,평촌,19930,19475,39405,19702.5
20240719,과천선,범계,31448,32151,63599,31799.5
20240719,분당선,선릉,14990,23246,38236,19118
20240719,분당선,한티,18309,19626,37935,18967.5
20240719,분당선,도곡,8870,8604,17474,8737
20240719,분당선,구룡,4335,4065,8400,4200
20240719,분당선,개포동,5332,5417,10749,5374.5
20240719,분당선,대모산입구,6840,6238,13078,6539
20240719,분당선,수서,19317,20571,39888,19944
20240719,분당선,복정,3,0,3,1.5
20240719,분당선,수원,9287,8758,18045,9022.5
20240719,분당선,서울숲,14285,14266,28551,14275.5
20240719,분당선,압구정로데오,22814,25990,48804,24402
20240719,분당선,강남구청,11190,12787,23977,11988.5
20240719,분당선,선정릉,9047,9184,18231,9115.5
20240719,분당선,가천대,7887,7802,15689,7844.5
20240719,분당선,태평,14959,14031,28990,14495
20240719,분당선,모란,26530,27707,54237,27118.5
20240719,분당선,야탑,29229,31145,60374,30187
20240719,분당선,서현,30160,30728,60888,30444
20240719,분당선,수내,16218,16390,32608,16304
20240720,9호선2~3단계,송파나루,4961,5455,10416,5208
20240720,9호선2~3단계,석촌,8069,6507,14576,7288
20240720,9호선2~3단계,한성백제,2248,1972,4220,2110
20240720,9호선2~3단계,올림픽공원(한국체대),8769,8631,17400,8700
20240720,9호선2~3단계,둔촌오륜,853,934,1787,893.5
20240720,9호선2~3단계,중앙보훈병원,5988,5301,11289,5644.5
20240720,경강선,판교,3819,3517,7336,3668
20240720,경강선,이매,862,673,1535,767.5
20240720,경강선,삼동,1657,1448,3105,1552.5
20240720,경강선,경기광주,5786,5452,11238,5619
20240720,경강선,초월,2603,2291,4894,2447
20240720,경강선,곤지암,2139,2085,4224,2112
20240720,경강선,신둔도예촌,1267,1241,2508,1254
20240720,경강선,이천,3088,3281,6369,3184.5
20240720,경강선,부발,2204,1980,4184,2092
20240720,경강선,세종대왕릉,356,390,746,373
20240720,경강선,여주,2865,3128,5993,2996.5
20240720,경강선,성남,750,748,1498,749
20240720,경부선,서울역,10142,3889,14031,7015.5
20240720,경부선,남영,6208,6718,12926,6463
20240720,경부선,용산,45661,48697,94358,47179
20240720,경부선,노량진,8036,7500,15536,7768
20240720,경부선,대방,6540,7192,13732,6866
20240720,경부선,영등포,45586,46806,92392,46196
20240720,경부선,신도림,2970,3529,6499,3249.5
20240720,경부선,신길,5860,4778,10638,5319
20240720,경부선,구로,13363,14149,27512,13756
20240720,경부선,가산디지털단지,6615,8258,14873,7436.5
20240720,경부선,금천구청,7919,7944,15863,7931.5
20240720,경부선,석수,6468,5868,12336,6168
20240720,경부선,관악,5753,5589,11342,5671
20240720,경부선,안양,18216,18104,36320,18160
20240720,경부선,명학,4982,4735,9717,4858.5
20240720,경부선,금정,20516,20468,40984,20492
20240720,경부선,군포,4314,4047,8361,4180.5
20240720,경부선,의왕,6079,5835,11914,5957
20240720,경부선,성균관대,11221,11306,22527,11263.5
20240720,경부선,화서,12200,12253,24453,12226.5
20240720,경부선,수원,41281,45338,86619,43309.5
20240720,경부선,독산,9422,9176,18598,9299
20240720,경부선,세류,3003,2979,5982,2991
20240720,경부선,병점,13427,12701,26128,13064
20240720,경부선,세마,2702,2404,5106,2553
20240720,경부선,오산대,2992,2719,5711,2855.5
20240720,경부선,오산,9814,9264,19078,9539
20240720,경부선,진위,1119,998,2117,1058.5
20240720,경부선,송탄,4882,4521,9403,4701.5
20240720,경부선,서정리,7869,6636,14505,7252.5
20240720,경부선,평택지제,3974,3666,7640,3820
20240720,경부선,평택,14265,13915,28180,14090
20240720,경부선,성환,3658,3227,6885,3442.5
20240720,경부선,직산,927,818,1745,872.5
20240720,경부선,두정,6659,6386,13045,6522.5
20240720,경부선,천안,7195,7229,14424,7212
20240720,경부선,당정,4255,3981,8236,4118
20240720,경부선,서동탄,1079,1086,2165,1082.5
20240720,경부선,광명,3270,2976,6246,3123
20240720,경원선,이촌(국립중앙박물관),3141,2417,5558,2779
20240720,경원선,서빙고,1803,1787,3590,1795
20240720,경원선,한남,2469,2540,5009,2504.5
20240720,경원선,옥수,44,32,76,38
20240720,경원선,응봉,1419,1124,2543,1271.5
20240720,경원선,왕십리(성동구청),14738,15161,29899,14949.5
20240720,경원선,청량리(서울시립대입구),18127,19519,37646,18823
20240720,경원선,외대앞,7205,6584,13789,6894.5
20240720,경원선,신이문,6442,5942,12384,6192
20240720,경원선,석계,6383,6738,13121,6560.5
20240720,경원선,광운대,5723,5380,11103,5551.5
20240720,경원선,월계,4633,4202,8835,4417.5
20240720,경원선,녹천,3361,2856,6217,3108.5
20240720,경원선,창동,8,0,8,4
20240720,경원선,방학,7837,7618,15455,7727.5
20240720,경원선,도봉,4608,4348,8956,4478
20240720,경원선,도봉산,7537,5134,12671,6335.5
20240720,경원선,망월사,5350,5441,10791,5395.5
20240720,경원선,회룡,10351,9971,20322,10161
20240720,경원선,의정부,17596,18401,35997,17998.5
20240720,경원선,가능,5218,5065,10283,5141.5
20240720,경원선,녹양,3374,3219,6593,3296.5
20240720,경원선,양주,6196,5859,12055,6027.5
20240720,경원선,덕계,4511,4161,8672,4336
20240720,경원선,덕정,4632,4161,8793,4396.5
20240720,경원선,지행,6004,5694,11698,5849
20240720,경원선,동두천중앙,2605,2676,5281,2640.5
20240720,경원선,보산,1444,1408,2852,1426
20240720,경원선,동두천,1410,1364,2774,1387
20240720,경원선,소요산,2422,2341,4763,2381.5
20240720,경원선,청산,155,140,295,147.5
20240720,경원선,전곡,1420,1222,2642,1321
20240720,경원선,연천,1158,1145,2303,1151.5
20240720,경의선,서울역,1502,1630,3132,1566
20240720,경의선,신촌,365,438,803,401.5
20240720,경의선,효창공원앞,2004,2247,4251,2125.5
20240720,경의선,공덕,3606,2475,6081,3040.5
20240720,경의선,서강대,1874,1847,3721,1860.5
20240720,경의선,홍대입구,2750,3485,6235,3117.5
20240720,경의선,가좌,4258,4070,8328,4164
20240720,경의선,디지털미디어시티,2349,2057,4406,2203
20240720,경의선,수색,2242,2237,4479,2239.5
20240720,경의선,한국항공대,1114,1102,2216,1108
20240720,경의선,강매,1983,1842,3825,1912.5
20240720,경의선,행신,5871,6012,11883,5941.5
20240720,경의선,능곡,3562,3466,7028,3514
20240720,경의선,곡산,477,474,951,475.5
20240720,경의선,백마,5239,4905,10144,5072
20240720,경의선,풍산,5179,5063,10242,5121
20240720,경의선,일산,7813,7379,15192,7596
20240720,경의선,탄현,5893,5663,11556,5778
20240720,경의선,야당,7557,7651,15208,7604
20240720,경의선,운정,5772,5281,11053,5526.5
20240720,경의선,금릉,4380,4200,8580,4290
20240720,경의선,금촌,5965,5636,11601,5800.5
20240720,경의선,월롱,1250,1126,2376,1188
20240720,경의선,파주,1063,817,1880,940
20240720,경의선,문산,5348,4800,10148,5074
20240720,경의선,임진강,78,55,133,66.5
20240720,경의선,운천,5,3,8,4
20240720,경인선,개봉,16542,16070,32612,16306
20240720,경인선,오류동,9360,8445,17805,8902.5
20240720,경인선,역곡,19539,19112,38651,19325.5
20240720,경인선,부천,28998,29892,58890,29445
20240720,경인선,송내,18764,18334,37098,18549
20240720,경인선,부평,28336,31185,59521,29760.5
20240720,경인선,백운,6082,5828,11910,5955
20240720,경인선,동암,13041,13150,26191,13095.5
20240720,경인선,주안,15997,13925,29922,14961
20240720,경인선,제물포,7464,7140,14604,7302
20240720,경인선,동인천,12188,11873,24061,12030.5
20240720,경인선,인천,3816,3195,7011,3505.5
20240720,경인선,구일,4702,3933,8635,4317.5
20240720,경인선,소사,6180,6014,12194,6097
20240720,경인선,부개,6787,6368,13155,6577.5
20240720,경인선,간석,4708,4424,9132,4566
20240720,경인선,도원,2267,2399,4666,2333
20240720,경인선,온수(성공회대입구),4758,4316,9074,4537
20240720,경인선,중동,7112,6600,13712,6856
20240720,경인선,도화,3450,3112,6562,3281
20240720,경춘선,신내,1635,1445,3080,1540
20240720,경춘선,갈매,1925,1658,3583,1791.5
20240720,경춘선,별내,2430,2265,4695,2347.5
20240720,경춘선,퇴계원,2537,2379,4916,2458
20240720,경춘선,사릉,1429,1403,2832,1416
20240720,경춘선,금곡,1032,945,1977,988.5
20240720,경춘선,평내호평,4418,4289,8707,4353.5
20240720,경춘선,천마산,1164,1078,2242,1121
20240720,경춘선,마석,3077,2980,6057,3028.5
20240720,경춘선,대성리,1061,1247,2308,1154
20240720,경춘선,청평,1999,2248,4247,2123.5
20240720,경춘선,상천,283,335,618,309
20240720,경춘선,가평,2158,2901,5059,2529.5
20240720,경춘선,굴봉산,158,152,310,155
20240720,경춘선,백양리,88,81,169,84.5
20240720,경춘선,강촌,475,639,1114,557
20240720,경춘선,김유정,398,461,859,429.5
20240720,경춘선,남춘천,2664,2755,5419,2709.5
20240720,경춘선,춘천,1517,1341,2858,1429
20240720,공항철도 1호선,서울역,13587,13397,26984,13492
20240720,공항철도 1호선,공덕,2280,3540,5820,2910
20240720,공항철도 1호선,홍대입구,18994,18667,37661,18830.5
20240720,공항철도 1호선,디지털미디어시티,7290,6542,13832,6916
20240720,공항철도 1호선,마곡나루(서울식물원),4265,4513,8778,4389
20240720,공항철도 1호선,김포공항,8853,4778,13631,6815.5
20240720,공항철도 1호선,계양,9654,8670,18324,9162
20240720,공항철도 1호선,검암,4582,4554,9136,4568
20240720,공항철도 1호선,청라국제도시,5108,4862,9970,4985
20240720,공항철도 1호선,운서,8663,9470,18133,9066.5
20240720,공항철도 1호선,공항화물청사,1229,1187,2416,1208
20240720,공항철도 1호선,인천공항1터미널,16265,14105,30370,15185
20240720,공항철도 1호선,인천공항2터미널,7451,5848,13299,6649.5
20240720,공항철도 1호선,영종,3744,3717,7461,3730.5
20240720,과천선,선바위,5464,4526,9990,4995
20240720,과천선,경마공원,13626,12552,26178,13089
20240720,과천선,대공원,16129,18351,34480,17240
20240720,안산선,산본,13553,14240,27793,13896.5
20240720,안산선,대야미,4008,3531,7539,3769.5
20240720,안산선,반월,3613,3381,6994,3497
20240720,안산선,상록수,12281,12212,24493,12246.5
20240720,안산선,한대앞,7376,7322,14698,7349
20240720,안산선,중앙,16500,17525,34025,17012.5
20240720,안산선,고잔,6211,6158,12369,6184.5
20240720,안산선,초지,3844,3825,7669,3834.5
20240720,안산선,안산,10540,11542,22082,11041
20240720,안산선,신길온천,1734,1587,3321,1660.5
20240720,안산선,정왕,7684,7707,15391,7695.5
20240720,안산선,오이도,6796,6906,13702,6851
20240720,안산선,수리산,3032,2491,5523,2761.5
20240720,우이신설선,북한산우이,3223,3545,6768,3384
20240720,우이신설선,솔밭공원,2097,1917,4014,2007
20240720,우이신설선,4.19민주묘지,2590,2320,4910,2455
20240720,우이신설선,가오리,3410,3189,6599,3299.5
20240720,우이신설선,화계,2764,2465,5229,2614.5
20240720,우이신설선,삼양,1686,1768,3454,1727
20240720,우이신설선,삼양사거리,2161,2130,4291,2145.5
20240720,우이신설선,솔샘,4293,3798,8091,4045.5
20240720,우이신설선,북한산보국문,4995,4341,9336,4668
20240720,우이신설선,정릉,3814,3203,7017,3508.5
20240720,우이신설선,성신여대입구(돈암),3270,3710,6980,3490
20240720,우이신설선,보문,1347,1349,2696,1348
20240720,우이신설선,신설동,1608,1547,3155,1577.5
20240720,일산선,원흥,8079,7599,15678,7839
20240720,일산선,지축,3,0,3,1.5
20240720,일산선,삼송,14494,13937,28431,14215.5
20240720,일산선,원당,8531,7978,16509,8254.5
20240720,일산선,화정,13368,14061,27429,13714.5
20240720,일산선,대곡,2332,1867,4199,2099.5
20240720,일산선,백석,7918,8105,16023,8011.5
20240720,일산선,마두,5728,5607,11335,5667.5
20240720,일산선,정발산,7013,7039,14052,7026
20240720,일산선,주엽,8242,7881,16123,8061.5
20240720,일산선,대화,21053,17535,38588,19294
20240720,장항선,봉명,863,792,1655,827.5
20240720,장항선,쌍용(나사렛대),1893,1776,3669,1834.5
20240720,장항선,아산,3375,3315,6690,3345
20240720,장항선,탕정,1400,1229,2629,1314.5
20240720,장항선,배방,1180,1118,2298,1149
20240720,장항선,온양온천,4363,4415,8778,4389
20240720,장항선,신창(순천향대),1028,933,1961,980.5
20240720,중앙선,회기,20913,19078,39991,19995.5
20240720,중앙선,중랑,4429,4104,8533,4266.5
20240720,중앙선,상봉,4963,4829,9792,4896
20240720,중앙선,망우,6589,6472,13061,6530.5
20240720,중앙선,양원,2051,1991,4042,2021
20240720,중앙선,구리,10267,10355,20622,10311
20240720,중앙선,도농,7409,7095,14504,7252
20240720,중앙선,양정,473,419,892,446
20240720,중앙선,덕소,4421,4330,8751,4375.5
20240720,중앙선,도심,1673,1400,3073,1536.5
20240720,중앙선,팔당,980,1040,2020,1010
20240720,중앙선,운길산,797,841,1638,819
20240720,중앙선,양수,2187,2341,4528,2264
20240720,중앙선,신원,171,168,339,169.5
20240720,중앙선,국수,625,629,1254,627
20240720,중앙선,아신,502,569,1071,535.5
20240720,중앙선,오빈,284,283,567,283.5
20240720,중앙선,양평,2808,3051,5859,2929.5
20240720,중앙선,원덕,400,410,810,405
20240720,중앙선,용문,3306,3613,6919,3459.5
20240720,중앙선,지평,64,75,139,69.5
20240720,1호선,서울역,43001,40932,83933,41966.5
20240720,분당선,복정,6,0,6,3
20240720,신림선,관악산(서울대),2700,2788,5488,2744
20240720,신림선,서울대벤처타운,7956,6976,14932,7466
20240720,신림선,서원,2812,2493,5305,2652.5
20240720,신림선,신림,1683,2035,3718,1859
20240720,신림선,당곡,3800,3531,7331,3665.5
20240720,신림선,보라매병원,3571,3507,7078,3539
20240720,신림선,보라매공원,1449,1491,2940,1470
20240720,신림선,보라매,3004,2573,5577,2788.5
20240720,신림선,서울지방병무청,2209,2502,4711,2355.5
20240720,신림선,대방,2371,1814,4185,2092.5
20240720,신림선,샛강,1074,1390,2464,1232
20240720,수인선,인천,1139,1754,2893,1446.5
20240720,수인선,신포,1615,1558,3173,1586.5
20240720,수인선,숭의,2928,2663,5591,2795.5
20240720,수인선,인하대,4571,4197,8768,4384
20240720,수인선,송도,1997,1848,3845,1922.5
20240720,수인선,연수,4342,4405,8747,4373.5
20240720,수인선,원인재,3709,3827,7536,3768
20240720,수인선,남동인더스파크,906,951,1857,928.5
20240720,수인선,호구포,2647,2534,5181,2590.5
20240720,수인선,인천논현,4671,4825,9496,4748
20240720,수인선,소래포구,4358,4397,8755,4377.5
20240720,수인선,월곶,2396,2230,4626,2313
20240720,수인선,달월,66,63,129,64.5
20240720,수인선,사리,3998,3279,7277,3638.5
20240720,수인선,야목,332,284,616,308
20240720,수인선,어천,1447,1271,2718,1359
20240720,수인선,오목천,3088,2477,5565,2782.5
20240720,수인선,고색,3141,3080,6221,3110.5
20240720,서해선,부천종합운동장,1850,1513,3363,1681.5
20240720,서해선,원종,4078,4015,8093,4046.5
20240720,서해선,김포공항,2951,3966,6917,3458.5
20240720,분당선,매교,3483,3377,6860,3430
20240720,분당선,수원시청,11921,13469,25390,12695
20240720,분당선,매탄권선,3873,3662,7535,3767.5
20240720,분당선,망포,10248,9411,19659,9829.5
20240720,분당선,영통,7859,7463,15322,7661
20240720,분당선,청명,3155,3008,6163,3081.5
20240720,분당선,상갈,3934,3831,7765,3882.5
20240720,분당선,기흥,7353,6807,14160,7080
20240720,분당선,신갈,3030,2996,6026,3013
20240720,분당선,구성,4733,4817,9550,4775
20240720,분당선,죽전,9669,10797,20466,10233
20240720,분당선,보정,1586,1480,3066,1533
20240720,분당선,이매,4222,3978,8200,4100
20240720,분당선,오리,7635,6474,14109,7054.5
20240720,분당선,미금,10647,10934,21581,10790.5
20240720,분당선,정자,10869,11219,22088,11044
20240720,분당선,수내,9186,8645,17831,8915.5
20240720,분당선,서현,18754,18978,37732,18866
20240720,분당선,야탑,17878,18726,36604,18302
20240720,분당선,모란,15976,16532,32508,16254
20240720,분당선,태평,10489,9913,20402,10201
20240720,분당선,가천대,5206,5343,10549,5274.5
20240720,분당선,선정릉,3449,3352,6801,3400.5
20240720,분당선,강남구청,5196,6393,11589,5794.5
20240720,분당선,압구정로데오,18226,21066,39292,19646
20240720,분당선,서울숲,9288,9246,18534,9267
20240720,분당선,수원,7369,7152,14521,7260.5
20240720,분당선,수서,13404,14073,27477,13738.5
20240720,분당선,대모산입구,4213,3997,8210,4105
20240720,분당선,개포동,3192,3142,6334,3167
20240720,분당선,구룡,2288,2162,4450,2225
20240720,분당선,도곡,5021,4651,9672,4836
20240720,분당선,한티,15697,15237,30934,15467
20240720,분당선,선릉,5549,8477,14026,7013
20240720,과천선,범계,23297,22717,46014,23007
20240720,과천선,평촌,9685,9329,19014,9507
20240720,과천선,인덕원,17921,18212,36133,18066.5
20240720,과천선,정부과천청사,7973,7847,15820,7910
20240720,과천선,과천,6124,4893,11017,5508.5
20240720,1호선,시청,14858,15324,30182,15091
20240720,1호선,종각,22055,22165,44220,22110
20240720,1호선,종로3가,23398,23010,46408,23204
20240720,1호선,종로5가,20669,20179,40848,20424
20240720,1호선,동대문,11130,11161,22291,11145.5
20240720,1호선,신설동,10434,9918,20352,10176
20240720,1호선,제기동,15016,15534,30550,15275
20240720,1호선,청량리(서울시립대입구),21314,21325,42639,21319.5
20240720,1호선,동묘앞,11090,11366,22456,11228
20240720,2호선,시청,13681,11611,25292,12646
20240720,2호선,을지로입구,32357,31636,63993,31996.5
20240720,2호선,을지로3가,14867,14807,29674,14837
20240720,2호선,을지로4가,8904,9359,18263,9131.5
20240720,2호선,동대문역사문화공원(DDP),13701,16482,30183,15091.5
20240720,2호선,신당,12351,13210,25561,12780.5
20240720,2호선,상왕십리,10491,9971,20462,10231
20240720,2호선,왕십리(성동구청),12626,12144,24770,12385
20240720,2호선,한양대,4547,4593,9140,4570
20240720,2호선,뚝섬,16822,16403,33225,16612.5
20240720,2호선,성수,31993,36144,68137,34068.5
20240720,2호선,건대입구,33507,35885,69392,34696
20240720,2호선,구의(광진구청),18357,17688,36045,18022.5
20240720,2호선,강변(동서울터미널),26418,26063,52481,26240.5
20240720,2호선,잠실나루,8402,8360,16762,8381
20240720,2호선,잠실(송파구청),74297,72595,146892,73446
20240720,2호선,잠실새내,19960,20587,40547,20273.5
20240720,2호선,종합운동장,17652,18975,36627,18313.5
20240720,2호선,삼성(무역센터),35221,34142,69363,34681.5
20240720,2호선,선릉,27576,24411,51987,25993.5
20240720,2호선,역삼,19375,21120,40495,20247.5
20240720,2호선,강남,61164,60294,121458,60729
20240720,2호선,교대(법원.검찰청),16731,20999,37730,18865
20240720,2호선,서초,11634,10510,22144,11072
20240720,2호선,방배,9757,9922,19679,9839.5
20240720,2호선,사당,36568,39858,76426,38213
20240720,2호선,낙성대(강감찬),22125,20229,42354,21177
20240720,2호선,서울대입구(관악구청),37247,35419,72666,36333
20240720,2호선,봉천,19195,17484,36679,18339.5
20240720,2호선,신림,46545,44001,90546,45273
20240720,2호선,신대방,20732,19233,39965,19982.5
20240720,2호선,구로디지털단지,36819,35826,72645,36322.5
20240720,2호선,대림(구로구청),19272,20171,39443,19721.5
20240720,2호선,신도림,42542,42450,84992,42496
20240720,2호선,문래,12666,13472,26138,13069
20240720,2호선,영등포구청,14178,14772,28950,14475
20240720,2호선,당산,11833,13107,24940,12470
20240720,2호선,합정,31135,35858,66993,33496.5
20240720,2호선,홍대입구,82542,92225,174767,87383.5
20240720,2호선,신촌,35185,35983,71168,35584
20240720,2호선,이대,12102,12982,25084,12542
20240720,2호선,아현,8208,7599,15807,7903.5
20240720,2호선,충정로(경기대입구),6202,6441,12643,6321.5
20240720,2호선,용답,2241,2038,4279,2139.5
20240720,2호선,신답,1075,1079,2154,1077
20240720,2호선,신설동,3635,3460,7095,3547.5
20240720,2호선,도림천,892,918,1810,905
20240720,2호선,양천구청,4546,4526,9072,4536
20240720,2호선,신정네거리,7486,7478,14964,7482
20240720,2호선,용두(동대문구청),1913,1930,3843,1921.5
20240720,3호선,지축,5530,5282,10812,5406
20240720,3호선,구파발,16751,16594,33345,16672.5
20240720,3호선,연신내,28101,26360,54461,27230.5
20240720,3호선,불광,13528,14622,28150,14075
20240720,3호선,녹번,10701,9439,20140,10070
20240720,3호선,홍제,13979,13219,27198,13599
20240720,3호선,무악재,3010,2947,5957,2978.5
20240720,3호선,독립문,6028,5955,11983,5991.5
20240720,3호선,경복궁(정부서울청사),17526,18318,35844,17922
20240720,3호선,안국,19327,20534,39861,19930.5
20240720,3호선,종로3가,8409,10434,18843,9421.5
20240720,3호선,을지로3가,6486,6911,13397,6698.5
20240720,3호선,충무로,20,0,20,10
20240720,3호선,동대입구,9784,10404,20188,10094
20240720,3호선,약수,9693,9259,18952,9476
20240720,3호선,금호,6021,5503,11524,5762
20240720,3호선,옥수,6961,6977,13938,6969
20240720,3호선,압구정,25285,26542,51827,25913.5
20240720,3호선,신사,22395,23480,45875,22937.5
20240720,3호선,잠원,3456,3386,6842,3421
20240720,3호선,고속터미널,58041,55881,113922,56961
20240720,3호선,교대(법원.검찰청),10416,5598,16014,8007
20240720,3호선,남부터미널(예술의전당),21697,21757,43454,21727
20240720,3호선,양재(서초구청),19997,21688,41685,20842.5
20240720,3호선,매봉,6687,6577,13264,6632
20240720,3호선,도곡,3491,3428,6919,3459.5
20240720,3호선,대치,12085,10644,22729,11364.5
20240720,3호선,학여울,2064,2127,4191,2095.5
20240720,3호선,대청,6627,6144,12771,6385.5
20240720,3호선,일원,5468,5397,10865,5432.5
20240720,3호선,수서,15414,14860,30274,15137
20240720,3호선,가락시장,6590,6139,12729,6364.5
20240720,3호선,경찰병원,4545,4542,9087,4543.5
20240720,3호선,오금,4011,3747,7758,3879
20240720,4호선,당고개,7726,7121,14847,7423.5
20240720,4호선,상계,15213,13755,28968,14484
20240720,4호선,노원,24502,26842,51344,25672
20240720,4호선,창동,21953,22524,44477,22238.5
20240720,4호선,쌍문,22820,20292,43112,21556
20240720,4호선,수유(강북구청),27512,26861,54373,27186.5
20240720,4호선,미아(서울사이버대학),11906,11086,22992,11496
20240720,4호선,미아사거리,22267,21191,43458,21729
20240720,4호선,길음,15519,14798,30317,15158.5
20240720,4호선,성신여대입구(돈암),18670,18201,36871,18435.5
20240720,4호선,한성대입구(삼선교),10957,10727,21684,10842
20240720,4호선,혜화,33210,34670,67880,33940
20240720,4호선,동대문,15500,16039,31539,15769.5
20240720,4호선,동대문역사문화공원(DDP),17573,15189,32762,16381
20240720,4호선,충무로,17156,18411,35567,17783.5
20240720,4호선,명동,29248,32788,62036,31018
20240720,4호선,회현(남대문시장),21822,22516,44338,22169
20240720,4호선,서울역,7413,18347,25760,12880
20240720,4호선,숙대입구(갈월),11680,11385,23065,11532.5
20240720,4호선,삼각지,5818,7456,13274,6637
20240720,4호선,신용산,15637,17596,33233,16616.5
20240720,4호선,이촌(국립중앙박물관),9282,9717,18999,9499.5
20240720,4호선,동작(현충원),1038,1105,2143,1071.5
20240720,4호선,총신대입구(이수),15679,16835,32514,16257
20240720,4호선,사당,24254,23099,47353,23676.5
20240720,4호선,남태령,1269,813,2082,1041
20240720,5호선,방화,4979,4730,9709,4854.5
20240720,5호선,개화산,4107,4033,8140,4070
20240720,5호선,김포공항,9830,7819,17649,8824.5
20240720,5호선,송정,5146,4853,9999,4999.5
20240720,5호선,마곡,7296,7342,14638,7319
20240720,5호선,발산,15531,16692,32223,16111.5
20240720,5호선,우장산,10524,10387,20911,10455.5
20240720,5호선,화곡,20699,18623,39322,19661
20240720,5호선,까치산,21305,19951,41256,20628
20240720,5호선,신정(은행정),9196,7849,17045,8522.5
20240720,5호선,목동,11670,11599,23269,11634.5
20240720,5호선,오목교(목동운동장앞),16704,16887,33591,16795.5
20240720,5호선,양평,4165,3878,8043,4021.5
20240720,5호선,영등포구청,2643,2447,5090,2545
20240720,5호선,영등포시장,8614,8683,17297,8648.5
20240720,5호선,신길,3431,3417,6848,3424
20240720,5호선,여의도,13637,13734,27371,13685.5
20240720,5호선,여의나루,7297,9583,16880,8440
20240720,5호선,마포,8428,8582,17010,8505
20240720,5호선,공덕,7809,8181,15990,7995
20240720,5호선,애오개,3986,3837,7823,3911.5
20240720,5호선,충정로(경기대입구),2073,2007,4080,2040
20240720,5호선,서대문,8248,7925,16173,8086.5
20240720,5호선,광화문(세종문화회관),17431,18123,35554,17777
20240720,5호선,종로3가,14607,15495,30102,15051
20240720,5호선,을지로4가,3565,3888,7453,3726.5
20240720,5호선,동대문역사문화공원(DDP),1543,1748,3291,1645.5
20240720,5호선,청구,2534,2476,5010,2505
20240720,5호선,신금호,4392,4472,8864,4432
20240720,5호선,행당,5659,4884,10543,5271.5
20240720,5호선,왕십리(성동구청),3600,4598,8198,4099
20240720,5호선,마장,4126,3877,8003,4001.5
20240720,5호선,답십리,10852,9762,20614,10307
20240720,5호선,장한평,12969,12600,25569,12784.5
20240720,5호선,군자(능동),8916,9954,18870,9435
20240720,5호선,아차산(어린이대공원후문),12132,11578,23710,11855
20240720,5호선,광나루(장신대),10472,9872,20344,10172
20240720,5호선,천호(풍납토성),17837,17028,34865,17432.5
20240720,5호선,강동,13081,12520,25601,12800.5
20240720,5호선,길동,6726,6741,13467,6733.5
20240720,5호선,굽은다리(강동구민회관앞),8327,7877,16204,8102
20240720,5호선,명일,6432,6578,13010,6505
20240720,5호선,고덕,7093,6716,13809,6904.5
20240720,5호선,상일동,9735,9235,18970,9485
20240720,5호선,둔촌동,7009,6902,13911,6955.5
20240720,5호선,올림픽공원(한국체대),5276,4743,10019,5009.5
20240720,5호선,방이,5561,5475,11036,5518
20240720,5호선,오금,2226,2149,4375,2187.5
20240720,5호선,개롱,4722,4905,9627,4813.5
20240720,5호선,거여,6678,6342,13020,6510
20240720,5호선,마천,4864,4772,9636,4818
20240720,5호선,강일,4165,3639,7804,3902
20240720,5호선,미사,14109,14203,28312,14156
20240720,5호선,하남풍산,3279,3317,6596,3298
20240720,5호선,하남시청(덕풍·신장),6816,6412,13228,6614
20240720,5호선,하남검단산,5834,5747,11581,5790.5
20240720,6호선,응암,13074,12907,25981,12990.5
20240720,6호선,역촌,2953,3286,6239,3119.5
20240720,6호선,불광,4518,3696,8214,4107
20240720,6호선,독바위,2029,2169,4198,2099
20240720,6호선,연신내,5,0,5,2.5
20240720,6호선,구산,6457,4787,11244,5622
20240720,6호선,새절(신사),9066,8512,17578,8789
20240720,6호선,증산(명지대앞),7439,7247,14686,7343
20240720,6호선,디지털미디어시티,8117,8437,16554,8277
20240720,6호선,월드컵경기장(성산),5248,5111,10359,5179.5
20240720,6호선,마포구청,9995,9181,19176,9588
20240720,6호선,망원,14505,15489,29994,14997
20240720,6호선,합정,13267,12716,25983,12991.5
20240720,6호선,상수,9727,11585,21312,10656
20240720,6호선,광흥창(서강),5742,5221,10963,5481.5
20240720,6호선,대흥(서강대앞),6004,6030,12034,6017
20240720,6호선,공덕,11572,11009,22581,11290.5
20240720,6호선,효창공원앞,5115,4577,9692,4846
20240720,6호선,삼각지,6886,5871,12757,6378.5
20240720,6호선,녹사평(용산구청),4593,5236,9829,4914.5
20240720,6호선,이태원,11993,15044,27037,13518.5
20240720,6호선,한강진,10531,12348,22879,11439.5
20240720,6호선,버티고개,1517,1720,3237,1618.5
20240720,6호선,약수,2803,2868,5671,2835.5
20240720,6호선,청구,2786,2466,5252,2626
20240720,6호선,신당,7063,6568,13631,6815.5
20240720,6호선,동묘앞,8128,7781,15909,7954.5
20240720,6호선,창신,2270,1890,4160,2080
20240720,6호선,보문,5562,4990,10552,5276
20240720,6호선,안암(고대병원앞),9650,8961,18611,9305.5
20240720,6호선,고려대(종암),5581,5486,11067,5533.5
20240720,6호선,월곡(동덕여대),7600,7182,14782,7391
20240720,6호선,상월곡(한국과학기술연구원),4454,3766,8220,4110
20240720,6호선,돌곶이,6967,6082,13049,6524.5
20240720,6호선,석계,9108,9195,18303,9151.5
20240720,6호선,태릉입구,4531,4825,9356,4678
20240720,6호선,화랑대(서울여대입구),7248,5818,13066,6533
20240720,6호선,봉화산(서울의료원),5699,5497,11196,5598
20240720,6호선,신내,1,0,1,0.5
20240720,7호선,장암,2043,1461,3504,1752
20240720,7호선,도봉산,6175,8157,14332,7166
20240720,7호선,수락산,10237,9859,20096,10048
20240720,7호선,마들,9517,8809,18326,9163
20240720,7호선,노원,20619,21200,41819,20909.5
20240720,7호선,중계,9727,8687,18414,9207
20240720,7호선,하계,13195,11728,24923,12461.5
20240720,7호선,공릉(서울과학기술대),9158,8906,18064,9032
20240720,7호선,태릉입구,6988,6427,13415,6707.5
20240720,7호선,먹골,8139,7908,16047,8023.5
20240720,7호선,중화,7820,7422,15242,7621
20240720,7호선,상봉,14582,14037,28619,14309.5
20240720,7호선,면목,11216,10540,21756,10878
20240720,7호선,사가정,12624,12209,24833,12416.5
20240720,7호선,용마산(용마폭포공원),4277,4151,8428,4214
20240720,7호선,중곡,7331,6797,14128,7064
20240720,7호선,군자(능동),11925,8839,20764,10382
20240720,7호선,어린이대공원(세종대),9988,9472,19460,9730
20240720,7호선,건대입구,11104,11433,22537,11268.5
20240720,7호선,자양(뚝섬한강공원),6989,6764,13753,6876.5
20240720,7호선,청담,10179,11106,21285,10642.5
20240720,7호선,강남구청,9432,10580,20012,10006
20240720,7호선,학동,11680,12427,24107,12053.5
20240720,7호선,논현,11082,11997,23079,11539.5
20240720,7호선,반포,5250,4935,10185,5092.5
20240720,7호선,고속터미널,15951,12101,28052,14026
20240720,7호선,내방,8287,8137,16424,8212
20240720,7호선,이수,13633,13166,26799,13399.5
20240720,7호선,남성,8613,8121,16734,8367
20240720,7호선,숭실대입구(살피재),8603,8171,16774,8387
20240720,7호선,상도,8332,7653,15985,7992.5
20240720,7호선,장승배기,6892,6597,13489,6744.5
20240720,7호선,신대방삼거리,11197,10476,21673,10836.5
20240720,7호선,보라매,5154,5269,10423,5211.5
20240720,7호선,신풍,8260,7522,15782,7891
20240720,7호선,대림(구로구청),8550,9124,17674,8837
20240720,7호선,남구로,8453,8936,17389,8694.5
20240720,7호선,가산디지털단지,14194,12890,27084,13542
20240720,7호선,철산,16281,16262,32543,16271.5
20240720,7호선,광명사거리,16324,16270,32594,16297
20240720,7호선,천왕,7408,7002,14410,7205
20240720,7호선,온수(성공회대입구),5615,5500,11115,5557.5
20240720,8호선,암사,13332,12094,25426,12713
20240720,8호선,천호(풍납토성),12506,14471,26977,13488.5
20240720,8호선,강동구청,6466,6518,12984,6492
20240720,8호선,몽촌토성(평화의문),4854,4898,9752,4876
20240720,8호선,잠실(송파구청),16046,17415,33461,16730.5
20240720,8호선,석촌,6451,7985,14436,7218
20240720,8호선,송파,6852,6813,13665,6832.5
20240720,8호선,가락시장,5661,5865,11526,5763
20240720,8호선,문정,9236,9292,18528,9264
20240720,8호선,장지,12864,11629,24493,12246.5
20240720,8호선,복정,6100,5038,11138,5569
20240720,8호선,산성,4644,4773,9417,4708.5
20240720,8호선,남한산성입구(성남법원.검찰청),8913,7851,16764,8382
20240720,8호선,단대오거리,8441,7792,16233,8116.5
20240720,8호선,신흥,4325,4510,8835,4417.5
20240720,8호선,수진,4568,4214,8782,4391
20240720,8호선,모란,3994,3497,7491,3745.5
20240720,8호선,남위례,4786,4685,9471,4735.5
20240720,9호선,개화,1512,1195,2707,1353.5
20240720,9호선,김포공항,6854,10509,17363,8681.5
20240720,9호선,공항시장,2472,2554,5026,2513
20240720,9호선,신방화,5329,4962,10291,5145.5
20240720,9호선,마곡나루(서울식물원),9131,8934,18065,9032.5
20240720,9호선,양천향교,6296,5913,12209,6104.5
20240720,9호선,가양,16247,15271,31518,15759
20240720,9호선,증미,3739,3527,7266,3633
20240720,9호선,등촌,8165,7703,15868,7934
20240720,9호선,염창,12813,11860,24673,12336.5
20240720,9호선,신목동,2680,2267,4947,2473.5
20240720,9호선,선유도,4289,3961,8250,4125
20240720,9호선,당산,13990,13224,27214,13607
20240720,9호선,국회의사당,5457,5697,11154,5577
20240720,9호선,여의도,14948,13445,28393,14196.5
20240720,9호선,샛강,3020,2968,5988,2994
20240720,9호선,노량진,22394,21764,44158,22079
20240720,9호선,노들,3665,3030,6695,3347.5
20240720,9호선,흑석(중앙대입구),6048,6056,12104,6052
20240720,9호선,동작(현충원),1512,1434,2946,1473
20240720,9호선,구반포,657,660,1317,658.5
20240720,9호선,신반포,3003,2918,5921,2960.5
20240720,9호선,고속터미널,15257,23227,38484,19242
20240720,9호선,사평,2893,2755,5648,2824
20240720,9호선,신논현,27119,27636,54755,27377.5
20240720,9호선2~3단계,언주,7178,7104,14282,7141
20240720,9호선2~3단계,선정릉,4938,5580,10518,5259
20240720,9호선2~3단계,삼성중앙,3524,3642,7166,3583
20240720,9호선2~3단계,봉은사,15451,16419,31870,15935
20240720,9호선2~3단계,종합운동장,3907,3762,7669,3834.5
20240720,9호선2~3단계,삼전,5751,5341,11092,5546
20240720,9호선2~3단계,석촌고분,5411,5213,10624,5312
20240721,경의선,풍산,4098,3844,7942,3971
20240721,경원선,녹양,2690,2574,5264,2632
20240721,경원선,가능,3966,3830,7796,3898
20240721,경원선,의정부,13883,13936,27819,13909.5
20240721,경원선,회룡,7896,7802,15698,7849
20240721,경원선,망월사,4665,4735,9400,4700
20240721,경원선,도봉산,6862,4644,11506,5753
20240721,경원선,도봉,3550,3397,6947,3473.5
20240721,경원선,방학,6270,6173,12443,6221.5
20240721,경원선,창동,1,0,1,0.5
20240721,경원선,녹천,2479,2208,4687,2343.5
20240721,경원선,월계,3719,3602,7321,3660.5
20240721,경원선,광운대,4715,4512,9227,4613.5
20240721,경원선,석계,4759,4921,9680,4840
20240721,경원선,신이문,4802,4587,9389,4694.5
20240721,경원선,외대앞,5221,5135,10356,5178
20240721,경원선,청량리(서울시립대입구),15870,14129,29999,14999.5
20240721,경원선,왕십리(성동구청),12539,12417,24956,12478
20240721,경원선,응봉,1049,1031,2080,1040
20240721,경원선,옥수,54,23,77,38.5
20240721,경원선,한남,1656,1663,3319,1659.5
20240721,경원선,서빙고,2026,2116,4142,2071
20240721,경원선,이촌(국립중앙박물관),2730,2187,4917,2458.5
20240721,경부선,광명,3229,2204,5433,2716.5
20240721,경부선,서동탄,843,855,1698,849
20240721,경부선,당정,3193,3170,6363,3181.5
20240721,경부선,천안,6805,6498,13303,6651.5
20240721,경부선,두정,5298,6044,11342,5671
20240721,경부선,직산,722,804,1526,763
20240721,경부선,성환,3038,3437,6475,3237.5
20240721,경부선,평택,12752,13247,25999,12999.5
20240721,경부선,평택지제,3266,3156,6422,3211
20240721,경부선,서정리,5398,7138,12536,6268
20240721,경부선,송탄,3867,4134,8001,4000.5
20240721,경부선,진위,934,984,1918,959
20240721,경부선,오산,8395,8900,17295,8647.5
20240721,경부선,오산대,2348,2314,4662,2331
20240721,경부선,세마,2033,1852,3885,1942.5
20240721,경부선,병점,10087,11031,21118,10559
20240721,3호선,옥수,5233,5351,10584,5292
20240721,1호선,서울역,36503,33602,70105,35052.5
20240721,1호선,시청,10195,9956,20151,10075.5
20240721,1호선,종각,14518,13508,28026,14013
20240721,1호선,종로3가,15600,14251,29851,14925.5
20240721,1호선,종로5가,10859,10593,21452,10726
20240721,1호선,동대문,9966,10609,20575,10287.5
20240721,1호선,신설동,8568,8352,16920,8460
20240721,1호선,제기동,10168,10540,20708,10354
20240721,1호선,청량리(서울시립대입구),15413,15244,30657,15328.5
20240721,1호선,동묘앞,11574,11547,23121,11560.5
20240721,2호선,시청,9393,7590,16983,8491.5
20240721,2호선,을지로입구,25376,24461,49837,24918.5
20240721,2호선,을지로3가,12053,11578,23631,11815.5
20240721,2호선,을지로4가,5928,5637,11565,5782.5
20240721,2호선,동대문역사문화공원(DDP),11742,13918,25660,12830
20240721,2호선,신당,9240,9764,19004,9502
20240721,2호선,상왕십리,7623,7715,15338,7669
20240721,2호선,왕십리(성동구청),9541,9340,18881,9440.5
20240721,2호선,한양대,3486,3898,7384,3692
20240721,2호선,뚝섬,12682,12399,25081,12540.5
20240721,2호선,성수,25096,27934,53030,26515
20240721,2호선,건대입구,25927,26829,52756,26378
20240721,2호선,구의(광진구청),12531,12346,24877,12438.5
20240721,2호선,강변(동서울터미널),21685,20420,42105,21052.5
20240721,2호선,잠실나루,5900,5864,11764,5882
20240721,2호선,잠실(송파구청),56475,53752,110227,55113.5
20240721,2호선,잠실새내,13727,13988,27715,13857.5
20240721,2호선,종합운동장,16247,17872,34119,17059.5
20240721,2호선,삼성(무역센터),25566,24711,50277,25138.5
20240721,2호선,선릉,15581,13546,29127,14563.5
20240721,2호선,역삼,12440,13608,26048,13024
20240721,2호선,강남,36123,34836,70959,35479.5
20240721,2호선,교대(법원.검찰청),10392,12454,22846,11423
20240721,2호선,서초,14311,13557,27868,13934
20240721,2호선,방배,7311,7533,14844,7422
20240721,2호선,사당,26437,27425,53862,26931
20240721,2호선,낙성대(강감찬),16951,17512,34463,17231.5
20240721,2호선,서울대입구(관악구청),26805,27426,54231,27115.5
20240721,2호선,봉천,13537,13176,26713,13356.5
20240721,2호선,신림,35577,34725,70302,35151
20240721,2호선,신대방,16223,16071,32294,16147
20240721,2호선,구로디지털단지,26934,26302,53236,26618
20240721,2호선,대림(구로구청),16560,16997,33557,16778.5
20240721,2호선,신도림,31252,30747,61999,30999.5
20240721,2호선,문래,8978,9517,18495,9247.5
20240721,2호선,영등포구청,8963,9142,18105,9052.5
20240721,2호선,당산,8694,9521,18215,9107.5
20240721,2호선,합정,24216,25551,49767,24883.5
20240721,2호선,홍대입구,67468,71011,138479,69239.5
20240721,2호선,신촌,26880,27064,53944,26972
20240721,2호선,이대,9278,10215,19493,9746.5
20240721,2호선,아현,5981,5637,11618,5809
20240721,2호선,충정로(경기대입구),3968,4372,8340,4170
20240721,2호선,용답,1790,1803,3593,1796.5
20240721,2호선,신답,809,891,1700,850
20240721,2호선,신설동,3008,3073,6081,3040.5
20240721,2호선,도림천,603,674,1277,638.5
20240721,2호선,양천구청,3512,3643,7155,3577.5
20240721,2호선,신정네거리,5274,5508,10782,5391
20240721,2호선,용두(동대문구청),1340,1335,2675,1337.5
20240721,3호선,지축,4066,3992,8058,4029
20240721,3호선,구파발,12620,12830,25450,12725
20240721,3호선,연신내,20300,19642,39942,19971
20240721,3호선,불광,10065,10991,21056,10528
20240721,3호선,녹번,7386,6870,14256,7128
20240721,3호선,홍제,10029,9690,19719,9859.5
20240721,3호선,무악재,2272,2349,4621,2310.5
20240721,3호선,독립문,4423,4621,9044,4522
20240721,3호선,경복궁(정부서울청사),13053,13758,26811,13405.5
20240721,3호선,안국,14320,14886,29206,14603
20240721,3호선,종로3가,5692,6846,12538,6269
20240721,3호선,을지로3가,4879,4694,9573,4786.5
20240721,3호선,충무로,9,0,9,4.5
20240721,3호선,동대입구,8356,8721,17077,8538.5
20240721,3호선,약수,7560,7231,14791,7395.5
20240721,3호선,금호,4381,4164,8545,4272.5
20240721,3호선,압구정,15499,16197,31696,15848
20240721,3호선,신사,12570,12487,25057,12528.5
20240721,3호선,잠원,2704,2670,5374,2687
20240721,우이신설선,삼양,1359,1403,2762,1381
20240721,우이신설선,삼양사거리,1723,1718,3441,1720.5
20240721,우이신설선,솔샘,3187,2869,6056,3028
20240721,우이신설선,북한산보국문,4047,3644,7691,3845.5
20240721,우이신설선,정릉,3068,2508,5576,2788
20240721,우이신설선,성신여대입구(돈암),2412,2869,5281,2640.5
20240721,우이신설선,보문,1089,1100,2189,1094.5
20240721,우이신설선,신설동,1369,1348,2717,1358.5
20240721,일산선,원흥,5999,5771,11770,5885
20240721,일산선,지축,2,0,2,1
20240721,일산선,삼송,10881,10766,21647,10823.5
20240721,일산선,원당,6221,6032,12253,6126.5
20240721,일산선,화정,10625,10861,21486,10743
20240721,일산선,대곡,1661,1424,3085,1542.5
20240721,일산선,백석,6079,5935,12014,6007
20240721,일산선,마두,3606,3632,7238,3619
20240721,일산선,정발산,5551,5295,10846,5423
20240721,일산선,주엽,5664,5604,11268,5634
20240721,일산선,대화,14241,11514,25755,12877.5
20240721,장항선,봉명,597,595,1192,596
20240721,장항선,쌍용(나사렛대),1508,1591,3099,1549.5
20240721,장항선,아산,3565,2543,6108,3054
20240721,장항선,탕정,1048,1155,2203,1101.5
20240721,장항선,배방,903,1025,1928,964
20240721,장항선,온양온천,3850,4103,7953,3976.5
20240721,장항선,신창(순천향대),856,929,1785,892.5
20240721,중앙선,회기,15597,15424,31021,15510.5
20240721,중앙선,중랑,3540,3378,6918,3459
20240721,중앙선,상봉,3864,3909,7773,3886.5
20240721,중앙선,망우,4948,4930,9878,4939
20240721,중앙선,양원,1561,1528,3089,1544.5
20240721,중앙선,구리,7472,7633,15105,7552.5
20240721,중앙선,도농,5484,5410,10894,5447
20240721,중앙선,양정,400,300,700,350
20240721,중앙선,덕소,3333,3426,6759,3379.5
20240721,중앙선,도심,1260,1120,2380,1190
20240721,중앙선,팔당,945,941,1886,943
20240721,중앙선,운길산,738,686,1424,712
20240721,중앙선,양수,1942,1857,3799,1899.5
20240721,중앙선,신원,168,116,284,142
20240721,중앙선,국수,477,466,943,471.5
20240721,중앙선,아신,425,406,831,415.5
20240721,중앙선,오빈,237,227,464,232
20240721,중앙선,양평,2315,2200,4515,2257.5
20240721,중앙선,원덕,306,254,560,280
20240721,중앙선,용문,2044,1681,3725,1862.5
20240721,중앙선,지평,63,37,100,50
20240721,경원선,보산,1107,1354,2461,1230.5
20240721,경원선,동두천중앙,1944,1873,3817,1908.5
20240721,경원선,지행,4452,4645,9097,4548.5
20240721,경원선,덕정,3568,3632,7200,3600
20240721,경원선,덕계,3463,3120,6583,3291.5
20240721,경원선,양주,4937,4826,9763,4881.5
20240721,3호선,고속터미널,47579,43677,91256,45628
20240721,3호선,교대(법원.검찰청),5836,3103,8939,4469.5
20240721,3호선,남부터미널(예술의전당),15199,15721,30920,15460
20240721,3호선,양재(서초구청),13914,15649,29563,14781.5
20240721,3호선,매봉,4314,4262,8576,4288
20240721,3호선,도곡,2207,2317,4524,2262
20240721,3호선,대치,8204,6911,15115,7557.5
20240721,3호선,학여울,1287,1317,2604,1302
20240721,3호선,대청,4790,4863,9653,4826.5
20240721,3호선,일원,4036,4084,8120,4060
20240721,3호선,수서,11443,11259,22702,11351
20240721,3호선,가락시장,4020,4297,8317,4158.5
20240721,3호선,경찰병원,3081,3142,6223,3111.5
20240721,3호선,오금,3023,3018,6041,3020.5
20240721,경부선,세류,2396,2383,4779,2389.5
20240721,경부선,독산,6637,6603,13240,6620
20240721,경부선,수원,37632,35862,73494,36747
20240721,경부선,화서,9896,9658,19554,9777
20240721,경부선,성균관대,8427,8673,17100,8550
20240721,경부선,의왕,4272,4301,8573,4286.5
20240721,경부선,군포,2989,2810,5799,2899.5
20240721,경부선,금정,15655,16163,31818,15909
20240721,경부선,명학,3209,3079,6288,3144
20240721,경부선,안양,13084,13015,26099,13049.5
20240721,경부선,관악,4613,4468,9081,4540.5
20240721,경부선,석수,4582,4368,8950,4475
20240721,4호선,당고개,6036,5756,11792,5896
20240721,경부선,금천구청,5912,5864,11776,5888
20240721,경부선,가산디지털단지,4887,6453,11340,5670
20240721,경부선,구로,10224,10584,20808,10404
20240721,경부선,신길,4792,4272,9064,4532
20240721,경부선,신도림,2233,2815,5048,2524
20240721,경부선,영등포,36814,35791,72605,36302.5
20240721,경부선,대방,5222,5778,11000,5500
20240721,경부선,노량진,5561,5272,10833,5416.5
20240721,경부선,용산,41992,37904,79896,39948
20240721,경부선,남영,5430,5784,11214,5607
20240721,경부선,서울역,10946,3006,13952,6976
20240721,경강선,성남,596,521,1117,558.5
20240721,경강선,여주,2583,2428,5011,2505.5
20240721,경강선,세종대왕릉,312,285,597,298.5
20240721,경강선,부발,1567,2081,3648,1824
20240721,경강선,이천,2453,2675,5128,2564
20240721,경강선,신둔도예촌,971,910,1881,940.5
20240721,경강선,곤지암,1774,1883,3657,1828.5
20240721,경강선,초월,1829,1762,3591,1795.5
20240721,경강선,경기광주,4154,4408,8562,4281
20240721,경강선,삼동,1158,1121,2279,1139.5
20240721,경강선,이매,708,519,1227,613.5
20240721,경강선,판교,3070,2779,5849,2924.5
20240721,9호선2~3단계,중앙보훈병원,4275,4173,8448,4224
20240721,9호선2~3단계,둔촌오륜,729,767,1496,748
20240721,9호선2~3단계,올림픽공원(한국체대),7756,7806,15562,7781
20240721,9호선2~3단계,한성백제,1772,1626,3398,1699
20240721,9호선2~3단계,송파나루,3502,3806,7308,3654
20240721,9호선2~3단계,석촌,5628,4996,10624,5312
20240721,9호선2~3단계,석촌고분,3745,3804,7549,3774.5
20240721,9호선2~3단계,삼전,4177,4083,8260,4130
20240721,9호선2~3단계,종합운동장,3102,2786,5888,2944
20240721,9호선2~3단계,봉은사,13133,13359,26492,13246
20240721,9호선2~3단계,삼성중앙,2238,2362,4600,2300
20240721,9호선2~3단계,선정릉,3268,3645,6913,3456.5
20240721,9호선2~3단계,언주,4285,4414,8699,4349.5
20240721,9호선,신논현,17293,17101,34394,17197
20240721,9호선,사평,2046,2102,4148,2074
20240721,9호선,고속터미널,12939,17977,30916,15458
20240721,9호선,신반포,2417,2419,4836,2418
20240721,9호선,구반포,368,383,751,375.5
20240721,9호선,동작(현충원),1231,1178,2409,1204.5
20240721,9호선,흑석(중앙대입구),4145,4164,8309,4154.5
20240721,9호선,노들,3033,2605,5638,2819
20240721,9호선,노량진,14939,15841,30780,15390
20240721,9호선,샛강,2083,2033,4116,2058
20240721,9호선,여의도,11176,10129,21305,10652.5
20240721,9호선,국회의사당,5934,5481,11415,5707.5
20240721,9호선,당산,9621,9612,19233,9616.5
20240721,9호선,선유도,2987,3015,6002,3001
20240721,9호선,신목동,2005,1866,3871,1935.5
20240721,9호선,염창,9567,9379,18946,9473
20240721,9호선,등촌,5653,5910,11563,5781.5
20240721,9호선,증미,2803,2799,5602,2801
20240721,9호선,가양,12234,12022,24256,12128
20240721,9호선,양천향교,4461,4766,9227,4613.5
20240721,9호선,마곡나루(서울식물원),5923,6057,11980,5990
20240721,9호선,신방화,3971,4009,7980,3990
20240721,9호선,공항시장,1988,2176,4164,2082
20240721,9호선,김포공항,6016,9561,15577,7788.5
20240721,9호선,개화,1162,1008,2170,1085
20240721,8호선,남위례,3353,3509,6862,3431
20240721,8호선,모란,2754,2356,5110,2555
20240721,8호선,수진,3731,3450,7181,3590.5
20240721,8호선,신흥,3198,3231,6429,3214.5
20240721,8호선,단대오거리,5768,5657,11425,5712.5
20240721,8호선,남한산성입구(성남법원.검찰청),6568,5918,12486,6243
20240721,8호선,산성,3116,3399,6515,3257.5
20240721,8호선,복정,5032,4819,9851,4925.5
20240721,8호선,장지,9303,8898,18201,9100.5
20240721,8호선,문정,5611,5876,11487,5743.5
20240721,8호선,가락시장,3331,4077,7408,3704
20240721,8호선,송파,4761,4751,9512,4756
20240721,8호선,석촌,4493,5544,10037,5018.5
20240721,8호선,잠실(송파구청),12235,13228,25463,12731.5
20240721,8호선,몽촌토성(평화의문),3580,3681,7261,3630.5
20240721,8호선,강동구청,4912,5157,10069,5034.5
20240721,8호선,천호(풍납토성),9201,10555,19756,9878
20240721,8호선,암사,9419,8991,18410,9205
20240721,7호선,온수(성공회대입구),4227,4163,8390,4195
20240721,7호선,천왕,5367,5316,10683,5341.5
20240721,7호선,광명사거리,12119,12224,24343,12171.5
20240721,7호선,철산,10809,10871,21680,10840
20240721,7호선,가산디지털단지,9887,9321,19208,9604
20240721,7호선,남구로,7085,6824,13909,6954.5
20240721,7호선,대림(구로구청),9380,8834,18214,9107
20240721,7호선,신풍,6384,6067,12451,6225.5
20240721,7호선,보라매,3929,3986,7915,3957.5
20240721,7호선,신대방삼거리,7899,7878,15777,7888.5
20240721,7호선,장승배기,4719,4808,9527,4763.5
20240721,7호선,상도,6093,5947,12040,6020
20240721,7호선,숭실대입구(살피재),6049,6510,12559,6279.5
20240721,7호선,남성,6158,6187,12345,6172.5
20240721,7호선,이수,9450,9097,18547,9273.5
20240721,7호선,내방,5680,5768,11448,5724
20240721,7호선,고속터미널,13467,8792,22259,11129.5
20240721,7호선,반포,3356,3308,6664,3332
20240721,7호선,논현,6247,6467,12714,6357
20240721,7호선,학동,7469,7719,15188,7594
20240721,7호선,강남구청,5150,5685,10835,5417.5
20240721,7호선,청담,6506,6831,13337,6668.5
20240721,7호선,자양(뚝섬한강공원),6837,6511,13348,6674
20240721,7호선,건대입구,8274,8400,16674,8337
20240721,7호선,어린이대공원(세종대),8118,8025,16143,8071.5
20240721,7호선,군자(능동),8909,6984,15893,7946.5
20240721,7호선,중곡,5567,5313,10880,5440
20240721,7호선,용마산(용마폭포공원),3153,3158,6311,3155.5
20240721,7호선,사가정,8938,8722,17660,8830
20240721,7호선,면목,7868,7683,15551,7775.5
20240721,7호선,상봉,10437,10103,20540,10270
20240721,7호선,중화,5803,5377,11180,5590
20240721,7호선,먹골,5538,5420,10958,5479
20240721,7호선,태릉입구,5137,4662,9799,4899.5
20240721,7호선,공릉(서울과학기술대),6678,6609,13287,6643.5
20240721,7호선,하계,9730,9069,18799,9399.5
20240721,7호선,중계,7743,7338,15081,7540.5
20240721,7호선,노원,14477,14595,29072,14536
20240721,7호선,마들,6367,5872,12239,6119.5
20240721,7호선,수락산,8186,7946,16132,8066
20240721,7호선,도봉산,4709,6531,11240,5620
20240721,7호선,장암,1628,1141,2769,1384.5
20240721,6호선,봉화산(서울의료원),4200,4137,8337,4168.5
20240721,6호선,화랑대(서울여대입구),5220,4421,9641,4820.5
20240721,6호선,태릉입구,3341,3782,7123,3561.5
20240721,6호선,석계,6717,6959,13676,6838
20240721,6호선,돌곶이,6324,5929,12253,6126.5
20240721,6호선,상월곡(한국과학기술연구원),3461,3266,6727,3363.5
20240721,6호선,월곡(동덕여대),5917,5700,11617,5808.5
20240721,6호선,고려대(종암),4294,4142,8436,4218
20240721,6호선,안암(고대병원앞),5285,5468,10753,5376.5
20240721,6호선,보문,4411,4220,8631,4315.5
20240721,6호선,창신,1784,1649,3433,1716.5
20240721,6호선,동묘앞,6365,6206,12571,6285.5
20240721,6호선,신당,5013,5578,10591,5295.5
20240721,6호선,청구,2025,1822,3847,1923.5
20240721,6호선,약수,1955,2045,4000,2000
20240721,6호선,버티고개,1226,1279,2505,1252.5
20240721,6호선,한강진,8318,9377,17695,8847.5
20240721,6호선,이태원,10545,9274,19819,9909.5
20240721,6호선,녹사평(용산구청),3802,3640,7442,3721
20240721,6호선,삼각지,6823,5208,12031,6015.5
20240721,6호선,효창공원앞,3882,3405,7287,3643.5
20240721,6호선,공덕,8244,8082,16326,8163
20240721,6호선,대흥(서강대앞),4620,4761,9381,4690.5
20240721,6호선,광흥창(서강),4857,4660,9517,4758.5
20240721,6호선,상수,7852,7983,15835,7917.5
20240721,6호선,합정,10471,9409,19880,9940
20240721,6호선,망원,10790,11693,22483,11241.5
20240721,6호선,마포구청,7555,7101,14656,7328
20240721,6호선,월드컵경기장(성산),10639,10972,21611,10805.5
20240721,6호선,디지털미디어시티,6204,6244,12448,6224
20240721,6호선,증산(명지대앞),5659,5627,11286,5643
20240721,6호선,새절(신사),6885,6629,13514,6757
20240721,6호선,구산,4521,3517,8038,4019
20240721,6호선,연신내,1,0,1,0.5
20240721,6호선,독바위,1470,1707,3177,1588.5
20240721,6호선,불광,3319,3009,6328,3164
20240721,6호선,역촌,2326,2505,4831,2415.5
20240721,우이신설선,화계,2457,2261,4718,2359
20240721,6호선,응암,10021,10177,20198,10099
20240721,5호선,하남검단산,4849,4659,9508,4754
20240721,5호선,하남시청(덕풍·신장),4857,4640,9497,4748.5
20240721,5호선,하남풍산,2870,2844,5714,2857
20240721,5호선,미사,10005,10290,20295,10147.5
20240721,5호선,강일,3189,2916,6105,3052.5
20240721,5호선,마천,3823,3845,7668,3834
20240721,5호선,거여,4840,4703,9543,4771.5
20240721,5호선,개롱,3476,3701,7177,3588.5
20240721,5호선,오금,1804,1714,3518,1759
20240721,5호선,방이,4442,4299,8741,4370.5
20240721,5호선,올림픽공원(한국체대),4240,4021,8261,4130.5
20240721,5호선,둔촌동,5161,5097,10258,5129
20240721,5호선,상일동,6735,6691,13426,6713
20240721,5호선,고덕,4754,4917,9671,4835.5
20240721,5호선,명일,5344,5436,10780,5390
20240721,5호선,굽은다리(강동구민회관앞),6208,5803,12011,6005.5
20240721,5호선,길동,4615,4573,9188,4594
20240721,5호선,강동,9097,9254,18351,9175.5
20240721,5호선,천호(풍납토성),13607,12858,26465,13232.5
20240721,5호선,광나루(장신대),7887,7423,15310,7655
20240721,5호선,아차산(어린이대공원후문),9233,9069,18302,9151
20240721,5호선,군자(능동),6627,7455,14082,7041
20240721,5호선,장한평,9112,9178,18290,9145
20240721,5호선,답십리,7864,7278,15142,7571
20240721,5호선,마장,2934,2706,5640,2820
20240721,5호선,왕십리(성동구청),2757,3415,6172,3086
20240721,5호선,행당,4089,3673,7762,3881
20240721,5호선,신금호,3148,3507,6655,3327.5
20240721,5호선,청구,1869,1841,3710,1855
20240721,5호선,동대문역사문화공원(DDP),1191,1313,2504,1252
20240721,5호선,을지로4가,1935,2116,4051,2025.5
20240721,5호선,종로3가,10744,10337,21081,10540.5
20240721,5호선,광화문(세종문화회관),13434,13914,27348,13674
20240721,5호선,서대문,5567,5373,10940,5470
20240721,5호선,충정로(경기대입구),1600,1652,3252,1626
20240721,5호선,애오개,2983,3066,6049,3024.5
20240721,5호선,공덕,5082,5268,10350,5175
20240721,5호선,마포,5846,5832,11678,5839
20240721,5호선,여의나루,8386,9887,18273,9136.5
20240721,5호선,여의도,9550,9792,19342,9671
20240721,5호선,신길,2721,2781,5502,2751
20240721,5호선,영등포시장,6418,6565,12983,6491.5
20240721,5호선,영등포구청,1830,1771,3601,1800.5
20240721,5호선,양평,2956,3014,5970,2985
20240721,5호선,오목교(목동운동장앞),11615,11800,23415,11707.5
20240721,5호선,목동,8053,8390,16443,8221.5
20240721,5호선,신정(은행정),6714,6102,12816,6408
20240721,5호선,까치산,15970,15625,31595,15797.5
20240721,5호선,화곡,14812,14021,28833,14416.5
20240721,5호선,우장산,7405,7726,15131,7565.5
20240721,5호선,발산,10461,10820,21281,10640.5
20240721,5호선,마곡,4122,4299,8421,4210.5
20240721,5호선,송정,3687,3712,7399,3699.5
20240721,5호선,김포공항,9162,6784,15946,7973
20240721,5호선,개화산,3139,3044,6183,3091.5
20240721,5호선,방화,3989,3957,7946,3973
20240721,4호선,남태령,1012,705,1717,858.5
20240721,4호선,사당,18177,16943,35120,17560
20240721,4호선,총신대입구(이수),11504,12501,24005,12002.5
20240721,4호선,동작(현충원),959,991,1950,975
20240721,4호선,이촌(국립중앙박물관),6926,7344,14270,7135
20240721,4호선,신용산,12655,13367,26022,13011
20240721,4호선,삼각지,5607,7651,13258,6629
20240721,4호선,숙대입구(갈월),9760,9371,19131,9565.5
20240721,4호선,서울역,6293,15597,21890,10945
20240721,4호선,회현(남대문시장),10525,10559,21084,10542
20240721,4호선,명동,26647,29062,55709,27854.5
20240721,4호선,충무로,11852,12160,24012,12006
20240721,4호선,동대문역사문화공원(DDP),14385,12719,27104,13552
20240721,4호선,동대문,8523,9337,17860,8930
20240721,4호선,혜화,26336,26881,53217,26608.5
20240721,4호선,한성대입구(삼선교),8593,8549,17142,8571
20240721,4호선,성신여대입구(돈암),14115,13687,27802,13901
20240721,4호선,길음,11459,11320,22779,11389.5
20240721,4호선,미아사거리,16658,16033,32691,16345.5
20240721,4호선,미아(서울사이버대학),8647,8146,16793,8396.5
20240721,4호선,수유(강북구청),21179,20539,41718,20859
20240721,4호선,쌍문,16805,15247,32052,16026
20240721,4호선,창동,16540,17068,33608,16804
20240721,4호선,노원,17851,19369,37220,18610
20240721,4호선,상계,10849,9992,20841,10420.5
20240721,우이신설선,가오리,2581,2455,5036,2518
20240721,우이신설선,4.19민주묘지,2183,1951,4134,2067
20240721,우이신설선,솔밭공원,1700,1563,3263,1631.5
20240721,우이신설선,북한산우이,3472,3518,6990,3495
20240721,안산선,수리산,2183,1969,4152,2076
20240721,안산선,오이도,5411,5390,10801,5400.5
20240721,안산선,정왕,6542,6636,13178,6589
20240721,안산선,신길온천,1473,1338,2811,1405.5
20240721,안산선,안산,11438,10470,21908,10954
20240721,안산선,초지,2688,2685,5373,2686.5
20240721,안산선,고잔,4727,4638,9365,4682.5
20240721,안산선,중앙,12146,12269,24415,12207.5
20240721,안산선,한대앞,5773,5600,11373,5686.5
20240721,안산선,상록수,9196,9153,18349,9174.5
20240721,안산선,반월,2517,2567,5084,2542
20240721,안산선,대야미,2985,2794,5779,2889.5
20240721,안산선,산본,9653,10282,19935,9967.5
20240721,신림선,관악산(서울대),2886,2816,5702,2851
20240721,신림선,서울대벤처타운,6034,5886,11920,5960
20240721,신림선,서원,2096,2001,4097,2048.5
20240721,신림선,신림,1307,1710,3017,1508.5
20240721,신림선,당곡,2822,2824,5646,2823
20240721,신림선,보라매병원,2401,2551,4952,2476
20240721,신림선,보라매공원,1316,1330,2646,1323
20240721,신림선,보라매,2403,2174,4577,2288.5
20240721,신림선,서울지방병무청,1737,1988,3725,1862.5
20240721,신림선,대방,1782,1471,3253,1626.5
20240721,신림선,샛강,858,1032,1890,945
20240721,수인선,인천,1082,1402,2484,1242
20240721,수인선,신포,1432,1352,2784,1392
20240721,수인선,숭의,2456,2271,4727,2363.5
20240721,수인선,인하대,3418,3403,6821,3410.5
20240721,수인선,송도,1649,1640,3289,1644.5
20240721,수인선,연수,3805,3753,7558,3779
20240721,수인선,원인재,2972,2975,5947,2973.5
20240721,수인선,남동인더스파크,705,704,1409,704.5
20240721,수인선,호구포,2251,2381,4632,2316
20240721,수인선,인천논현,3367,3586,6953,3476.5
20240721,수인선,소래포구,3535,3438,6973,3486.5
20240721,수인선,월곶,2008,1963,3971,1985.5
20240721,수인선,달월,44,48,92,46
20240721,수인선,사리,2920,2469,5389,2694.5
20240721,수인선,야목,226,201,427,213.5
20240721,수인선,어천,1031,1182,2213,1106.5
20240721,수인선,오목천,2236,2208,4444,2222
20240721,수인선,고색,2184,2270,4454,2227
20240721,서해선,부천종합운동장,1349,1097,2446,1223
20240721,서해선,원종,3042,2982,6024,3012
20240721,서해선,김포공항,2718,3539,6257,3128.5
20240721,분당선,매교,2427,2395,4822,2411
20240721,분당선,수원시청,7972,7766,15738,7869
20240721,분당선,매탄권선,2963,2892,5855,2927.5
20240721,분당선,망포,6503,7095,13598,6799
20240721,분당선,영통,5671,5418,11089,5544.5
20240721,분당선,청명,2279,2295,4574,2287
20240721,분당선,상갈,2955,3409,6364,3182
20240721,분당선,기흥,4716,4216,8932,4466
20240721,분당선,신갈,2321,3147,5468,2734
20240721,분당선,구성,3357,3620,6977,3488.5
20240721,분당선,죽전,7542,8477,16019,8009.5
20240721,분당선,보정,1156,1160,2316,1158
20240721,분당선,이매,3406,3559,6965,3482.5
20240721,분당선,오리,5508,4918,10426,5213
20240721,분당선,미금,7968,7990,15958,7979
20240721,분당선,정자,7767,8127,15894,7947
20240721,분당선,수내,6310,6139,12449,6224.5
20240721,분당선,서현,14166,14156,28322,14161
20240721,분당선,야탑,13580,14046,27626,13813
20240721,분당선,모란,11209,11843,23052,11526
20240721,분당선,태평,8294,7710,16004,8002
20240721,분당선,가천대,3690,4099,7789,3894.5
20240721,분당선,선정릉,2158,2120,4278,2139
20240721,분당선,강남구청,3079,3745,6824,3412
20240721,분당선,압구정로데오,10408,11296,21704,10852
20240721,분당선,서울숲,7121,6871,13992,6996
20240721,분당선,수원,5969,5466,11435,5717.5
20240721,분당선,복정,6,0,6,3
20240721,분당선,수서,10326,10466,20792,10396
20240721,분당선,대모산입구,2803,2756,5559,2779.5
20240721,분당선,개포동,2527,2549,5076,2538
20240721,분당선,구룡,1628,1770,3398,1699
20240721,분당선,도곡,3267,3274,6541,3270.5
20240721,분당선,한티,11581,10885,22466,11233
20240721,분당선,선릉,3058,4556,7614,3807
20240721,과천선,범계,16768,15992,32760,16380
20240721,과천선,평촌,6884,6618,13502,6751
20240721,과천선,인덕원,13533,13972,27505,13752.5
20240721,과천선,정부과천청사,5579,5684,11263,5631.5
20240721,과천선,과천,4311,3927,8238,4119
20240721,과천선,대공원,14741,17805,32546,16273
20240721,과천선,경마공원,15129,14875,30004,15002
20240721,과천선,선바위,4328,3776,8104,4052
20240721,공항철도 1호선,영종,3058,3033,6091,3045.5
20240721,공항철도 1호선,인천공항2터미널,9074,6931,16005,8002.5
20240721,공항철도 1호선,인천공항1터미널,15590,15242,30832,15416
20240721,공항철도 1호선,공항화물청사,969,1946,2915,1457.5
20240721,공항철도 1호선,운서,7890,9267,17157,8578.5
20240721,공항철도 1호선,청라국제도시,3904,4014,7918,3959
20240721,공항철도 1호선,검암,3552,3716,7268,3634
20240721,공항철도 1호선,계양,7119,6951,14070,7035
20240721,공항철도 1호선,김포공항,8695,4459,13154,6577
20240721,공항철도 1호선,마곡나루(서울식물원),2722,3167,5889,2944.5
20240721,공항철도 1호선,디지털미디어시티,4021,4218,8239,4119.5
20240721,공항철도 1호선,홍대입구,16809,15047,31856,15928
20240721,공항철도 1호선,공덕,1923,2638,4561,2280.5
20240721,공항철도 1호선,서울역,14594,12607,27201,13600.5
20240721,경춘선,춘천,1434,1244,2678,1339
20240721,경춘선,남춘천,2319,2372,4691,2345.5
20240721,경춘선,김유정,367,338,705,352.5
20240721,경춘선,강촌,714,416,1130,565
20240721,경춘선,백양리,139,58,197,98.5
20240721,경춘선,굴봉산,207,122,329,164.5
20240721,경춘선,가평,2637,1741,4378,2189
20240721,경춘선,상천,343,238,581,290.5
20240721,경춘선,청평,2216,1593,3809,1904.5
20240721,경춘선,대성리,1127,729,1856,928
20240721,경춘선,마석,2464,2413,4877,2438.5
20240721,경춘선,천마산,1000,977,1977,988.5
20240721,경춘선,평내호평,3262,3278,6540,3270
20240721,경춘선,금곡,808,797,1605,802.5
20240721,경춘선,사릉,1193,1155,2348,1174
20240721,경춘선,퇴계원,1864,1773,3637,1818.5
20240721,경춘선,별내,1912,1889,3801,1900.5
20240721,경춘선,갈매,1384,1283,2667,1333.5
20240721,경춘선,신내,1194,1128,2322,1161
20240721,경인선,도화,2591,2403,4994,2497
20240721,경인선,중동,5373,5052,10425,5212.5
20240721,경인선,온수(성공회대입구),4153,3758,7911,3955.5
20240721,경인선,도원,4719,4809,9528,4764
20240721,경인선,간석,3602,3345,6947,3473.5
20240721,경인선,부개,5283,4961,10244,5122
20240721,경인선,소사,4897,4495,9392,4696
20240721,경인선,구일,3505,3333,6838,3419
20240721,경인선,인천,3601,3153,6754,3377
20240721,경인선,동인천,9755,9334,19089,9544.5
20240721,경인선,제물포,5647,5591,11238,5619
20240721,경인선,주안,12089,10599,22688,11344
20240721,경인선,동암,10248,9997,20245,10122.5
20240721,경인선,백운,4716,4627,9343,4671.5
20240721,경인선,부평,23138,22793,45931,22965.5
20240721,경인선,송내,13197,13054,26251,13125.5
20240721,경인선,부천,23412,22928,46340,23170
20240721,경인선,역곡,14267,14267,28534,14267
20240721,경인선,오류동,7122,6711,13833,6916.5
20240721,경인선,개봉,12244,12143,24387,12193.5
20240721,경의선,운천,7,2,9,4.5
20240721,경의선,임진강,37,51,88,44
20240721,경의선,문산,3870,4193,8063,4031.5
20240721,경의선,파주,747,681,1428,714
20240721,경의선,월롱,752,1215,1967,983.5
20240721,경의선,금촌,4975,5514,10489,5244.5
20240721,경의선,금릉,3367,3241,6608,3304
20240721,경의선,운정,4266,4138,8404,4202
20240721,경의선,야당,5937,5900,11837,5918.5
20240721,경의선,탄현,4533,4218,8751,4375.5
20240721,경의선,일산,6161,5786,11947,5973.5
20240721,경의선,백마,3786,3689,7475,3737.5
20240721,경의선,곡산,348,342,690,345
20240721,경의선,능곡,2754,2691,5445,2722.5
20240721,경의선,행신,4950,4740,9690,4845
20240721,경의선,강매,1455,1418,2873,1436.5
20240721,경의선,한국항공대,979,958,1937,968.5
20240721,경의선,수색,1266,1403,2669,1334.5
20240721,경의선,디지털미디어시티,1747,1608,3355,1677.5
20240721,경의선,가좌,3293,3306,6599,3299.5
20240721,경의선,홍대입구,2447,2943,5390,2695
20240721,경의선,서강대,1483,1475,2958,1479
20240721,경의선,공덕,2624,1907,4531,2265.5
20240721,경의선,효창공원앞,1496,1864,3360,1680
20240721,경의선,신촌,257,383,640,320
20240721,경의선,서울역,1253,1176,2429,1214.5
20240721,경원선,연천,1045,1065,2110,1055
20240721,경원선,전곡,1010,1078,2088,1044
20240721,경원선,청산,146,109,255,127.5
20240721,경원선,소요산,2326,2359,4685,2342.5
20240721,경원선,동두천,1166,1175,2341,1170.5
20240722,7호선,이수,16901,16382,33283,16641.5
20240722,7호선,내방,15788,15798,31586,15793
20240722,7호선,고속터미널,17280,14338,31618,15809
20240722,7호선,반포,6092,5903,11995,5997.5
20240722,7호선,논현,20197,20574,40771,20385.5
20240722,7호선,학동,26505,27218,53723,26861.5
20240722,7호선,강남구청,17033,18767,35800,17900
20240722,7호선,청담,19909,21656,41565,20782.5
20240722,7호선,자양(뚝섬한강공원),8336,8179,16515,8257.5
20240722,7호선,건대입구,12851,13061,25912,12956
20240722,7호선,어린이대공원(세종대),13441,13383,26824,13412
20240722,7호선,군자(능동),15630,12571,28201,14100.5
20240722,7호선,중곡,11287,10722,22009,11004.5
20240722,7호선,용마산(용마폭포공원),5792,5525,11317,5658.5
20240722,7호선,사가정,16168,16360,32528,16264
20240722,7호선,면목,15120,14907,30027,15013.5
20240722,7호선,상봉,17604,16839,34443,17221.5
20240722,7호선,중화,10630,10626,21256,10628
20240722,7호선,먹골,10423,10417,20840,10420
20240722,7호선,태릉입구,8653,8113,16766,8383
20240722,7호선,공릉(서울과학기술대),12033,11878,23911,11955.5
20240722,7호선,하계,18165,17136,35301,17650.5
20240722,7호선,중계,14759,13503,28262,14131
20240722,7호선,노원,24712,25369,50081,25040.5
20240722,7호선,마들,13326,12750,26076,13038
20240722,7호선,수락산,12228,12118,24346,12173
20240722,7호선,도봉산,8911,9927,18838,9419
20240722,7호선,장암,2781,1036,3817,1908.5
20240722,6호선,봉화산(서울의료원),9437,8798,18235,9117.5
20240722,6호선,화랑대(서울여대입구),11982,9507,21489,10744.5
20240722,6호선,태릉입구,5568,6231,11799,5899.5
20240722,6호선,석계,12727,12956,25683,12841.5
20240722,6호선,돌곶이,11709,10898,22607,11303.5
20240722,6호선,상월곡(한국과학기술연구원),6506,5948,12454,6227
20240722,6호선,월곡(동덕여대),12050,12048,24098,12049
20240722,6호선,고려대(종암),8514,8066,16580,8290
20240722,6호선,안암(고대병원앞),11506,11645,23151,11575.5
20240722,6호선,보문,7990,7386,15376,7688
20240722,6호선,창신,3529,2794,6323,3161.5
20240722,6호선,동묘앞,7878,8209,16087,8043.5
20240722,6호선,신당,8678,9262,17940,8970
20240722,6호선,청구,4113,4019,8132,4066
20240722,6호선,약수,3800,3648,7448,3724
20240722,6호선,버티고개,2156,2185,4341,2170.5
20240722,6호선,한강진,7488,8552,16040,8020
20240722,6호선,이태원,9729,9762,19491,9745.5
20240722,6호선,녹사평(용산구청),4661,4619,9280,4640
20240722,6호선,삼각지,6557,6338,12895,6447.5
20240722,6호선,효창공원앞,7417,6551,13968,6984
20240722,6호선,공덕,20285,19981,40266,20133
20240722,6호선,대흥(서강대앞),9019,9572,18591,9295.5
20240722,6호선,광흥창(서강),10390,9926,20316,10158
20240722,6호선,상수,9339,9688,19027,9513.5
20240722,6호선,합정,12907,12497,25404,12702
20240722,6호선,망원,14515,15426,29941,14970.5
20240722,6호선,마포구청,15041,13706,28747,14373.5
20240722,6호선,월드컵경기장(성산),3830,3956,7786,3893
20240722,6호선,디지털미디어시티,15592,17217,32809,16404.5
20240722,6호선,증산(명지대앞),9862,9758,19620,9810
20240722,6호선,새절(신사),13142,12182,25324,12662
20240722,6호선,구산,8279,6725,15004,7502
20240722,6호선,연신내,1,0,1,0.5
20240722,6호선,독바위,2965,3072,6037,3018.5
20240722,6호선,불광,4407,4368,8775,4387.5
20240722,6호선,역촌,4054,4487,8541,4270.5
20240722,6호선,응암,17934,17715,35649,17824.5
20240722,5호선,하남검단산,6360,6025,12385,6192.5
20240722,5호선,하남시청(덕풍·신장),8604,8217,16821,8410.5
20240722,5호선,하남풍산,4687,4738,9425,4712.5
20240722,5호선,미사,18282,18431,36713,18356.5
20240722,5호선,강일,6232,5736,11968,5984
20240722,5호선,마천,7866,6910,14776,7388
20240722,5호선,거여,10627,10425,21052,10526
20240722,5호선,개롱,7040,7213,14253,7126.5
20240722,5호선,오금,3879,3932,7811,3905.5
20240722,5호선,방이,7610,7827,15437,7718.5
20240722,5호선,올림픽공원(한국체대),5422,4629,10051,5025.5
20240722,5호선,둔촌동,9118,9212,18330,9165
20240722,5호선,상일동,15734,15023,30757,15378.5
20240722,5호선,고덕,11448,11340,22788,11394
20240722,5호선,명일,8908,9296,18204,9102
20240722,5호선,굽은다리(강동구민회관앞),10007,9757,19764,9882
20240722,5호선,길동,8583,8864,17447,8723.5
20240722,5호선,강동,19021,18535,37556,18778
20240722,5호선,천호(풍납토성),19163,18826,37989,18994.5
20240722,5호선,광나루(장신대),12956,12023,24979,12489.5
20240722,5호선,아차산(어린이대공원후문),13861,13865,27726,13863
20240722,9호선,샛강,7451,7457,14908,7454
20240722,9호선,여의도,33645,32495,66140,33070
20240722,9호선,국회의사당,17882,18809,36691,18345.5
20240722,9호선,당산,20031,19962,39993,19996.5
20240722,9호선,선유도,9767,9345,19112,9556
20240722,9호선,신목동,4789,4356,9145,4572.5
20240722,9호선,염창,18355,17907,36262,18131
20240722,9호선,등촌,13064,12683,25747,12873.5
20240722,9호선,증미,8929,8932,17861,8930.5
20240722,9호선,가양,23084,22631,45715,22857.5
20240722,9호선,양천향교,10544,10941,21485,10742.5
20240722,9호선,마곡나루(서울식물원),14326,14043,28369,14184.5
20240722,9호선,신방화,7298,7353,14651,7325.5
20240722,9호선,공항시장,3146,3429,6575,3287.5
20240722,9호선,김포공항,7016,10284,17300,8650
20240722,9호선,개화,3107,1980,5087,2543.5
20240722,8호선,남위례,7382,7384,14766,7383
20240722,8호선,모란,4691,3589,8280,4140
20240722,8호선,수진,5517,5044,10561,5280.5
20240722,안산선,상록수,14914,15148,30062,15031
20240722,안산선,한대앞,8891,9008,17899,8949.5
20240722,안산선,중앙,18436,18920,37356,18678
20240722,안산선,고잔,9006,8393,17399,8699.5
20240722,안산선,초지,5172,5148,10320,5160
20240722,안산선,안산,12024,11037,23061,11530.5
20240722,안산선,신길온천,2092,1862,3954,1977
20240722,안산선,정왕,8818,9083,17901,8950.5
20240722,안산선,오이도,7502,7228,14730,7365
20240722,안산선,수리산,4073,3328,7401,3700.5
20240722,우이신설선,북한산우이,2506,2152,4658,2329
20240722,우이신설선,솔밭공원,2550,2518,5068,2534
20240722,우이신설선,4.19민주묘지,2867,2760,5627,2813.5
20240722,우이신설선,가오리,4397,4420,8817,4408.5
20240722,우이신설선,화계,3645,3589,7234,3617
20240722,우이신설선,삼양,2090,2110,4200,2100
20240722,우이신설선,삼양사거리,2521,2602,5123,2561.5
20240722,우이신설선,솔샘,6064,5886,11950,5975
20240722,우이신설선,북한산보국문,5832,5795,11627,5813.5
20240722,우이신설선,정릉,4520,4298,8818,4409
20240722,우이신설선,성신여대입구(돈암),3540,3764,7304,3652
20240722,우이신설선,보문,1623,1641,3264,1632
20240722,우이신설선,신설동,2465,2262,4727,2363.5
20240722,일산선,원흥,11482,10872,22354,11177
20240722,일산선,지축,3,0,3,1.5
20240722,일산선,삼송,19007,18322,37329,18664.5
20240722,일산선,원당,10688,10181,20869,10434.5
20240722,일산선,화정,16752,17373,34125,17062.5
20240722,일산선,대곡,2953,2147,5100,2550
20240722,일산선,백석,9896,10044,19940,9970
20240722,일산선,마두,7968,7967,15935,7967.5
20240722,일산선,정발산,6578,6512,13090,6545
20240722,일산선,주엽,9918,10090,20008,10004
20240722,일산선,대화,13661,10216,23877,11938.5
20240722,장항선,봉명,1501,1507,3008,1504
20240722,장항선,쌍용(나사렛대),2146,2068,4214,2107
20240722,장항선,아산,3519,3145,6664,3332
20240722,장항선,탕정,1778,1654,3432,1716
20240722,장항선,배방,1243,1186,2429,1214.5
20240722,장항선,온양온천,4116,4123,8239,4119.5
20240722,8호선,신흥,5208,5379,10587,5293.5
20240722,8호선,단대오거리,12203,11946,24149,12074.5
20240722,8호선,남한산성입구(성남법원.검찰청),13028,11909,24937,12468.5
20240722,8호선,산성,6358,6476,12834,6417
20240722,5호선,군자(능동),11141,12285,23426,11713
20240722,5호선,장한평,20087,20232,40319,20159.5
20240722,5호선,답십리,16872,15317,32189,16094.5
20240722,5호선,마장,5984,5623,11607,5803.5
20240722,5호선,왕십리(성동구청),4617,5229,9846,4923
20240722,5호선,행당,8290,7512,15802,7901
20240722,5호선,신금호,6520,6924,13444,6722
20240722,5호선,동대문역사문화공원(DDP),3492,3899,7391,3695.5
20240722,5호선,을지로4가,6855,6900,13755,6877.5
20240722,5호선,종로3가,14438,14124,28562,14281
20240722,5호선,광화문(세종문화회관),34181,35602,69783,34891.5
20240722,5호선,서대문,21948,22153,44101,22050.5
20240722,5호선,충정로(경기대입구),5241,5218,10459,5229.5
20240722,5호선,애오개,7380,7186,14566,7283
20240722,5호선,공덕,15550,16362,31912,15956
20240722,5호선,마포,15922,16458,32380,16190
20240722,5호선,여의나루,11358,13460,24818,12409
20240722,5호선,여의도,33009,34490,67499,33749.5
20240722,5호선,신길,5195,5407,10602,5301
20240722,5호선,영등포시장,11618,11738,23356,11678
20240722,5호선,영등포구청,4948,4879,9827,4913.5
20240722,경부선,의왕,9184,9339,18523,9261.5
20240722,경부선,군포,7707,7597,15304,7652
20240722,경부선,금정,28578,28964,57542,28771
20240722,경부선,명학,8789,8755,17544,8772
20240722,경부선,안양,21128,21033,42161,21080.5
20240722,경부선,관악,7171,6945,14116,7058
20240722,경부선,석수,8553,7813,16366,8183
20240722,경부선,금천구청,11209,11456,22665,11332.5
20240722,경부선,가산디지털단지,19058,21879,40937,20468.5
20240722,경부선,구로,17466,17684,35150,17575
20240722,경부선,신길,9027,7541,16568,8284
20240722,경부선,신도림,3839,4056,7895,3947.5
20240722,경부선,영등포,38607,39429,78036,39018
20240722,경부선,대방,10554,11681,22235,11117.5
20240722,경부선,노량진,7237,7258,14495,7247.5
20240722,경부선,용산,38739,40114,78853,39426.5
20240722,경부선,남영,9637,10060,19697,9848.5
20240722,경부선,서울역,9547,3533,13080,6540
20240722,경강선,성남,950,877,1827,913.5
20240722,경강선,여주,2647,2574,5221,2610.5
20240722,경강선,세종대왕릉,312,315,627,313.5
20240722,경강선,부발,2173,2266,4439,2219.5
20240722,경강선,이천,2999,3067,6066,3033
20240722,경강선,신둔도예촌,1489,1445,2934,1467
20240722,경강선,곤지암,2118,2106,4224,2112
20240722,경강선,초월,3573,3389,6962,3481
20240722,경강선,경기광주,8167,7662,15829,7914.5
20240722,경부선,성균관대,15287,15180,30467,15233.5
20240722,경부선,화서,11902,11443,23345,11672.5
20240722,경부선,수원,34791,36316,71107,35553.5
20240722,경부선,독산,18613,19254,37867,18933.5
20240722,경부선,세류,3584,3255,6839,3419.5
20240722,경부선,병점,14806,14659,29465,14732.5
20240722,경부선,세마,3458,3267,6725,3362.5
20240722,경부선,오산대,3620,3323,6943,3471.5
20240722,경부선,오산,9855,10154,20009,10004.5
20240722,경부선,진위,1887,1702,3589,1794.5
20240722,경부선,송탄,4377,4219,8596,4298
20240722,경부선,서정리,8310,8046,16356,8178
20240722,경부선,평택지제,4246,4068,8314,4157
20240722,경부선,평택,12025,11946,23971,11985.5
20240722,경부선,성환,3788,3924,7712,3856
20240722,경부선,직산,1014,1015,2029,1014.5
20240722,경부선,두정,6357,6511,12868,6434
20240722,경부선,천안,5424,5710,11134,5567
20240722,경부선,당정,6093,5780,11873,5936.5
20240722,경부선,서동탄,1624,1346,2970,1485
20240722,경부선,광명,3918,3341,7259,3629.5
20240722,경원선,이촌(국립중앙박물관),3979,3136,7115,3557.5
20240722,경원선,서빙고,2121,1861,3982,1991
20240722,경원선,한남,3962,3871,7833,3916.5
20240722,경원선,옥수,57,46,103,51.5
20240722,경원선,응봉,1896,1583,3479,1739.5
20240722,경원선,왕십리(성동구청),15803,16127,31930,15965
20240722,경원선,청량리(서울시립대입구),15330,15999,31329,15664.5
20240722,경원선,외대앞,8293,8058,16351,8175.5
20240722,경원선,신이문,8635,8052,16687,8343.5
20240722,경원선,석계,6992,8351,15343,7671.5
20240722,경원선,광운대,7705,7317,15022,7511
20240722,경원선,월계,6513,6178,12691,6345.5
20240722,경원선,녹천,4706,4004,8710,4355
20240722,경원선,방학,9702,9437,19139,9569.5
20240722,경원선,도봉,6107,5757,11864,5932
20240722,경원선,도봉산,6331,3772,10103,5051.5
20240722,경원선,망월사,6974,7163,14137,7068.5
20240722,경원선,회룡,12834,12506,25340,12670
20240722,경원선,의정부,17549,17655,35204,17602
20240722,경원선,가능,6390,6295,12685,6342.5
20240722,경원선,녹양,4248,4031,8279,4139.5
20240722,경원선,양주,7000,6704,13704,6852
20240722,경원선,덕계,5817,5282,11099,5549.5
20240722,경원선,덕정,5730,5577,11307,5653.5
20240722,경원선,지행,6406,6188,12594,6297
20240722,경원선,동두천중앙,2858,2727,5585,2792.5
20240722,경원선,보산,1412,1301,2713,1356.5
20240722,경원선,동두천,1645,1572,3217,1608.5
20240722,경원선,소요산,1143,1096,2239,1119.5
20240722,경원선,청산,144,120,264,132
20240722,경원선,전곡,1035,870,1905,952.5
20240722,경원선,연천,1073,856,1929,964.5
20240722,경의선,서울역,4950,6209,11159,5579.5
20240722,경의선,신촌,1031,1321,2352,1176
20240722,경의선,효창공원앞,3158,3718,6876,3438
20240722,경의선,공덕,4693,3638,8331,4165.5
20240722,경의선,서강대,2130,2075,4205,2102.5
20240722,경의선,홍대입구,2058,2459,4517,2258.5
20240722,경의선,가좌,5898,5664,11562,5781
20240722,경의선,디지털미디어시티,2830,2637,5467,2733.5
20240722,경의선,수색,3550,3632,7182,3591
20240722,경의선,한국항공대,1856,1715,3571,1785.5
20240722,경의선,강매,3372,2830,6202,3101
20240722,경의선,행신,8159,8224,16383,8191.5
20240722,경의선,능곡,4639,4268,8907,4453.5
20240722,경의선,곡산,652,695,1347,673.5
20240722,경의선,백마,7546,7314,14860,7430
20240722,경의선,풍산,6138,5680,11818,5909
20240722,경의선,일산,10420,10216,20636,10318
20240722,경의선,탄현,7827,7580,15407,7703.5
20240722,경의선,야당,8396,8303,16699,8349.5
20240722,경의선,운정,7802,7119,14921,7460.5
20240722,경의선,금릉,5384,5083,10467,5233.5
20240722,경의선,금촌,6094,5815,11909,5954.5
20240722,경의선,월롱,1865,1705,3570,1785
20240722,경의선,파주,1106,833,1939,969.5
20240722,경의선,문산,5127,4819,9946,4973
20240722,경의선,임진강,0,3,3,1.5
20240722,경의선,운천,3,3,6,3
20240722,경인선,개봉,21550,21330,42880,21440
20240722,경인선,오류동,11637,11035,22672,11336
20240722,경인선,역곡,25375,25546,50921,25460.5
20240722,경인선,부천,29766,29452,59218,29609
20240722,경인선,송내,26512,25977,52489,26244.5
20240722,경인선,부평,27261,28233,55494,27747
20240722,경인선,백운,7342,7056,14398,7199
20240722,경인선,동암,14966,14972,29938,14969
20240722,경인선,주안,17667,15931,33598,16799
20240722,경인선,제물포,10181,9818,19999,9999.5
20240722,경인선,동인천,12927,12058,24985,12492.5
20240722,경인선,인천,3061,2411,5472,2736
20240722,경인선,구일,6461,6525,12986,6493
20240722,경인선,소사,7252,6992,14244,7122
20240722,경인선,부개,8414,8048,16462,8231
20240722,경인선,간석,5781,5479,11260,5630
20240722,경인선,도원,3109,3173,6282,3141
20240722,경인선,온수(성공회대입구),5971,5703,11674,5837
20240722,경인선,중동,9318,8684,18002,9001
20240722,경인선,도화,3997,3738,7735,3867.5
20240722,경춘선,신내,2836,2617,5453,2726.5
20240722,경춘선,갈매,3005,2683,5688,2844
20240722,경춘선,별내,3464,3286,6750,3375
20240722,경춘선,퇴계원,3576,3292,6868,3434
20240722,경춘선,사릉,2047,2033,4080,2040
20240722,경춘선,금곡,1442,1413,2855,1427.5
20240722,경춘선,평내호평,6060,5790,11850,5925
20240722,경춘선,천마산,1454,1341,2795,1397.5
20240722,경춘선,마석,3644,3534,7178,3589
20240722,경춘선,대성리,689,955,1644,822
20240722,경춘선,청평,1759,1862,3621,1810.5
20240722,경춘선,상천,211,192,403,201.5
20240722,경춘선,가평,2213,2645,4858,2429
20240722,경춘선,굴봉산,122,95,217,108.5
20240722,경춘선,백양리,53,56,109,54.5
20240722,경춘선,강촌,400,359,759,379.5
20240722,경춘선,김유정,325,345,670,335
20240722,경춘선,남춘천,2637,2749,5386,2693
20240722,경춘선,춘천,1220,1122,2342,1171
20240722,공항철도 1호선,서울역,13629,12149,25778,12889
20240722,공항철도 1호선,공덕,3202,4056,7258,3629
20240722,공항철도 1호선,홍대입구,15554,14768,30322,15161
20240722,공항철도 1호선,디지털미디어시티,15215,14422,29637,14818.5
20240722,공항철도 1호선,마곡나루(서울식물원),12066,11423,23489,11744.5
20240722,공항철도 1호선,김포공항,10212,6219,16431,8215.5
20240722,공항철도 1호선,계양,13690,12934,26624,13312
20240722,공항철도 1호선,검암,6478,6744,13222,6611
20240722,공항철도 1호선,청라국제도시,7660,7261,14921,7460.5
20240722,공항철도 1호선,운서,10045,9661,19706,9853
20240722,공항철도 1호선,공항화물청사,2206,2350,4556,2278
20240722,공항철도 1호선,인천공항1터미널,15523,15461,30984,15492
20240722,공항철도 1호선,인천공항2터미널,7473,6767,14240,7120
20240722,공항철도 1호선,영종,4050,4114,8164,4082
20240722,과천선,선바위,7716,6783,14499,7249.5
20240722,과천선,경마공원,842,821,1663,831.5
20240722,과천선,대공원,1873,1886,3759,1879.5
20240722,과천선,과천,6722,6100,12822,6411
20240722,과천선,정부과천청사,13149,13625,26774,13387
20240722,과천선,인덕원,25827,26892,52719,26359.5
20240722,과천선,평촌,18806,18277,37083,18541.5
20240722,과천선,범계,26921,26939,53860,26930
20240722,분당선,선릉,14692,23010,37702,18851
20240722,분당선,한티,17028,18417,35445,17722.5
20240722,분당선,도곡,7960,8156,16116,8058
20240722,분당선,구룡,3758,3748,7506,3753
20240722,분당선,개포동,4787,4816,9603,4801.5
20240722,분당선,대모산입구,6307,5971,12278,6139
20240722,분당선,수서,17650,18027,35677,17838.5
20240722,분당선,복정,2,0,2,1
20240722,분당선,수원,7721,7015,14736,7368
20240722,분당선,서울숲,13000,13186,26186,13093
20240722,분당선,압구정로데오,18024,19464,37488,18744
20240722,분당선,강남구청,10241,11838,22079,11039.5
20240722,분당선,선정릉,8554,8987,17541,8770.5
20240722,분당선,가천대,6695,6943,13638,6819
20240722,분당선,태평,13430,12931,26361,13180.5
20240722,분당선,모란,19952,20061,40013,20006.5
20240722,분당선,야탑,26161,27547,53708,26854
20240722,분당선,서현,26140,26616,52756,26378
20240722,분당선,수내,15115,15278,30393,15196.5
20240722,분당선,정자,19656,20571,40227,20113.5
20240722,분당선,미금,16285,17014,33299,16649.5
20240722,분당선,오리,12066,10588,22654,11327
20240722,분당선,이매,5869,5515,11384,5692
20240722,분당선,보정,2588,2388,4976,2488
20240722,분당선,죽전,12865,14375,27240,13620
20240722,분당선,구성,6636,6795,13431,6715.5
20240722,분당선,신갈,5152,4970,10122,5061
20240722,분당선,기흥,10684,9713,20397,10198.5
20240722,분당선,상갈,5472,5271,10743,5371.5
20240722,분당선,청명,4768,4566,9334,4667
20240722,분당선,영통,9034,9203,18237,9118.5
20240722,분당선,망포,16201,15647,31848,15924
20240722,분당선,매탄권선,5405,5351,10756,5378
20240722,분당선,수원시청,14427,15117,29544,14772
20240722,경강선,삼동,2681,2590,5271,2635.5
20240722,경강선,이매,1109,1016,2125,1062.5
20240722,경강선,판교,5600,5432,11032,5516
20240722,9호선2~3단계,중앙보훈병원,13295,11641,24936,12468
20240722,9호선2~3단계,둔촌오륜,1241,1262,2503,1251.5
20240722,9호선2~3단계,올림픽공원(한국체대),5207,5680,10887,5443.5
20240722,9호선2~3단계,한성백제,3139,2925,6064,3032
20240722,9호선2~3단계,송파나루,5937,6293,12230,6115
20240722,분당선,매교,5522,5466,10988,5494
20240722,서해선,김포공항,2932,3932,6864,3432
20240722,서해선,원종,4559,4617,9176,4588
20240722,서해선,부천종합운동장,2710,2308,5018,2509
20240722,수인선,고색,5597,5120,10717,5358.5
20240722,수인선,오목천,4163,3823,7986,3993
20240722,수인선,어천,1306,1211,2517,1258.5
20240722,수인선,야목,416,360,776,388
20240722,수인선,사리,5114,4396,9510,4755
20240722,수인선,달월,105,55,160,80
20240722,수인선,월곶,2568,2301,4869,2434.5
20240722,수인선,소래포구,4318,3998,8316,4158
20240722,수인선,인천논현,5230,5464,10694,5347
20240722,수인선,호구포,3967,4186,8153,4076.5
20240722,수인선,남동인더스파크,2502,2858,5360,2680
20240722,수인선,원인재,4266,4296,8562,4281
20240722,수인선,연수,4625,4530,9155,4577.5
20240722,수인선,송도,2548,2334,4882,2441
20240722,수인선,인하대,6153,5789,11942,5971
20240722,수인선,숭의,3991,3774,7765,3882.5
20240722,수인선,신포,1707,1601,3308,1654
20240722,수인선,인천,957,1487,2444,1222
20240722,신림선,샛강,3199,3649,6848,3424
20240722,신림선,대방,2897,2454,5351,2675.5
20240722,신림선,서울지방병무청,3357,3715,7072,3536
20240722,신림선,보라매,4297,3975,8272,4136
20240722,신림선,보라매공원,2282,2415,4697,2348.5
20240722,신림선,보라매병원,8797,9303,18100,9050
20240722,신림선,당곡,5036,5100,10136,5068
20240722,신림선,신림,2062,2607,4669,2334.5
20240722,신림선,서원,3715,3379,7094,3547
20240722,신림선,서울대벤처타운,9592,9130,18722,9361
20240722,신림선,관악산(서울대),2576,2497,5073,2536.5
20240722,안산선,산본,16252,17036,33288,16644
20240722,9호선2~3단계,석촌,9760,8807,18567,9283.5
20240722,9호선2~3단계,석촌고분,7682,7587,15269,7634.5
20240722,9호선2~3단계,삼전,8568,8094,16662,8331
20240722,9호선2~3단계,종합운동장,5018,5088,10106,5053
20240722,9호선2~3단계,봉은사,20994,21735,42729,21364.5
20240722,9호선2~3단계,삼성중앙,8878,9342,18220,9110
20240722,9호선2~3단계,선정릉,10957,11555,22512,11256
20240722,9호선2~3단계,언주,12843,13323,26166,13083
20240722,9호선,신논현,31773,31529,63302,31651
20240722,9호선,사평,4230,4117,8347,4173.5
20240722,9호선,고속터미널,14294,18803,33097,16548.5
20240722,9호선,신반포,4142,4059,8201,4100.5
20240722,9호선,구반포,1346,1323,2669,1334.5
20240722,9호선,동작(현충원),2011,1362,3373,1686.5
20240722,9호선,흑석(중앙대입구),8857,9163,18020,9010
20240722,안산선,대야미,5034,4460,9494,4747
20240722,안산선,반월,4435,4328,8763,4381.5
20240722,9호선,노들,4885,4179,9064,4532
20240722,9호선,노량진,25992,25456,51448,25724
20240722,5호선,양평,8509,8368,16877,8438.5
20240722,5호선,오목교(목동운동장앞),20501,21711,42212,21106
20240722,5호선,목동,17263,18577,35840,17920
20240722,5호선,신정(은행정),13863,11613,25476,12738
20240722,5호선,까치산,28001,27291,55292,27646
20240722,5호선,화곡,28815,27093,55908,27954
20240722,5호선,우장산,14752,14747,29499,14749.5
20240722,5호선,발산,23327,23687,47014,23507
20240722,5호선,마곡,13185,13351,26536,13268
20240722,5호선,송정,6491,6127,12618,6309
20240722,5호선,김포공항,11319,7890,19209,9604.5
20240722,5호선,개화산,6330,6016,12346,6173
20240722,5호선,방화,7317,6997,14314,7157
20240722,4호선,남태령,1273,1193,2466,1233
20240722,4호선,사당,16691,21786,38477,19238.5
20240722,4호선,총신대입구(이수),19352,20863,40215,20107.5
20240722,4호선,동작(현충원),1226,1378,2604,1302
20240722,4호선,이촌(국립중앙박물관),8242,9262,17504,8752
20240722,4호선,신용산,21143,22571,43714,21857
20240722,4호선,삼각지,5888,6452,12340,6170
20240722,4호선,숙대입구(갈월),14016,13790,27806,13903
20240722,4호선,서울역,13821,22072,35893,17946.5
20240722,4호선,회현(남대문시장),27803,28691,56494,28247
20240722,4호선,명동,33618,35653,69271,34635.5
20240722,4호선,충무로,32129,32531,64660,32330
20240722,4호선,동대문역사문화공원(DDP),20472,18498,38970,19485
20240722,4호선,동대문,21095,21575,42670,21335
20240722,4호선,혜화,30664,30873,61537,30768.5
20240722,4호선,한성대입구(삼선교),13013,12550,25563,12781.5
20240722,4호선,성신여대입구(돈암),20591,20276,40867,20433.5
20240722,4호선,길음,21196,20894,42090,21045
20240722,4호선,미아사거리,26713,26163,52876,26438
20240722,4호선,미아(서울사이버대학),15141,15028,30169,15084.5
20240722,4호선,수유(강북구청),33108,33190,66298,33149
20240722,4호선,쌍문,29603,27701,57304,28652
20240722,4호선,창동,25952,27029,52981,26490.5
20240722,4호선,노원,28310,31158,59468,29734
20240722,4호선,상계,19529,18207,37736,18868
20240722,4호선,당고개,9519,8072,17591,8795.5
20240722,3호선,오금,7046,6201,13247,6623.5
20240722,3호선,경찰병원,8532,8550,17082,8541
20240722,3호선,가락시장,9410,9044,18454,9227
20240722,3호선,수서,19051,19167,38218,19109
20240722,3호선,일원,11932,11860,23792,11896
20240722,3호선,대청,11209,10656,21865,10932.5
20240722,3호선,학여울,1979,2030,4009,2004.5
20240722,3호선,대치,14006,13815,27821,13910.5
20240722,3호선,도곡,6215,6236,12451,6225.5
20240722,3호선,매봉,13948,13320,27268,13634
20240722,3호선,양재(서초구청),39327,42661,81988,40994
20240722,3호선,남부터미널(예술의전당),30356,31212,61568,30784
20240722,3호선,교대(법원.검찰청),17845,10697,28542,14271
20240722,3호선,고속터미널,45401,42195,87596,43798
20240722,3호선,잠원,5228,5038,10266,5133
20240722,3호선,신사,29461,30597,60058,30029
20240722,3호선,압구정,33660,35957,69617,34808.5
20240722,3호선,옥수,8766,9220,17986,8993
20240722,3호선,금호,8169,7683,15852,7926
20240722,3호선,약수,13067,12852,25919,12959.5
20240722,3호선,동대입구,8285,8929,17214,8607
20240722,3호선,충무로,8,0,8,4
20240722,3호선,을지로3가,12507,12578,25085,12542.5
20240722,3호선,종로3가,11763,12979,24742,12371
20240722,3호선,안국,24984,25570,50554,25277
20240722,3호선,경복궁(정부서울청사),22233,22339,44572,22286
20240722,3호선,독립문,7091,7018,14109,7054.5
20240722,3호선,무악재,4551,4441,8992,4496
20240722,3호선,홍제,17713,16990,34703,17351.5
20240722,3호선,녹번,15652,14561,30213,15106.5
20240722,3호선,불광,16435,17323,33758,16879
20240722,3호선,연신내,33443,32115,65558,32779
20240722,3호선,구파발,22414,21423,43837,21918.5
20240722,3호선,지축,7768,7709,15477,7738.5
20240722,2호선,용두(동대문구청),2497,2657,5154,2577
20240722,2호선,신정네거리,10278,10842,21120,10560
20240722,2호선,양천구청,6956,7509,14465,7232.5
20240722,2호선,도림천,1465,1538,3003,1501.5
20240722,2호선,신설동,3456,3406,6862,3431
20240722,2호선,신답,1761,2030,3791,1895.5
20240722,2호선,용답,2970,2869,5839,2919.5
20240722,2호선,충정로(경기대입구),10878,11411,22289,11144.5
20240722,2호선,아현,11381,10627,22008,11004
20240722,2호선,이대,15825,17427,33252,16626
20240722,2호선,신촌,36770,37528,74298,37149
20240722,2호선,홍대입구,69370,73191,142561,71280.5
20240722,2호선,합정,30649,32537,63186,31593
20240722,2호선,당산,17866,21159,39025,19512.5
20240722,2호선,영등포구청,23710,24411,48121,24060.5
20240722,2호선,문래,24984,25414,50398,25199
20240722,2호선,신도림,49900,47950,97850,48925
20240722,2호선,대림(구로구청),24965,25314,50279,25139.5
20240722,2호선,구로디지털단지,60578,60334,120912,60456
20240722,2호선,신대방,25525,24800,50325,25162.5
20240722,2호선,신림,55049,53111,108160,54080
20240722,2호선,봉천,25414,23937,49351,24675.5
20240722,2호선,서울대입구(관악구청),47125,46465,93590,46795
20240722,2호선,낙성대(강감찬),28344,27935,56279,28139.5
20240722,2호선,사당,47645,41852,89497,44748.5
20240722,2호선,방배,15663,16372,32035,16017.5
20240722,2호선,서초,22903,22241,45144,22572
20240722,2호선,교대(법원.검찰청),33700,39887,73587,36793.5
20240722,2호선,강남,87459,85526,172985,86492.5
20240722,2호선,역삼,59396,67442,126838,63419
20240722,2호선,선릉,65319,57463,122782,61391
20240722,2호선,삼성(무역센터),55102,56825,111927,55963.5
20240722,2호선,종합운동장,7121,7963,15084,7542
20240722,2호선,잠실새내,24120,23173,47293,23646.5
20240722,2호선,잠실(송파구청),76869,77058,153927,76963.5
20240722,2호선,잠실나루,16491,16000,32491,16245.5
20240722,2호선,강변(동서울터미널),30826,28744,59570,29785
20240722,2호선,구의(광진구청),25788,25415,51203,25601.5
20240722,2호선,건대입구,33727,35164,68891,34445.5
20240722,2호선,성수,46559,50733,97292,48646
20240722,2호선,뚝섬,25263,26598,51861,25930.5
20240722,2호선,한양대,8271,9068,17339,8669.5
20240722,2호선,왕십리(성동구청),15430,13736,29166,14583
20240722,2호선,상왕십리,15126,15164,30290,15145
20240722,2호선,신당,14601,15065,29666,14833
20240722,2호선,동대문역사문화공원(DDP),15824,17898,33722,16861
20240722,2호선,을지로4가,15458,15162,30620,15310
20240722,2호선,을지로3가,27043,26982,54025,27012.5
20240722,2호선,을지로입구,52634,54514,107148,53574
20240722,2호선,시청,28661,27587,56248,28124
20240722,1호선,동묘앞,7138,7045,14183,7091.5
20240722,1호선,청량리(서울시립대입구),21233,20376,41609,20804.5
20240722,1호선,제기동,15340,15297,30637,15318.5
20240722,1호선,신설동,14559,14175,28734,14367
20240722,1호선,동대문,11081,10675,21756,10878
20240722,1호선,종로5가,23750,23115,46865,23432.5
20240722,1호선,종로3가,24321,22143,46464,23232
20240722,1호선,종각,41680,41296,82976,41488
20240722,1호선,시청,26079,26250,52329,26164.5
20240722,1호선,서울역,55376,52569,107945,53972.5
20240722,중앙선,구리,13344,13323,26667,13333.5
20240722,5호선,청구,4150,3795,7945,3972.5
20240722,8호선,복정,9454,8081,17535,8767.5
20240722,중앙선,지평,47,52,99,49.5
20240722,중앙선,용문,1847,1792,3639,1819.5
20240722,중앙선,원덕,365,333,698,349
20240722,중앙선,양평,3035,3087,6122,3061
20240722,중앙선,오빈,326,303,629,314.5
20240722,중앙선,아신,540,511,1051,525.5
20240722,중앙선,국수,772,749,1521,760.5
20240722,장항선,신창(순천향대),1027,1142,2169,1084.5
20240722,중앙선,신원,161,141,302,151
20240722,중앙선,양수,1753,1740,3493,1746.5
20240722,중앙선,운길산,555,521,1076,538
20240722,중앙선,팔당,742,785,1527,763.5
20240722,중앙선,도심,2439,1857,4296,2148
20240722,중앙선,덕소,5383,5291,10674,5337
20240722,중앙선,양정,594,492,1086,543
20240722,중앙선,도농,11313,10261,21574,10787
20240722,중앙선,양원,3177,3143,6320,3160
20240722,중앙선,망우,7542,7224,14766,7383
20240722,중앙선,상봉,5985,5900,11885,5942.5
20240722,중앙선,중랑,5611,5389,11000,5500
20240722,중앙선,회기,24213,23361,47574,23787
20240722,8호선,장지,17492,16565,34057,17028.5
20240722,8호선,문정,24782,26060,50842,25421
20240722,8호선,가락시장,8021,8897,16918,8459
20240722,8호선,송파,10014,9937,19951,9975.5
20240722,8호선,석촌,8346,9313,17659,8829.5
20240722,8호선,잠실(송파구청),16208,18567,34775,17387.5
20240722,8호선,몽촌토성(평화의문),7043,7050,14093,7046.5
20240722,8호선,강동구청,11070,11536,22606,11303
20240722,8호선,천호(풍납토성),15518,17442,32960,16480
20240722,8호선,암사,19921,17672,37593,18796.5
20240722,7호선,온수(성공회대입구),9911,8917,18828,9414
20240722,7호선,천왕,12180,11730,23910,11955
20240722,7호선,광명사거리,19877,19578,39455,19727.5
20240722,7호선,철산,22089,22374,44463,22231.5
20240722,7호선,가산디지털단지,50716,50782,101498,50749
20240722,7호선,남구로,16190,16676,32866,16433
20240722,7호선,대림(구로구청),9090,8956,18046,9023
20240722,7호선,신풍,11666,10906,22572,11286
20240722,7호선,보라매,6894,7132,14026,7013
20240722,7호선,신대방삼거리,15486,15021,30507,15253.5
20240722,7호선,장승배기,9689,9576,19265,9632.5
20240722,7호선,상도,11699,11341,23040,11520
20240722,7호선,숭실대입구(살피재),12649,12792,25441,12720.5
20240722,7호선,남성,11879,11337,23216,11608
20240723,경원선,이촌(국립중앙박물관),4322,3353,7675,3837.5
20240723,경부선,서동탄,1597,1336,2933,1466.5
20240723,경부선,당정,6257,5933,12190,6095
20240723,경부선,천안,5330,5363,10693,5346.5
20240723,경부선,두정,5853,6133,11986,5993
20240723,경부선,직산,950,899,1849,924.5
20240723,경부선,성환,3509,3453,6962,3481
20240723,경부선,평택,11031,10821,21852,10926
20240723,경부선,평택지제,4069,3846,7915,3957.5
20240723,경부선,서정리,7702,7144,14846,7423
20240723,경부선,송탄,3998,3939,7937,3968.5
20240723,경부선,진위,1748,1628,3376,1688
20240723,경부선,오산,9529,9692,19221,9610.5
20240723,경부선,오산대,3533,3297,6830,3415
20240723,경부선,세마,3530,3066,6596,3298
20240723,경부선,병점,14502,14072,28574,14287
20240723,경부선,세류,3467,3134,6601,3300.5
20240723,경부선,독산,18914,19551,38465,19232.5
20240723,경부선,수원,34586,36266,70852,35426
20240723,경부선,화서,11603,11255,22858,11429
20240723,경부선,성균관대,15243,14950,30193,15096.5
20240723,경부선,의왕,9470,9571,19041,9520.5
20240723,경부선,군포,7559,7540,15099,7549.5
20240723,경부선,금정,28841,29222,58063,29031.5
20240723,경부선,명학,9162,9028,18190,9095
20240723,경부선,안양,21150,20957,42107,21053.5
20240723,경부선,관악,7523,7223,14746,7373
20240723,경부선,석수,8752,7943,16695,8347.5
20240723,경부선,금천구청,11424,11587,23011,11505.5
20240723,경부선,가산디지털단지,20085,23395,43480,21740
20240723,경부선,구로,18895,19029,37924,18962
20240723,경부선,신길,9248,7794,17042,8521
20240723,경부선,신도림,4044,4386,8430,4215
20240723,경부선,영등포,41777,42282,84059,42029.5
20240723,경부선,대방,10901,11913,22814,11407
20240723,경부선,노량진,7765,7712,15477,7738.5
20240723,경부선,용산,40264,40929,81193,40596.5
20240723,경부선,남영,10029,10402,20431,10215.5
20240723,경부선,서울역,9151,3194,12345,6172.5
20240723,경강선,성남,931,880,1811,905.5
20240723,경강선,여주,2653,2602,5255,2627.5
20240723,경강선,세종대왕릉,373,392,765,382.5
20240723,경강선,부발,2278,2186,4464,2232
20240723,경강선,이천,2800,3037,5837,2918.5
20240723,경강선,신둔도예촌,1543,1402,2945,1472.5
20240723,경강선,곤지암,2129,2046,4175,2087.5
20240723,경강선,초월,3605,3369,6974,3487
20240723,경강선,경기광주,8222,7819,16041,8020.5
20240723,경강선,삼동,2712,2472,5184,2592
20240723,경강선,이매,1100,952,2052,1026
20240723,경강선,판교,6281,6229,12510,6255
20240723,9호선2~3단계,중앙보훈병원,13800,12348,26148,13074
20240723,9호선2~3단계,둔촌오륜,1261,1296,2557,1278.5
20240723,9호선2~3단계,올림픽공원(한국체대),5461,5632,11093,5546.5
20240723,9호선2~3단계,한성백제,3280,2944,6224,3112
20240723,9호선2~3단계,송파나루,6026,6303,12329,6164.5
20240723,9호선2~3단계,석촌,10481,9224,19705,9852.5
20240723,9호선2~3단계,석촌고분,7795,7642,15437,7718.5
20240723,9호선2~3단계,삼전,8868,8271,17139,8569.5
20240723,9호선2~3단계,종합운동장,5268,5370,10638,5319
20240723,9호선2~3단계,봉은사,21896,22509,44405,22202.5
20240723,9호선2~3단계,삼성중앙,9069,9495,18564,9282
20240723,9호선2~3단계,선정릉,11376,12059,23435,11717.5
20240723,9호선2~3단계,언주,13284,13753,27037,13518.5
20240723,9호선,신논현,33046,33191,66237,33118.5
20240723,9호선,사평,4320,4179,8499,4249.5
20240723,9호선,고속터미널,14764,19207,33971,16985.5
20240723,9호선,신반포,4207,4046,8253,4126.5
20240723,9호선,구반포,1409,1353,2762,1381
20240723,9호선,동작(현충원),1789,1514,3303,1651.5
20240723,9호선,흑석(중앙대입구),9005,9390,18395,9197.5
20240723,9호선,노들,5129,4341,9470,4735
20240723,9호선,노량진,26566,25975,52541,26270.5
20240723,9호선,샛강,7528,7498,15026,7513
20240723,9호선,여의도,34637,33589,68226,34113
20240723,9호선,국회의사당,18548,19542,38090,19045
20240723,9호선,당산,20986,20799,41785,20892.5
20240723,9호선,선유도,9964,9485,19449,9724.5
20240723,9호선,신목동,4904,4375,9279,4639.5
20240723,9호선,염창,19192,18508,37700,18850
20240723,9호선,등촌,13435,12816,26251,13125.5
20240723,9호선,증미,9113,8946,18059,9029.5
20240723,9호선,가양,23855,23314,47169,23584.5
20240723,9호선,양천향교,10900,11016,21916,10958
20240723,9호선,마곡나루(서울식물원),14907,14656,29563,14781.5
20240723,9호선,신방화,7504,7361,14865,7432.5
20240723,9호선,공항시장,3286,3537,6823,3411.5
20240723,9호선,김포공항,7073,10712,17785,8892.5
20240723,9호선,개화,3037,2070,5107,2553.5
20240723,8호선,남위례,7714,7688,15402,7701
20240723,8호선,모란,4674,3551,8225,4112.5
20240723,8호선,수진,5516,5090,10606,5303
20240723,8호선,신흥,5249,5424,10673,5336.5
20240723,8호선,단대오거리,12302,12076,24378,12189
20240723,8호선,남한산성입구(성남법원.검찰청),13336,12086,25422,12711
20240723,8호선,산성,6611,6692,13303,6651.5
20240723,8호선,복정,9882,8472,18354,9177
20240723,8호선,장지,18284,16714,34998,17499
20240723,8호선,문정,24624,25934,50558,25279
20240723,8호선,가락시장,8204,9029,17233,8616.5
20240723,8호선,송파,10296,10024,20320,10160
20240723,8호선,석촌,8546,9612,18158,9079
20240723,8호선,잠실(송파구청),16443,19226,35669,17834.5
20240723,8호선,몽촌토성(평화의문),7063,7119,14182,7091
20240723,8호선,강동구청,11349,11801,23150,11575
20240723,8호선,천호(풍납토성),15715,17707,33422,16711
20240723,8호선,암사,20113,17592,37705,18852.5
20240723,7호선,온수(성공회대입구),10327,9237,19564,9782
20240723,7호선,천왕,12630,12233,24863,12431.5
20240723,7호선,광명사거리,20591,20317,40908,20454
20240723,7호선,철산,22708,23072,45780,22890
20240723,7호선,가산디지털단지,51382,51751,103133,51566.5
20240723,7호선,남구로,16080,16584,32664,16332
20240723,7호선,대림(구로구청),9120,9125,18245,9122.5
20240723,7호선,신풍,12241,11206,23447,11723.5
20240723,7호선,보라매,6859,7199,14058,7029
20240723,7호선,신대방삼거리,15742,15135,30877,15438.5
20240723,7호선,장승배기,9815,9679,19494,9747
20240723,7호선,상도,12130,11741,23871,11935.5
20240723,7호선,숭실대입구(살피재),12807,12726,25533,12766.5
20240723,7호선,남성,12283,11710,23993,11996.5
20240723,7호선,이수,17545,17240,34785,17392.5
20240723,7호선,내방,16174,16290,32464,16232
20240723,7호선,고속터미널,17129,15024,32153,16076.5
20240723,7호선,반포,6603,6435,13038,6519
20240723,7호선,논현,20840,21336,42176,21088
20240723,7호선,학동,27002,27990,54992,27496
20240723,7호선,강남구청,17924,19757,37681,18840.5
20240723,7호선,청담,20885,22830,43715,21857.5
20240723,7호선,자양(뚝섬한강공원),8967,8666,17633,8816.5
20240723,7호선,건대입구,13718,13865,27583,13791.5
20240723,7호선,어린이대공원(세종대),14116,13838,27954,13977
20240723,7호선,군자(능동),15945,12748,28693,14346.5
20240723,7호선,중곡,11520,10999,22519,11259.5
20240723,7호선,용마산(용마폭포공원),5923,5583,11506,5753
20240723,7호선,사가정,16710,16893,33603,16801.5
20240723,7호선,면목,15461,15092,30553,15276.5
20240723,7호선,상봉,18145,17375,35520,17760
20240723,7호선,중화,11025,10753,21778,10889
20240723,7호선,먹골,10793,10575,21368,10684
20240723,7호선,태릉입구,9074,8492,17566,8783
20240723,7호선,공릉(서울과학기술대),12310,12111,24421,12210.5
20240723,7호선,하계,18777,17486,36263,18131.5
20240723,7호선,중계,15033,13712,28745,14372.5
20240723,7호선,노원,25193,26275,51468,25734
20240723,7호선,마들,13754,13112,26866,13433
20240723,7호선,수락산,12610,12560,25170,12585
20240723,7호선,도봉산,9132,10344,19476,9738
20240723,7호선,장암,3017,1217,4234,2117
20240723,6호선,봉화산(서울의료원),9589,8949,18538,9269
20240723,6호선,화랑대(서울여대입구),12102,9464,21566,10783
20240723,6호선,태릉입구,5782,6416,12198,6099
20240723,6호선,석계,12776,13107,25883,12941.5
20240723,6호선,돌곶이,10516,9675,20191,10095.5
20240723,6호선,상월곡(한국과학기술연구원),6571,5923,12494,6247
20240723,6호선,월곡(동덕여대),12263,12102,24365,12182.5
20240723,6호선,고려대(종암),8549,8105,16654,8327
20240723,6호선,안암(고대병원앞),11697,11657,23354,11677
20240723,6호선,보문,8202,7594,15796,7898
20240723,6호선,창신,3629,2834,6463,3231.5
20240723,6호선,동묘앞,8199,8272,16471,8235.5
20240723,6호선,신당,9363,9819,19182,9591
20240723,6호선,청구,4274,4138,8412,4206
20240723,6호선,약수,4169,3741,7910,3955
20240723,6호선,버티고개,2203,2210,4413,2206.5
20240723,6호선,한강진,9437,11060,20497,10248.5
20240723,6호선,이태원,9880,10186,20066,10033
20240723,6호선,녹사평(용산구청),4966,4972,9938,4969
20240723,6호선,삼각지,7433,6675,14108,7054
20240723,6호선,효창공원앞,7619,6878,14497,7248.5
20240723,6호선,공덕,21081,20399,41480,20740
20240723,6호선,대흥(서강대앞),9445,10064,19509,9754.5
20240723,6호선,광흥창(서강),10468,10023,20491,10245.5
20240723,6호선,상수,9626,10384,20010,10005
20240723,6호선,합정,13776,13353,27129,13564.5
20240723,6호선,망원,15086,15952,31038,15519
20240723,6호선,마포구청,15534,14203,29737,14868.5
20240723,6호선,월드컵경기장(성산),4002,3995,7997,3998.5
20240723,6호선,디지털미디어시티,16170,17569,33739,16869.5
20240723,6호선,증산(명지대앞),10212,10207,20419,10209.5
20240723,6호선,새절(신사),13584,12397,25981,12990.5
20240723,6호선,구산,8647,6783,15430,7715
20240723,6호선,연신내,3,0,3,1.5
20240723,6호선,독바위,3000,3061,6061,3030.5
20240723,6호선,불광,4946,4777,9723,4861.5
20240723,6호선,역촌,4030,4463,8493,4246.5
20240723,6호선,응암,18393,18331,36724,18362
20240723,5호선,하남검단산,6509,6102,12611,6305.5
20240723,5호선,하남시청(덕풍·신장),8579,8112,16691,8345.5
20240723,5호선,하남풍산,4782,4676,9458,4729
20240723,5호선,미사,18251,18528,36779,18389.5
20240723,5호선,강일,6287,5782,12069,6034.5
20240723,5호선,마천,8000,7165,15165,7582.5
20240723,5호선,거여,10709,10531,21240,10620
20240723,5호선,개롱,7064,7122,14186,7093
20240723,5호선,오금,3853,3925,7778,3889
20240723,5호선,방이,7832,8185,16017,8008.5
20240723,5호선,올림픽공원(한국체대),5524,4645,10169,5084.5
20240723,5호선,둔촌동,9460,9454,18914,9457
20240723,5호선,상일동,16084,15084,31168,15584
20240723,5호선,고덕,11652,11519,23171,11585.5
20240723,5호선,명일,8985,9305,18290,9145
20240723,5호선,굽은다리(강동구민회관앞),10269,9980,20249,10124.5
20240723,5호선,길동,8812,8914,17726,8863
20240723,5호선,강동,19477,19071,38548,19274
20240723,5호선,천호(풍납토성),19490,19441,38931,19465.5
20240723,5호선,광나루(장신대),13609,12415,26024,13012
20240723,5호선,아차산(어린이대공원후문),14406,14269,28675,14337.5
20240723,5호선,군자(능동),11776,12866,24642,12321
20240723,5호선,장한평,20482,20506,40988,20494
20240723,5호선,답십리,17185,15385,32570,16285
20240723,5호선,마장,6160,5618,11778,5889
20240723,5호선,왕십리(성동구청),4859,5537,10396,5198
20240723,5호선,행당,8501,7677,16178,8089
20240723,5호선,신금호,6891,7248,14139,7069.5
20240723,5호선,청구,4163,3882,8045,4022.5
20240723,5호선,동대문역사문화공원(DDP),3557,4104,7661,3830.5
20240723,5호선,을지로4가,7142,7082,14224,7112
20240723,5호선,종로3가,14733,14966,29699,14849.5
20240723,5호선,광화문(세종문화회관),35101,37146,72247,36123.5
20240723,5호선,서대문,22498,22951,45449,22724.5
20240723,5호선,충정로(경기대입구),5385,5532,10917,5458.5
20240723,5호선,애오개,7697,7683,15380,7690
20240723,5호선,공덕,16242,16941,33183,16591.5
20240723,5호선,마포,16248,16574,32822,16411
20240723,5호선,여의나루,11766,13914,25680,12840
20240723,5호선,여의도,33002,34955,67957,33978.5
20240723,5호선,신길,5321,5497,10818,5409
20240723,5호선,영등포시장,12071,12104,24175,12087.5
20240723,5호선,영등포구청,5252,5070,10322,5161
20240723,5호선,양평,8664,8422,17086,8543
20240723,5호선,오목교(목동운동장앞),22276,23604,45880,22940
20240723,5호선,목동,17526,18954,36480,18240
20240723,5호선,신정(은행정),14352,11964,26316,13158
20240723,5호선,까치산,29056,28147,57203,28601.5
20240723,5호선,화곡,29766,27964,57730,28865
20240723,5호선,우장산,15299,15142,30441,15220.5
20240723,5호선,발산,24491,25025,49516,24758
20240723,5호선,마곡,13451,13641,27092,13546
20240723,5호선,송정,6625,6244,12869,6434.5
20240723,5호선,김포공항,11220,7972,19192,9596
20240723,5호선,개화산,6514,6095,12609,6304.5
20240723,5호선,방화,7335,7035,14370,7185
20240723,4호선,남태령,1378,1250,2628,1314
20240723,4호선,사당,26126,22887,49013,24506.5
20240723,4호선,총신대입구(이수),19895,21296,41191,20595.5
20240723,4호선,동작(현충원),1289,1377,2666,1333
20240723,4호선,이촌(국립중앙박물관),8876,9677,18553,9276.5
20240723,4호선,신용산,21913,23230,45143,22571.5
20240723,4호선,삼각지,6325,6836,13161,6580.5
20240723,4호선,숙대입구(갈월),14949,14632,29581,14790.5
20240723,4호선,서울역,14305,22911,37216,18608
20240723,4호선,회현(남대문시장),28383,29499,57882,28941
20240723,4호선,명동,33612,35622,69234,34617
20240723,4호선,충무로,32347,33267,65614,32807
20240723,4호선,동대문역사문화공원(DDP),20029,17774,37803,18901.5
20240723,4호선,동대문,21096,21832,42928,21464
20240723,4호선,혜화,35333,35730,71063,35531.5
20240723,4호선,한성대입구(삼선교),13577,12991,26568,13284
20240723,4호선,성신여대입구(돈암),21467,20983,42450,21225
20240723,4호선,길음,22364,21682,44046,22023
20240723,4호선,미아사거리,27464,27205,54669,27334.5
20240723,4호선,미아(서울사이버대학),15579,15123,30702,15351
20240723,4호선,수유(강북구청),34211,34243,68454,34227
20240723,4호선,쌍문,30587,28647,59234,29617
20240723,4호선,창동,27417,28583,56000,28000
20240723,4호선,노원,29336,32929,62265,31132.5
20240723,4호선,상계,19958,18654,38612,19306
20240723,4호선,당고개,9969,8429,18398,9199
20240723,3호선,오금,7252,6337,13589,6794.5
20240723,3호선,경찰병원,8445,8540,16985,8492.5
20240723,3호선,가락시장,9664,9168,18832,9416
20240723,3호선,수서,18934,19204,38138,19069
20240723,3호선,일원,12058,11970,24028,12014
20240723,3호선,대청,11380,10764,22144,11072
20240723,3호선,학여울,2070,2073,4143,2071.5
20240723,3호선,대치,14117,13788,27905,13952.5
20240723,3호선,도곡,6226,6282,12508,6254
20240723,3호선,매봉,14317,13566,27883,13941.5
20240723,3호선,양재(서초구청),40901,43896,84797,42398.5
20240723,3호선,남부터미널(예술의전당),32091,32699,64790,32395
20240723,3호선,교대(법원.검찰청),18693,11408,30101,15050.5
20240723,3호선,고속터미널,45369,42208,87577,43788.5
20240723,3호선,잠원,5470,5107,10577,5288.5
20240723,3호선,신사,30372,31749,62121,31060.5
20240723,3호선,압구정,34413,36960,71373,35686.5
20240723,3호선,옥수,9351,9473,18824,9412
20240723,3호선,금호,8321,7801,16122,8061
20240723,3호선,약수,13273,13138,26411,13205.5
20240723,3호선,동대입구,8837,9572,18409,9204.5
20240723,3호선,충무로,9,0,9,4.5
20240723,3호선,을지로3가,12661,12918,25579,12789.5
20240723,3호선,종로3가,12081,13329,25410,12705
20240723,3호선,안국,26329,27044,53373,26686.5
20240723,3호선,경복궁(정부서울청사),21994,21803,43797,21898.5
20240723,3호선,독립문,7531,7543,15074,7537
20240723,3호선,무악재,4723,4602,9325,4662.5
20240723,3호선,홍제,18334,17384,35718,17859
20240723,3호선,녹번,16204,14925,31129,15564.5
20240723,3호선,불광,17209,18354,35563,17781.5
20240723,3호선,연신내,34766,33452,68218,34109
20240723,3호선,구파발,23061,22424,45485,22742.5
20240723,3호선,지축,7991,7987,15978,7989
20240723,2호선,용두(동대문구청),2508,2663,5171,2585.5
20240723,2호선,신정네거리,10721,11211,21932,10966
20240723,2호선,양천구청,7308,7707,15015,7507.5
20240723,2호선,도림천,1475,1519,2994,1497
20240723,2호선,신설동,3310,3225,6535,3267.5
20240723,2호선,신답,1819,1969,3788,1894
20240723,2호선,용답,2992,2975,5967,2983.5
20240723,2호선,충정로(경기대입구),11094,11600,22694,11347
20240723,2호선,아현,11634,10703,22337,11168.5
20240723,2호선,이대,16038,17514,33552,16776
20240723,2호선,신촌,38079,38803,76882,38441
20240723,2호선,홍대입구,71099,76300,147399,73699.5
20240723,2호선,합정,33177,35259,68436,34218
20240723,2호선,당산,18740,22053,40793,20396.5
20240723,2호선,영등포구청,23953,24676,48629,24314.5
20240723,2호선,문래,25260,25734,50994,25497
20240723,2호선,신도림,52812,50169,102981,51490.5
20240723,2호선,대림(구로구청),25085,25475,50560,25280
20240723,2호선,구로디지털단지,62414,62359,124773,62386.5
20240723,2호선,신대방,26392,25632,52024,26012
20240723,2호선,신림,56965,54850,111815,55907.5
20240723,2호선,봉천,25940,24525,50465,25232.5
20240723,2호선,서울대입구(관악구청),47781,46839,94620,47310
20240723,2호선,낙성대(강감찬),29154,28296,57450,28725
20240723,2호선,사당,41057,44346,85403,42701.5
20240723,2호선,방배,16513,17122,33635,16817.5
20240723,2호선,서초,23348,22950,46298,23149
20240723,2호선,교대(법원.검찰청),35061,41668,76729,38364.5
20240723,2호선,강남,90318,88015,178333,89166.5
20240723,2호선,역삼,61041,69535,130576,65288
20240723,2호선,선릉,66779,58714,125493,62746.5
20240723,2호선,삼성(무역센터),58824,60927,119751,59875.5
20240723,2호선,종합운동장,12479,13582,26061,13030.5
20240723,2호선,잠실새내,24994,23793,48787,24393.5
20240723,2호선,잠실(송파구청),82216,81590,163806,81903
20240723,2호선,잠실나루,16900,16453,33353,16676.5
20240723,2호선,강변(동서울터미널),29766,27886,57652,28826
20240723,2호선,구의(광진구청),26754,25857,52611,26305.5
20240723,2호선,건대입구,35090,36862,71952,35976
20240723,2호선,성수,47334,51573,98907,49453.5
20240723,2호선,뚝섬,26441,27919,54360,27180
20240723,2호선,한양대,8871,9498,18369,9184.5
20240723,2호선,왕십리(성동구청),15781,14119,29900,14950
20240723,2호선,상왕십리,15611,15484,31095,15547.5
20240723,2호선,신당,15171,15828,30999,15499.5
20240723,2호선,동대문역사문화공원(DDP),15046,17133,32179,16089.5
20240723,2호선,을지로4가,15792,15602,31394,15697
20240723,2호선,을지로3가,27563,27583,55146,27573
20240723,2호선,을지로입구,53682,55418,109100,54550
20240723,2호선,시청,30105,29155,59260,29630
20240723,1호선,동묘앞,7684,7835,15519,7759.5
20240723,1호선,청량리(서울시립대입구),22371,21702,44073,22036.5
20240723,1호선,제기동,15992,15897,31889,15944.5
20240723,1호선,신설동,14685,14579,29264,14632
20240723,1호선,동대문,11547,11129,22676,11338
20240723,1호선,종로5가,24381,24080,48461,24230.5
20240723,1호선,종로3가,25976,23552,49528,24764
20240723,1호선,종각,42998,42676,85674,42837
20240723,1호선,시청,28033,28127,56160,28080
20240723,1호선,서울역,57039,53834,110873,55436.5
20240723,분당선,복정,7,0,7,3.5
20240723,중앙선,지평,55,63,118,59
20240723,중앙선,용문,1796,1812,3608,1804
20240723,중앙선,원덕,348,326,674,337
20240723,중앙선,양평,3439,3435,6874,3437
20240723,중앙선,오빈,343,313,656,328
20240723,중앙선,아신,498,479,977,488.5
20240723,중앙선,국수,727,707,1434,717
20240723,중앙선,신원,190,168,358,179
20240723,중앙선,양수,2023,2033,4056,2028
20240723,중앙선,운길산,554,554,1108,554
20240723,중앙선,팔당,758,777,1535,767.5
20240723,중앙선,도심,2487,1954,4441,2220.5
20240723,중앙선,덕소,5515,5384,10899,5449.5
20240723,중앙선,양정,562,470,1032,516
20240723,중앙선,도농,11431,10480,21911,10955.5
20240723,중앙선,구리,13646,13731,27377,13688.5
20240723,중앙선,양원,3223,3274,6497,3248.5
20240723,중앙선,망우,7812,7401,15213,7606.5
20240723,중앙선,상봉,5973,6018,11991,5995.5
20240723,중앙선,중랑,5767,5442,11209,5604.5
20240723,중앙선,회기,24996,23615,48611,24305.5
20240723,장항선,신창(순천향대),946,966,1912,956
20240723,장항선,온양온천,3786,3867,7653,3826.5
20240723,장항선,배방,1183,1164,2347,1173.5
20240723,장항선,탕정,1623,1493,3116,1558
20240723,장항선,아산,3264,2995,6259,3129.5
20240723,장항선,쌍용(나사렛대),2186,2091,4277,2138.5
20240723,장항선,봉명,1450,1452,2902,1451
20240723,일산선,대화,14296,10949,25245,12622.5
20240723,일산선,주엽,10168,10500,20668,10334
20240723,일산선,정발산,7066,7339,14405,7202.5
20240723,일산선,마두,8411,8536,16947,8473.5
20240723,일산선,백석,10696,10538,21234,10617
20240723,일산선,대곡,3045,2279,5324,2662
20240723,일산선,화정,17320,17646,34966,17483
20240723,일산선,원당,11102,10589,21691,10845.5
20240723,일산선,삼송,19781,19189,38970,19485
20240723,일산선,지축,2,0,2,1
20240723,일산선,원흥,12040,11454,23494,11747
20240723,우이신설선,신설동,2571,2383,4954,2477
20240723,우이신설선,보문,1614,1521,3135,1567.5
20240723,우이신설선,성신여대입구(돈암),3511,3917,7428,3714
20240723,우이신설선,정릉,4797,4516,9313,4656.5
20240723,우이신설선,북한산보국문,6232,5996,12228,6114
20240723,우이신설선,솔샘,6197,5925,12122,6061
20240723,우이신설선,삼양사거리,2661,2745,5406,2703
20240723,우이신설선,삼양,2126,2269,4395,2197.5
20240723,우이신설선,화계,3766,3633,7399,3699.5
20240723,우이신설선,가오리,4524,4682,9206,4603
20240723,우이신설선,4.19민주묘지,3057,2860,5917,2958.5
20240723,우이신설선,솔밭공원,2699,2583,5282,2641
20240723,우이신설선,북한산우이,2544,2270,4814,2407
20240723,안산선,수리산,4116,3361,7477,3738.5
20240723,안산선,오이도,7884,7475,15359,7679.5
20240723,안산선,정왕,8745,8908,17653,8826.5
20240723,안산선,신길온천,1991,1812,3803,1901.5
20240723,안산선,안산,11889,10695,22584,11292
20240723,안산선,초지,5105,5127,10232,5116
20240723,안산선,고잔,9053,8662,17715,8857.5
20240723,안산선,중앙,18160,18988,37148,18574
20240723,안산선,한대앞,9019,9131,18150,9075
20240723,안산선,상록수,14643,15006,29649,14824.5
20240723,안산선,반월,4374,4203,8577,4288.5
20240723,안산선,대야미,4989,4488,9477,4738.5
20240723,안산선,산본,16548,17456,34004,17002
20240723,신림선,관악산(서울대),2689,2601,5290,2645
20240723,신림선,서울대벤처타운,9836,9183,19019,9509.5
20240723,신림선,서원,3783,3395,7178,3589
20240723,신림선,신림,1990,2654,4644,2322
20240723,신림선,당곡,5091,5185,10276,5138
20240723,신림선,보라매병원,8722,9058,17780,8890
20240723,신림선,보라매공원,2395,2599,4994,2497
20240723,신림선,보라매,4430,4074,8504,4252
20240723,신림선,서울지방병무청,3373,3800,7173,3586.5
20240723,신림선,대방,3096,2489,5585,2792.5
20240723,신림선,샛강,3204,3654,6858,3429
20240723,수인선,인천,977,1491,2468,1234
20240723,수인선,신포,1789,1754,3543,1771.5
20240723,수인선,숭의,4129,3876,8005,4002.5
20240723,수인선,인하대,6353,6075,12428,6214
20240723,수인선,송도,2382,2171,4553,2276.5
20240723,수인선,연수,4691,4574,9265,4632.5
20240723,수인선,원인재,4390,4563,8953,4476.5
20240723,수인선,남동인더스파크,2609,2843,5452,2726
20240723,수인선,호구포,4040,4199,8239,4119.5
20240723,수인선,인천논현,5526,5856,11382,5691
20240723,수인선,소래포구,4590,4200,8790,4395
20240723,수인선,월곶,2745,2519,5264,2632
20240723,수인선,달월,110,62,172,86
20240723,수인선,사리,5119,4403,9522,4761
20240723,수인선,야목,434,365,799,399.5
20240723,수인선,어천,1377,1292,2669,1334.5
20240723,수인선,오목천,3842,3543,7385,3692.5
20240723,수인선,고색,5622,5118,10740,5370
20240723,서해선,부천종합운동장,2814,2342,5156,2578
20240723,서해선,원종,4933,4911,9844,4922
20240723,서해선,김포공항,3137,4107,7244,3622
20240723,분당선,매교,5549,5525,11074,5537
20240723,분당선,수원시청,14186,15143,29329,14664.5
20240723,분당선,매탄권선,5543,5526,11069,5534.5
20240723,분당선,망포,16441,15655,32096,16048
20240723,분당선,영통,9069,9070,18139,9069.5
20240723,분당선,청명,4820,4588,9408,4704
20240723,분당선,상갈,5583,5247,10830,5415
20240723,분당선,기흥,10790,9777,20567,10283.5
20240723,분당선,신갈,5039,4940,9979,4989.5
20240723,분당선,구성,6499,6761,13260,6630
20240723,분당선,죽전,12951,14429,27380,13690
20240723,분당선,보정,2744,2449,5193,2596.5
20240723,분당선,이매,5478,5452,10930,5465
20240723,분당선,오리,12530,10629,23159,11579.5
20240723,분당선,미금,16094,16926,33020,16510
20240723,분당선,정자,20197,21059,41256,20628
20240723,분당선,수내,15406,15840,31246,15623
20240723,분당선,서현,25348,25667,51015,25507.5
20240723,분당선,야탑,26644,28062,54706,27353
20240723,분당선,모란,19822,20033,39855,19927.5
20240723,분당선,태평,13666,12939,26605,13302.5
20240723,분당선,가천대,6532,6740,13272,6636
20240723,분당선,선정릉,8731,9077,17808,8904
20240723,분당선,강남구청,10657,12413,23070,11535
20240723,분당선,압구정로데오,20740,22325,43065,21532.5
20240723,분당선,서울숲,13344,13646,26990,13495
20240723,분당선,수원,8034,7277,15311,7655.5
20240723,분당선,수서,17641,18217,35858,17929
20240723,분당선,대모산입구,6353,5999,12352,6176
20240723,분당선,개포동,4761,4807,9568,4784
20240723,분당선,구룡,3807,3743,7550,3775
20240723,분당선,도곡,8044,8079,16123,8061.5
20240723,분당선,한티,17461,18674,36135,18067.5
20240723,분당선,선릉,15184,23219,38403,19201.5
20240723,과천선,범계,28244,27788,56032,28016
20240723,과천선,평촌,19235,18815,38050,19025
20240723,과천선,인덕원,26512,27602,54114,27057
20240723,과천선,정부과천청사,13256,13878,27134,13567
20240723,과천선,과천,6747,6357,13104,6552
20240723,과천선,대공원,2168,2218,4386,2193
20240723,과천선,경마공원,1405,1416,2821,1410.5
20240723,과천선,선바위,7977,6934,14911,7455.5
20240723,공항철도 1호선,영종,4366,4306,8672,4336
20240723,공항철도 1호선,인천공항2터미널,7401,6343,13744,6872
20240723,공항철도 1호선,인천공항1터미널,14711,14903,29614,14807
20240723,공항철도 1호선,공항화물청사,2262,2399,4661,2330.5
20240723,공항철도 1호선,운서,9727,10067,19794,9897
20240723,공항철도 1호선,청라국제도시,8055,7529,15584,7792
20240723,공항철도 1호선,검암,6732,6887,13619,6809.5
20240723,공항철도 1호선,계양,13964,13256,27220,13610
20240723,공항철도 1호선,김포공항,10480,6292,16772,8386
20240723,공항철도 1호선,마곡나루(서울식물원),12425,11822,24247,12123.5
20240723,공항철도 1호선,디지털미디어시티,15771,14692,30463,15231.5
20240723,공항철도 1호선,홍대입구,15316,14637,29953,14976.5
20240723,공항철도 1호선,공덕,3258,4011,7269,3634.5
20240723,공항철도 1호선,서울역,13002,11144,24146,12073
20240723,경춘선,춘천,1065,974,2039,1019.5
20240723,경춘선,남춘천,2276,2381,4657,2328.5
20240723,경춘선,김유정,341,322,663,331.5
20240723,경춘선,강촌,438,334,772,386
20240723,경춘선,백양리,114,62,176,88
20240723,경춘선,굴봉산,134,90,224,112
20240723,경춘선,가평,2434,2186,4620,2310
20240723,경춘선,상천,204,220,424,212
20240723,경춘선,청평,1816,1673,3489,1744.5
20240723,경춘선,대성리,981,940,1921,960.5
20240723,경춘선,마석,3750,3783,7533,3766.5
20240723,경춘선,천마산,1514,1411,2925,1462.5
20240723,경춘선,평내호평,6094,5885,11979,5989.5
20240723,경춘선,금곡,1452,1370,2822,1411
20240723,경춘선,사릉,2110,2047,4157,2078.5
20240723,경춘선,퇴계원,3669,3343,7012,3506
20240723,경춘선,별내,3589,3368,6957,3478.5
20240723,경춘선,갈매,3112,2742,5854,2927
20240723,경춘선,신내,2876,2616,5492,2746
20240723,경인선,도화,4268,3991,8259,4129.5
20240723,경인선,중동,9659,8862,18521,9260.5
20240723,경인선,온수(성공회대입구),6540,6169,12709,6354.5
20240723,경인선,도원,2885,2918,5803,2901.5
20240723,경인선,간석,5900,5555,11455,5727.5
20240723,경인선,부개,9023,8371,17394,8697
20240723,경인선,소사,7562,7338,14900,7450
20240723,경인선,구일,23044,27420,50464,25232
20240723,경인선,인천,3460,2674,6134,3067
20240723,경인선,동인천,13891,13014,26905,13452.5
20240723,경인선,제물포,10444,10067,20511,10255.5
20240723,경인선,주안,18263,16480,34743,17371.5
20240723,경인선,동암,15699,15898,31597,15798.5
20240723,경인선,백운,7649,7463,15112,7556
20240723,경인선,부평,28258,29172,57430,28715
20240723,경인선,송내,27566,27456,55022,27511
20240723,경인선,부천,30985,30743,61728,30864
20240723,경인선,역곡,26127,26212,52339,26169.5
20240723,경인선,오류동,12052,11354,23406,11703
20240723,경인선,개봉,23595,22804,46399,23199.5
20240723,경의선,운천,3,2,5,2.5
20240723,경의선,임진강,11,10,21,10.5
20240723,경의선,문산,5233,5120,10353,5176.5
20240723,경의선,파주,1100,860,1960,980
20240723,경의선,월롱,2097,1812,3909,1954.5
20240723,경의선,금촌,6488,6205,12693,6346.5
20240723,경의선,금릉,5642,5253,10895,5447.5
20240723,경의선,운정,7946,7365,15311,7655.5
20240723,경의선,야당,8895,8887,17782,8891
20240723,경의선,탄현,8111,7832,15943,7971.5
20240723,경의선,일산,11514,11408,22922,11461
20240723,경의선,풍산,6320,6139,12459,6229.5
20240723,경의선,백마,7685,7564,15249,7624.5
20240723,경의선,곡산,674,735,1409,704.5
20240723,경의선,능곡,4900,4594,9494,4747
20240723,경의선,행신,8300,8352,16652,8326
20240723,경의선,강매,3451,2938,6389,3194.5
20240723,경의선,한국항공대,1880,1847,3727,1863.5
20240723,경의선,수색,3640,3718,7358,3679
20240723,경의선,디지털미디어시티,2931,2710,5641,2820.5
20240723,경의선,가좌,5934,5731,11665,5832.5
20240723,경의선,홍대입구,2101,2582,4683,2341.5
20240723,경의선,서강대,2217,2082,4299,2149.5
20240723,경의선,공덕,4559,3772,8331,4165.5
20240723,경의선,효창공원앞,3411,3888,7299,3649.5
20240723,경의선,신촌,1081,1343,2424,1212
20240723,경의선,서울역,5030,6138,11168,5584
20240723,경원선,연천,870,853,1723,861.5
20240723,경원선,전곡,914,851,1765,882.5
20240723,경원선,청산,133,110,243,121.5
20240723,경원선,소요산,1381,1336,2717,1358.5
20240723,경원선,동두천,1850,1651,3501,1750.5
20240723,경원선,보산,1481,1380,2861,1430.5
20240723,경원선,동두천중앙,2890,2806,5696,2848
20240723,경원선,지행,6357,6483,12840,6420
20240723,경원선,덕정,5878,5552,11430,5715
20240723,경원선,덕계,6017,5601,11618,5809
20240723,경원선,양주,7044,6635,13679,6839.5
20240723,경원선,녹양,4328,4117,8445,4222.5
20240723,경원선,가능,6482,6441,12923,6461.5
20240723,경원선,의정부,18126,18203,36329,18164.5
20240723,경원선,회룡,13369,13118,26487,13243.5
20240723,경원선,망월사,7321,7417,14738,7369
20240723,경원선,도봉산,6777,4159,10936,5468
20240723,경원선,도봉,6221,6003,12224,6112
20240723,경원선,방학,10152,9771,19923,9961.5
20240723,경원선,창동,5,0,5,2.5
20240723,경원선,녹천,4658,3952,8610,4305
20240723,경원선,월계,6589,6129,12718,6359
20240723,경원선,광운대,8016,7582,15598,7799
20240723,경원선,석계,7305,8433,15738,7869
20240723,경원선,신이문,8758,8217,16975,8487.5
20240723,경원선,외대앞,8548,8284,16832,8416
20240723,경원선,청량리(서울시립대입구),15774,16660,32434,16217
20240723,경원선,왕십리(성동구청),16309,16416,32725,16362.5
20240723,경원선,응봉,1965,1665,3630,1815
20240723,경원선,옥수,56,44,100,50
20240723,경원선,한남,4153,4048,8201,4100.5
20240723,경원선,서빙고,2284,2092,4376,2188
20240723,경부선,광명,3870,3347,7217,3608.5
20240724,중앙선,양원,3170,3202,6372,3186
20240724,중앙선,구리,13951,14170,28121,14060.5
20240724,중앙선,도농,11689,10919,22608,11304
20240724,중앙선,양정,572,500,1072,536
20240724,중앙선,덕소,5516,5525,11041,5520.5
20240724,중앙선,도심,2587,1978,4565,2282.5
20240724,중앙선,팔당,746,790,1536,768
20240724,중앙선,운길산,583,588,1171,585.5
20240724,중앙선,양수,2077,2044,4121,2060.5
20240724,중앙선,신원,164,154,318,159
20240724,중앙선,국수,717,710,1427,713.5
20240724,중앙선,아신,507,492,999,499.5
20240724,중앙선,오빈,324,329,653,326.5
20240724,중앙선,양평,3108,3117,6225,3112.5
20240724,중앙선,원덕,347,315,662,331
20240724,중앙선,용문,1845,1906,3751,1875.5
20240724,중앙선,지평,37,61,98,49
20240724,6호선,화랑대(서울여대입구),12479,9713,22192,11096
20240724,6호선,태릉입구,5931,6519,12450,6225
20240724,6호선,석계,13277,13627,26904,13452
20240724,6호선,돌곶이,11097,10198,21295,10647.5
20240724,6호선,상월곡(한국과학기술연구원),6694,6021,12715,6357.5
20240724,6호선,월곡(동덕여대),12466,12069,24535,12267.5
20240724,6호선,고려대(종암),8780,8290,17070,8535
20240724,6호선,안암(고대병원앞),12074,12063,24137,12068.5
20240724,6호선,보문,8428,7826,16254,8127
20240724,6호선,창신,3658,2889,6547,3273.5
20240724,6호선,동묘앞,8527,8753,17280,8640
20240724,6호선,신당,9573,9985,19558,9779
20240724,6호선,청구,4413,4270,8683,4341.5
20240724,6호선,약수,3862,3908,7770,3885
20240724,6호선,버티고개,2360,2416,4776,2388
20240724,6호선,한강진,11085,12832,23917,11958.5
20240724,6호선,이태원,10638,11162,21800,10900
20240724,6호선,녹사평(용산구청),5308,5075,10383,5191.5
20240724,6호선,삼각지,7644,6930,14574,7287
20240724,6호선,효창공원앞,7719,6930,14649,7324.5
20240724,6호선,공덕,21414,20909,42323,21161.5
20240724,6호선,대흥(서강대앞),9825,10137,19962,9981
20240724,6호선,광흥창(서강),10569,10121,20690,10345
20240724,6호선,상수,9979,10889,20868,10434
20240724,6호선,합정,14352,13782,28134,14067
20240724,6호선,망원,15949,16929,32878,16439
20240724,6호선,마포구청,15872,14273,30145,15072.5
20240724,6호선,월드컵경기장(성산),4641,4750,9391,4695.5
20240724,6호선,디지털미디어시티,16043,17782,33825,16912.5
20240724,6호선,증산(명지대앞),10508,10298,20806,10403
20240724,6호선,새절(신사),13827,12763,26590,13295
20240724,6호선,구산,8926,7132,16058,8029
20240724,6호선,연신내,1,0,1,0.5
20240724,6호선,독바위,3014,3129,6143,3071.5
20240724,6호선,불광,5635,5242,10877,5438.5
20240724,6호선,역촌,4222,4720,8942,4471
20240724,6호선,응암,19202,18891,38093,19046.5
20240724,5호선,하남검단산,6711,6376,13087,6543.5
20240724,5호선,하남시청(덕풍·신장),9031,8558,17589,8794.5
20240724,5호선,하남풍산,4731,4675,9406,4703
20240724,5호선,미사,19034,19227,38261,19130.5
20240724,5호선,강일,6402,5874,12276,6138
20240724,5호선,마천,7937,7132,15069,7534.5
20240724,5호선,거여,10883,10644,21527,10763.5
20240724,5호선,개롱,7286,7350,14636,7318
20240724,5호선,오금,3906,4041,7947,3973.5
20240724,5호선,방이,8117,8383,16500,8250
20240724,5호선,올림픽공원(한국체대),5757,4687,10444,5222
20240724,5호선,둔촌동,9655,9618,19273,9636.5
20240724,5호선,상일동,16121,15168,31289,15644.5
20240724,5호선,고덕,11679,11601,23280,11640
20240724,5호선,명일,9371,9578,18949,9474.5
20240724,5호선,굽은다리(강동구민회관앞),10854,10578,21432,10716
20240724,5호선,길동,8801,8962,17763,8881.5
20240724,5호선,강동,20095,19493,39588,19794
20240724,5호선,천호(풍납토성),20520,20343,40863,20431.5
20240724,5호선,광나루(장신대),14127,12842,26969,13484.5
20240724,5호선,아차산(어린이대공원후문),15088,14548,29636,14818
20240724,5호선,군자(능동),12078,13286,25364,12682
20240724,5호선,장한평,21840,21648,43488,21744
20240724,5호선,답십리,17465,15766,33231,16615.5
20240724,5호선,마장,6336,5826,12162,6081
20240724,5호선,왕십리(성동구청),4952,5619,10571,5285.5
20240724,5호선,행당,8777,7679,16456,8228
20240724,5호선,신금호,6857,7286,14143,7071.5
20240724,5호선,청구,4259,4118,8377,4188.5
20240724,5호선,동대문역사문화공원(DDP),3593,4184,7777,3888.5
20240724,5호선,을지로4가,7301,7227,14528,7264
20240724,5호선,종로3가,15749,15934,31683,15841.5
20240724,5호선,광화문(세종문화회관),36920,39296,76216,38108
20240724,5호선,서대문,22702,23015,45717,22858.5
20240724,5호선,충정로(경기대입구),5433,5625,11058,5529
20240724,5호선,애오개,7770,7772,15542,7771
20240724,5호선,공덕,16431,17404,33835,16917.5
20240724,5호선,마포,16429,16825,33254,16627
20240724,5호선,여의나루,12888,14751,27639,13819.5
20240724,5호선,여의도,33412,35261,68673,34336.5
20240724,5호선,신길,5415,5472,10887,5443.5
20240724,5호선,영등포시장,12370,12466,24836,12418
20240724,5호선,영등포구청,5283,5193,10476,5238
20240724,5호선,양평,8729,8613,17342,8671
20240724,5호선,오목교(목동운동장앞),22915,24303,47218,23609
20240724,5호선,목동,18119,19485,37604,18802
20240724,5호선,신정(은행정),14687,12250,26937,13468.5
20240724,5호선,까치산,29742,28525,58267,29133.5
20240724,5호선,화곡,30687,28916,59603,29801.5
20240724,5호선,우장산,15681,15453,31134,15567
20240724,5호선,발산,25329,26192,51521,25760.5
20240724,5호선,마곡,13685,13870,27555,13777.5
20240724,5호선,송정,6800,6257,13057,6528.5
20240724,5호선,김포공항,11745,8596,20341,10170.5
20240724,5호선,개화산,6878,6534,13412,6706
20240724,5호선,방화,7608,7283,14891,7445.5
20240724,4호선,남태령,1381,1232,2613,1306.5
20240724,4호선,사당,27187,23619,50806,25403
20240724,4호선,총신대입구(이수),20345,21791,42136,21068
20240724,4호선,동작(현충원),1312,1489,2801,1400.5
20240724,4호선,이촌(국립중앙박물관),8914,9853,18767,9383.5
20240724,4호선,신용산,22738,24708,47446,23723
20240724,4호선,삼각지,6610,7448,14058,7029
20240724,4호선,숙대입구(갈월),14808,14530,29338,14669
20240724,4호선,서울역,14531,23321,37852,18926
20240724,4호선,회현(남대문시장),29317,30567,59884,29942
20240724,4호선,명동,35397,37462,72859,36429.5
20240724,4호선,충무로,32991,33969,66960,33480
20240724,4호선,동대문역사문화공원(DDP),21071,18844,39915,19957.5
20240724,4호선,동대문,22115,22696,44811,22405.5
20240724,4호선,혜화,38294,38553,76847,38423.5
20240724,4호선,한성대입구(삼선교),13708,13126,26834,13417
20240724,4호선,성신여대입구(돈암),22157,21618,43775,21887.5
20240724,4호선,길음,22884,22266,45150,22575
20240724,4호선,미아사거리,28165,27613,55778,27889
20240724,4호선,미아(서울사이버대학),16162,15771,31933,15966.5
20240724,4호선,수유(강북구청),35299,35475,70774,35387
20240724,4호선,쌍문,31280,29082,60362,30181
20240724,4호선,창동,28264,29776,58040,29020
20240724,4호선,노원,30406,33822,64228,32114
20240724,4호선,상계,20456,18976,39432,19716
20240724,4호선,당고개,10255,8827,19082,9541
20240724,3호선,오금,7408,6324,13732,6866
20240724,3호선,경찰병원,8671,8775,17446,8723
20240724,3호선,가락시장,9746,9193,18939,9469.5
20240724,3호선,수서,19713,19527,39240,19620
20240724,3호선,일원,11957,11737,23694,11847
20240724,3호선,대청,11552,10768,22320,11160
20240724,3호선,학여울,2155,2200,4355,2177.5
20240724,3호선,대치,13792,13518,27310,13655
20240724,3호선,도곡,6286,6084,12370,6185
20240724,3호선,매봉,14420,14007,28427,14213.5
20240724,3호선,양재(서초구청),40958,43962,84920,42460
20240724,3호선,남부터미널(예술의전당),32573,33213,65786,32893
20240724,3호선,교대(법원.검찰청),19240,11269,30509,15254.5
20240724,3호선,고속터미널,47789,44322,92111,46055.5
20240724,3호선,잠원,5602,5215,10817,5408.5
20240724,3호선,신사,29979,31313,61292,30646
20240724,3호선,압구정,34795,36283,71078,35539
20240724,3호선,옥수,9617,9887,19504,9752
20240724,3호선,금호,8747,8062,16809,8404.5
20240724,3호선,약수,13881,13477,27358,13679
20240724,3호선,동대입구,9643,10257,19900,9950
20240724,3호선,충무로,9,0,9,4.5
20240724,3호선,을지로3가,13093,13177,26270,13135
20240724,3호선,종로3가,13120,14269,27389,13694.5
20240724,3호선,안국,27985,28800,56785,28392.5
20240724,3호선,경복궁(정부서울청사),25349,25509,50858,25429
20240724,3호선,독립문,7874,7742,15616,7808
20240724,3호선,무악재,4885,4570,9455,4727.5
20240724,3호선,홍제,19116,18073,37189,18594.5
20240724,3호선,녹번,16607,15260,31867,15933.5
20240724,3호선,불광,17935,19215,37150,18575
20240724,3호선,연신내,35980,34026,70006,35003
20240724,3호선,구파발,23905,23086,46991,23495.5
20240724,3호선,지축,8194,8170,16364,8182
20240724,2호선,용두(동대문구청),2605,2692,5297,2648.5
20240724,2호선,신정네거리,10851,11294,22145,11072.5
20240724,2호선,양천구청,7338,7787,15125,7562.5
20240724,2호선,도림천,1435,1466,2901,1450.5
20240724,2호선,신설동,3585,3592,7177,3588.5
20240724,2호선,신답,1811,2097,3908,1954
20240724,2호선,용답,3045,2916,5961,2980.5
20240724,2호선,충정로(경기대입구),11525,12030,23555,11777.5
20240724,2호선,아현,12035,11076,23111,11555.5
20240724,2호선,이대,16371,17887,34258,17129
20240724,2호선,신촌,39011,39488,78499,39249.5
20240724,2호선,홍대입구,74621,79504,154125,77062.5
20240724,2호선,합정,33685,35877,69562,34781
20240724,2호선,당산,19012,22157,41169,20584.5
20240724,2호선,영등포구청,24705,25404,50109,25054.5
20240724,2호선,문래,26398,26899,53297,26648.5
20240724,2호선,신도림,55104,52828,107932,53966
20240724,2호선,대림(구로구청),25842,26088,51930,25965
20240724,2호선,구로디지털단지,63403,63129,126532,63266
20240724,2호선,신대방,27206,26343,53549,26774.5
20240724,2호선,신림,58735,56527,115262,57631
20240724,2호선,봉천,26437,24840,51277,25638.5
20240724,2호선,서울대입구(관악구청),49650,48047,97697,48848.5
20240724,2호선,낙성대(강감찬),30074,29409,59483,29741.5
20240724,2호선,사당,42494,45357,87851,43925.5
20240724,2호선,방배,16746,17222,33968,16984
20240724,2호선,서초,23585,23140,46725,23362.5
20240724,2호선,교대(법원.검찰청),35093,42005,77098,38549
20240724,2호선,강남,91137,88732,179869,89934.5
20240724,2호선,역삼,60852,69829,130681,65340.5
20240724,2호선,선릉,67768,59554,127322,63661
20240724,2호선,삼성(무역센터),63661,64938,128599,64299.5
20240724,2호선,종합운동장,13141,13911,27052,13526
20240724,2호선,잠실새내,25268,24537,49805,24902.5
20240724,2호선,잠실(송파구청),84048,83754,167802,83901
20240724,2호선,잠실나루,17192,16492,33684,16842
20240724,2호선,강변(동서울터미널),31164,29311,60475,30237.5
20240724,2호선,구의(광진구청),26995,26140,53135,26567.5
20240724,2호선,건대입구,35813,37621,73434,36717
20240724,2호선,성수,48460,52823,101283,50641.5
20240724,2호선,뚝섬,27801,29609,57410,28705
20240724,2호선,한양대,9125,9627,18752,9376
20240724,2호선,왕십리(성동구청),16495,14948,31443,15721.5
20240724,2호선,상왕십리,15683,15468,31151,15575.5
20240724,2호선,신당,15772,16498,32270,16135
20240724,2호선,동대문역사문화공원(DDP),15991,18343,34334,17167
20240724,2호선,을지로4가,16199,16020,32219,16109.5
20240724,2호선,을지로3가,28551,28722,57273,28636.5
20240724,2호선,을지로입구,54542,56772,111314,55657
20240724,2호선,시청,30404,29466,59870,29935
20240724,1호선,동묘앞,9011,8987,17998,8999
20240724,1호선,청량리(서울시립대입구),23776,23081,46857,23428.5
20240724,1호선,제기동,17070,17176,34246,17123
20240724,1호선,신설동,15371,14921,30292,15146
20240724,1호선,동대문,11735,11393,23128,11564
20240724,1호선,종로5가,25606,24980,50586,25293
20240724,1호선,종로3가,26636,24411,51047,25523.5
20240724,1호선,종각,44149,43583,87732,43866
20240724,1호선,시청,28668,28951,57619,28809.5
20240724,1호선,서울역,58600,55068,113668,56834
20240724,경강선,삼동,2800,2564,5364,2682
20240724,경강선,이매,1187,1061,2248,1124
20240724,분당선,복정,3,0,3,1.5
20240724,경강선,판교,6376,6359,12735,6367.5
20240724,9호선2~3단계,중앙보훈병원,13635,12062,25697,12848.5
20240724,9호선2~3단계,둔촌오륜,1350,1361,2711,1355.5
20240724,9호선2~3단계,올림픽공원(한국체대),5580,5917,11497,5748.5
20240724,7호선,용마산(용마폭포공원),6175,5891,12066,6033
20240724,7호선,사가정,17119,17345,34464,17232
20240724,7호선,면목,15931,15640,31571,15785.5
20240724,7호선,상봉,18847,17825,36672,18336
20240724,7호선,중화,11441,11098,22539,11269.5
20240724,7호선,먹골,11016,10898,21914,10957
20240724,7호선,태릉입구,9230,8495,17725,8862.5
20240724,7호선,공릉(서울과학기술대),12524,12280,24804,12402
20240724,7호선,하계,19718,18388,38106,19053
20240724,7호선,중계,15973,14741,30714,15357
20240724,7호선,노원,25812,26981,52793,26396.5
20240724,7호선,마들,14231,13503,27734,13867
20240724,7호선,수락산,12981,12988,25969,12984.5
20240724,7호선,도봉산,9388,10714,20102,10051
20240724,7호선,장암,2991,1252,4243,2121.5
20240724,6호선,봉화산(서울의료원),9830,9058,18888,9444
20240724,경강선,세종대왕릉,332,321,653,326.5
20240724,경강선,부발,2218,2259,4477,2238.5
20240724,경강선,이천,2869,3026,5895,2947.5
20240724,경강선,신둔도예촌,1444,1351,2795,1397.5
20240724,경강선,곤지암,2233,2164,4397,2198.5
20240724,경강선,초월,3698,3498,7196,3598
20240724,경부선,영등포,43877,44681,88558,44279
20240724,경부선,대방,11114,11842,22956,11478
20240724,경부선,노량진,7930,7890,15820,7910
20240724,경부선,용산,43470,44654,88124,44062
20240724,경부선,남영,10205,10464,20669,10334.5
20240724,경부선,서울역,9410,3499,12909,6454.5
20240724,경강선,성남,986,897,1883,941.5
20240724,경강선,여주,2695,2651,5346,2673
20240724,경강선,경기광주,8343,7932,16275,8137.5
20240724,9호선2~3단계,한성백제,3292,3109,6401,3200.5
20240724,9호선2~3단계,송파나루,6313,6765,13078,6539
20240724,9호선2~3단계,석촌,10365,9182,19547,9773.5
20240724,9호선2~3단계,석촌고분,8079,7912,15991,7995.5
20240724,9호선2~3단계,삼전,8987,8345,17332,8666
20240724,9호선2~3단계,종합운동장,5289,5425,10714,5357
20240724,9호선2~3단계,봉은사,24857,26047,50904,25452
20240724,9호선2~3단계,삼성중앙,9145,9382,18527,9263.5
20240724,9호선2~3단계,선정릉,11229,11979,23208,11604
20240724,9호선2~3단계,언주,13436,13670,27106,13553
20240724,9호선,신논현,33962,33701,67663,33831.5
20240724,9호선,사평,4428,4338,8766,4383
20240724,9호선,고속터미널,15361,20354,35715,17857.5
20240724,9호선,신반포,4482,4318,8800,4400
20240724,9호선,구반포,1498,1491,2989,1494.5
20240724,9호선,동작(현충원),1945,1602,3547,1773.5
20240724,9호선,흑석(중앙대입구),9405,9637,19042,9521
20240724,9호선,노들,5448,4550,9998,4999
20240724,9호선,노량진,27071,26422,53493,26746.5
20240724,9호선,샛강,7358,7616,14974,7487
20240724,9호선,여의도,34722,33681,68403,34201.5
20240724,9호선,국회의사당,19493,20445,39938,19969
20240724,9호선,당산,21625,21373,42998,21499
20240724,9호선,선유도,10111,9701,19812,9906
20240724,9호선,신목동,4929,4355,9284,4642
20240724,9호선,염창,19561,18721,38282,19141
20240724,9호선,등촌,13916,13379,27295,13647.5
20240724,9호선,증미,9281,9041,18322,9161
20240724,9호선,가양,24070,23732,47802,23901
20240724,9호선,양천향교,11085,11451,22536,11268
20240724,9호선,마곡나루(서울식물원),15262,14948,30210,15105
20240724,9호선,신방화,7771,7679,15450,7725
20240724,9호선,공항시장,3314,3563,6877,3438.5
20240724,9호선,김포공항,7375,10821,18196,9098
20240724,9호선,개화,3122,2076,5198,2599
20240724,8호선,남위례,7634,7609,15243,7621.5
20240724,8호선,모란,5971,4588,10559,5279.5
20240724,8호선,수진,6079,5701,11780,5890
20240724,8호선,신흥,5608,5859,11467,5733.5
20240724,8호선,단대오거리,12717,12472,25189,12594.5
20240724,8호선,남한산성입구(성남법원.검찰청),13567,12069,25636,12818
20240724,8호선,산성,6741,6902,13643,6821.5
20240724,8호선,복정,10178,8482,18660,9330
20240724,8호선,장지,18961,17437,36398,18199
20240724,8호선,문정,24851,26261,51112,25556
20240724,8호선,가락시장,8349,9281,17630,8815
20240724,8호선,송파,10515,10160,20675,10337.5
20240724,8호선,석촌,8695,9814,18509,9254.5
20240724,8호선,잠실(송파구청),17497,20304,37801,18900.5
20240724,8호선,몽촌토성(평화의문),7318,7364,14682,7341
20240724,8호선,강동구청,11578,11877,23455,11727.5
20240724,8호선,천호(풍납토성),16426,18786,35212,17606
20240724,8호선,암사,20635,18122,38757,19378.5
20240724,7호선,온수(성공회대입구),10165,9443,19608,9804
20240724,7호선,천왕,12982,12368,25350,12675
20240724,7호선,광명사거리,21292,20811,42103,21051.5
20240724,7호선,철산,22937,23341,46278,23139
20240724,7호선,가산디지털단지,51363,51800,103163,51581.5
20240724,7호선,남구로,16105,17001,33106,16553
20240724,7호선,대림(구로구청),9257,9283,18540,9270
20240724,7호선,신풍,12197,11325,23522,11761
20240724,7호선,보라매,7059,7391,14450,7225
20240724,7호선,신대방삼거리,15891,15325,31216,15608
20240724,7호선,장승배기,10004,9790,19794,9897
20240724,7호선,상도,12106,11682,23788,11894
20240724,7호선,숭실대입구(살피재),13188,13049,26237,13118.5
20240724,7호선,남성,12433,11731,24164,12082
20240724,7호선,이수,17822,17275,35097,17548.5
20240724,7호선,내방,16520,16717,33237,16618.5
20240724,7호선,고속터미널,17142,14764,31906,15953
20240724,7호선,반포,6935,6659,13594,6797
20240724,7호선,논현,20693,21272,41965,20982.5
20240724,7호선,학동,27250,28341,55591,27795.5
20240724,7호선,강남구청,18008,20104,38112,19056
20240724,7호선,청담,20855,23032,43887,21943.5
20240724,7호선,자양(뚝섬한강공원),9811,9433,19244,9622
20240724,7호선,건대입구,13679,13939,27618,13809
20240724,7호선,어린이대공원(세종대),14192,13980,28172,14086
20240724,7호선,군자(능동),16474,13189,29663,14831.5
20240724,7호선,중곡,11801,11252,23053,11526.5
20240724,경부선,신도림,4186,4562,8748,4374
20240724,경부선,신길,9329,7872,17201,8600.5
20240724,경부선,구로,19753,19963,39716,19858
20240724,경부선,가산디지털단지,20093,23054,43147,21573.5
20240724,경부선,금천구청,11696,11817,23513,11756.5
20240724,경부선,석수,9240,8359,17599,8799.5
20240724,경부선,관악,7605,7398,15003,7501.5
20240724,경부선,안양,21729,21598,43327,21663.5
20240724,경부선,명학,9303,9197,18500,9250
20240724,경부선,금정,29786,29971,59757,29878.5
20240724,경부선,군포,7748,7599,15347,7673.5
20240724,경부선,의왕,9652,9607,19259,9629.5
20240724,경부선,성균관대,15490,15222,30712,15356
20240724,경부선,화서,12023,11820,23843,11921.5
20240724,경부선,수원,36618,38405,75023,37511.5
20240724,경부선,독산,19149,19818,38967,19483.5
20240724,경부선,세류,3619,3210,6829,3414.5
20240724,경부선,병점,15218,14801,30019,15009.5
20240724,경부선,세마,3413,3201,6614,3307
20240724,경부선,오산대,3670,3374,7044,3522
20240724,경부선,오산,9941,9991,19932,9966
20240724,경부선,진위,1806,1656,3462,1731
20240724,경부선,송탄,4379,4190,8569,4284.5
20240724,경부선,서정리,8072,7601,15673,7836.5
20240724,경부선,평택지제,4060,4023,8083,4041.5
20240724,경부선,평택,11820,11670,23490,11745
20240724,경부선,성환,3758,3725,7483,3741.5
20240724,경부선,직산,1015,996,2011,1005.5
20240724,경부선,두정,6425,6457,12882,6441
20240724,경부선,천안,5591,5675,11266,5633
20240724,경부선,당정,6318,6068,12386,6193
20240724,경부선,서동탄,1658,1394,3052,1526
20240724,경부선,광명,4070,3380,7450,3725
20240724,경원선,이촌(국립중앙박물관),4412,3319,7731,3865.5
20240724,경원선,서빙고,2340,2139,4479,2239.5
20240724,경원선,한남,4255,3986,8241,4120.5
20240724,경원선,옥수,53,36,89,44.5
20240724,경원선,응봉,1948,1669,3617,1808.5
20240724,경원선,왕십리(성동구청),17537,17886,35423,17711.5
20240724,경원선,청량리(서울시립대입구),15775,17107,32882,16441
20240724,경원선,외대앞,8541,8260,16801,8400.5
20240724,경원선,신이문,9069,8464,17533,8766.5
20240724,경원선,석계,7714,8963,16677,8338.5
20240724,경원선,광운대,8262,7655,15917,7958.5
20240724,경원선,월계,6856,6319,13175,6587.5
20240724,경원선,녹천,4746,3972,8718,4359
20240724,경원선,방학,10383,10058,20441,10220.5
20240724,경원선,도봉,6431,6221,12652,6326
20240724,경원선,도봉산,7513,4657,12170,6085
20240724,경원선,망월사,7853,7988,15841,7920.5
20240724,경원선,회룡,13935,13621,27556,13778
20240724,경원선,의정부,19171,19553,38724,19362
20240724,경원선,가능,6774,6661,13435,6717.5
20240724,경원선,녹양,4570,4339,8909,4454.5
20240724,경원선,양주,7342,7014,14356,7178
20240724,경원선,덕계,6267,5718,11985,5992.5
20240724,경원선,덕정,6081,5797,11878,5939
20240724,경원선,지행,6555,6591,13146,6573
20240724,경원선,동두천중앙,2876,2889,5765,2882.5
20240724,경원선,보산,1473,1384,2857,1428.5
20240724,경원선,동두천,1677,1656,3333,1666.5
20240724,경원선,소요산,1578,1602,3180,1590
20240724,경원선,청산,151,121,272,136
20240724,경원선,전곡,1095,1001,2096,1048
20240724,경원선,연천,1028,1052,2080,1040
20240724,경의선,서울역,5096,6305,11401,5700.5
20240724,경의선,신촌,1042,1313,2355,1177.5
20240724,경의선,효창공원앞,3448,3886,7334,3667
20240724,경의선,공덕,4733,3810,8543,4271.5
20240724,경의선,서강대,2324,2163,4487,2243.5
20240724,경의선,홍대입구,2218,2682,4900,2450
20240724,경의선,가좌,6281,5902,12183,6091.5
20240724,경의선,디지털미디어시티,3003,2822,5825,2912.5
20240724,경의선,수색,3680,3730,7410,3705
20240724,경의선,한국항공대,1981,1857,3838,1919
20240724,경의선,강매,3487,2936,6423,3211.5
20240724,경의선,행신,8536,8449,16985,8492.5
20240724,경의선,능곡,4962,4627,9589,4794.5
20240724,경의선,곡산,696,724,1420,710
20240724,경의선,백마,7900,7777,15677,7838.5
20240724,경의선,풍산,6507,6135,12642,6321
20240724,경의선,일산,11173,10960,22133,11066.5
20240724,경의선,탄현,8292,8026,16318,8159
20240724,경의선,야당,9334,9181,18515,9257.5
20240724,경의선,운정,8179,7489,15668,7834
20240724,경의선,금릉,5715,5503,11218,5609
20240724,경의선,금촌,6748,6535,13283,6641.5
20240724,경의선,월롱,2017,1767,3784,1892
20240724,경의선,파주,1109,910,2019,1009.5
20240724,경의선,문산,5623,5465,11088,5544
20240724,경의선,임진강,8,5,13,6.5
20240724,경의선,운천,3,4,7,3.5
20240724,경인선,개봉,23874,22981,46855,23427.5
20240724,경인선,오류동,12530,11763,24293,12146.5
20240724,경인선,역곡,26640,26659,53299,26649.5
20240724,경인선,부천,32330,32327,64657,32328.5
20240724,경인선,송내,28087,27573,55660,27830
20240724,경인선,부평,30011,31406,61417,30708.5
20240724,경인선,백운,8052,7956,16008,8004
20240724,경인선,동암,16194,16032,32226,16113
20240724,경인선,주안,19322,17360,36682,18341
20240724,경인선,제물포,10902,10317,21219,10609.5
20240724,경인선,동인천,14801,13855,28656,14328
20240724,경인선,인천,3996,3154,7150,3575
20240724,경인선,구일,23521,27704,51225,25612.5
20240724,경인선,소사,7673,7263,14936,7468
20240724,경인선,부개,9197,8569,17766,8883
20240724,경인선,간석,6053,5783,11836,5918
20240724,경인선,도원,2964,3040,6004,3002
20240724,경인선,온수(성공회대입구),6435,6201,12636,6318
20240724,경인선,중동,9750,9197,18947,9473.5
20240724,경인선,도화,4346,4081,8427,4213.5
20240724,경춘선,신내,2972,2699,5671,2835.5
20240724,경춘선,갈매,3173,2775,5948,2974
20240724,경춘선,별내,3570,3397,6967,3483.5
20240724,경춘선,퇴계원,3921,3576,7497,3748.5
20240724,경춘선,사릉,2207,2166,4373,2186.5
20240724,경춘선,금곡,1492,1467,2959,1479.5
20240724,경춘선,평내호평,6337,6068,12405,6202.5
20240724,경춘선,천마산,1581,1492,3073,1536.5
20240724,경춘선,마석,3742,3579,7321,3660.5
20240724,경춘선,대성리,926,892,1818,909
20240724,경춘선,청평,1920,1826,3746,1873
20240724,경춘선,상천,214,200,414,207
20240724,경춘선,가평,2334,2388,4722,2361
20240724,경춘선,굴봉산,150,115,265,132.5
20240724,경춘선,백양리,88,87,175,87.5
20240724,경춘선,강촌,495,454,949,474.5
20240724,경춘선,김유정,343,348,691,345.5
20240724,경춘선,남춘천,2423,2435,4858,2429
20240724,경춘선,춘천,1160,1057,2217,1108.5
20240724,공항철도 1호선,서울역,13395,11964,25359,12679.5
20240724,공항철도 1호선,공덕,3247,4100,7347,3673.5
20240724,공항철도 1호선,홍대입구,16137,15473,31610,15805
20240724,공항철도 1호선,디지털미디어시티,16025,14852,30877,15438.5
20240724,공항철도 1호선,마곡나루(서울식물원),12318,11738,24056,12028
20240724,공항철도 1호선,김포공항,10213,6081,16294,8147
20240724,공항철도 1호선,계양,14306,13710,28016,14008
20240724,공항철도 1호선,검암,6985,7196,14181,7090.5
20240724,공항철도 1호선,청라국제도시,8248,7783,16031,8015.5
20240724,공항철도 1호선,운서,10033,10435,20468,10234
20240724,공항철도 1호선,공항화물청사,2265,2423,4688,2344
20240724,공항철도 1호선,인천공항1터미널,13867,15076,28943,14471.5
20240724,공항철도 1호선,인천공항2터미널,7101,6519,13620,6810
20240724,공항철도 1호선,영종,4408,4351,8759,4379.5
20240724,과천선,선바위,8131,7156,15287,7643.5
20240724,과천선,경마공원,1588,1627,3215,1607.5
20240724,과천선,대공원,2410,2467,4877,2438.5
20240724,과천선,과천,7014,6456,13470,6735
20240724,과천선,정부과천청사,13580,14121,27701,13850.5
20240724,과천선,인덕원,27123,28155,55278,27639
20240724,과천선,평촌,19351,18723,38074,19037
20240724,과천선,범계,29173,29036,58209,29104.5
20240724,분당선,선릉,15316,23500,38816,19408
20240724,분당선,한티,17734,18874,36608,18304
20240724,분당선,도곡,8183,8318,16501,8250.5
20240724,분당선,구룡,3827,3797,7624,3812
20240724,분당선,개포동,4978,5110,10088,5044
20240724,분당선,대모산입구,6603,6201,12804,6402
20240724,분당선,수서,18095,18716,36811,18405.5
20240724,분당선,수원,8472,7633,16105,8052.5
20240724,분당선,서울숲,13982,14178,28160,14080
20240724,분당선,압구정로데오,20860,22825,43685,21842.5
20240724,분당선,강남구청,10719,12436,23155,11577.5
20240724,분당선,선정릉,8602,9049,17651,8825.5
20240724,분당선,가천대,7002,7265,14267,7133.5
20240724,분당선,태평,14305,13381,27686,13843
20240724,분당선,모란,24602,25300,49902,24951
20240724,분당선,야탑,27676,29079,56755,28377.5
20240724,분당선,서현,26439,26697,53136,26568
20240724,분당선,수내,15644,15899,31543,15771.5
20240724,분당선,정자,20495,21432,41927,20963.5
20240724,분당선,미금,16523,17538,34061,17030.5
20240724,분당선,오리,12751,10903,23654,11827
20240724,분당선,이매,5953,5768,11721,5860.5
20240724,분당선,보정,2781,2514,5295,2647.5
20240724,분당선,죽전,13540,15056,28596,14298
20240724,분당선,구성,6933,6971,13904,6952
20240724,분당선,신갈,5193,5092,10285,5142.5
20240724,분당선,기흥,11285,10190,21475,10737.5
20240724,분당선,상갈,5775,5460,11235,5617.5
20240724,분당선,청명,4945,4830,9775,4887.5
20240724,분당선,영통,9615,9605,19220,9610
20240724,분당선,망포,16835,16217,33052,16526
20240724,분당선,매탄권선,5750,5565,11315,5657.5
20240724,분당선,수원시청,15221,16153,31374,15687
20240724,분당선,매교,5565,5642,11207,5603.5
20240724,서해선,김포공항,3319,3947,7266,3633
20240724,서해선,원종,4991,5036,10027,5013.5
20240724,서해선,부천종합운동장,2797,2288,5085,2542.5
20240724,수인선,고색,5835,5331,11166,5583
20240724,수인선,오목천,3971,3583,7554,3777
20240724,수인선,어천,1436,1409,2845,1422.5
20240724,수인선,야목,452,376,828,414
20240724,수인선,사리,5270,4486,9756,4878
20240724,수인선,달월,112,70,182,91
20240724,수인선,월곶,3352,3130,6482,3241
20240724,수인선,소래포구,4692,4414,9106,4553
20240724,수인선,인천논현,5734,6084,11818,5909
20240724,수인선,호구포,4257,4464,8721,4360.5
20240724,수인선,남동인더스파크,2711,3030,5741,2870.5
20240724,수인선,원인재,4718,4792,9510,4755
20240724,수인선,연수,5110,5005,10115,5057.5
20240724,수인선,송도,2599,2383,4982,2491
20240724,수인선,인하대,6708,6245,12953,6476.5
20240724,수인선,숭의,4480,4152,8632,4316
20240724,수인선,신포,2013,1973,3986,1993
20240724,수인선,인천,1116,1752,2868,1434
20240724,신림선,샛강,3247,3738,6985,3492.5
20240724,신림선,대방,3094,2579,5673,2836.5
20240724,신림선,서울지방병무청,3484,3702,7186,3593
20240724,신림선,보라매,4578,4091,8669,4334.5
20240724,신림선,보라매공원,2537,2697,5234,2617
20240724,신림선,보라매병원,8995,9514,18509,9254.5
20240724,신림선,당곡,5378,5276,10654,5327
20240724,신림선,신림,2115,2757,4872,2436
20240724,신림선,서원,3922,3493,7415,3707.5
20240724,신림선,서울대벤처타운,9988,9388,19376,9688
20240724,신림선,관악산(서울대),3047,2954,6001,3000.5
20240724,안산선,산본,17004,18135,35139,17569.5
20240724,안산선,대야미,5233,4527,9760,4880
20240724,안산선,반월,4420,4272,8692,4346
20240724,안산선,상록수,15344,15727,31071,15535.5
20240724,안산선,한대앞,9197,9340,18537,9268.5
20240724,안산선,중앙,19277,20042,39319,19659.5
20240724,안산선,고잔,9608,9218,18826,9413
20240724,안산선,초지,5338,5320,10658,5329
20240724,안산선,안산,12169,11073,23242,11621
20240724,안산선,신길온천,2161,1929,4090,2045
20240724,안산선,정왕,9184,9465,18649,9324.5
20240724,안산선,오이도,8236,8022,16258,8129
20240724,안산선,수리산,4238,3459,7697,3848.5
20240724,우이신설선,북한산우이,2876,2565,5441,2720.5
20240724,우이신설선,솔밭공원,2816,2744,5560,2780
20240724,우이신설선,4.19민주묘지,3297,3015,6312,3156
20240724,우이신설선,가오리,4625,4703,9328,4664
20240724,우이신설선,화계,3865,3677,7542,3771
20240724,우이신설선,삼양,2256,2326,4582,2291
20240724,우이신설선,삼양사거리,2749,2757,5506,2753
20240724,우이신설선,솔샘,6498,6090,12588,6294
20240724,우이신설선,북한산보국문,6523,6120,12643,6321.5
20240724,우이신설선,정릉,5071,4635,9706,4853
20240724,우이신설선,성신여대입구(돈암),3952,4239,8191,4095.5
20240724,우이신설선,보문,1696,1657,3353,1676.5
20240724,우이신설선,신설동,2557,2343,4900,2450
20240724,일산선,원흥,12265,11537,23802,11901
20240724,일산선,지축,2,0,2,1
20240724,일산선,삼송,20245,19450,39695,19847.5
20240724,일산선,원당,11606,11010,22616,11308
20240724,일산선,화정,18314,18719,37033,18516.5
20240724,일산선,대곡,3100,2399,5499,2749.5
20240724,일산선,백석,10521,10573,21094,10547
20240724,일산선,마두,8793,8917,17710,8855
20240724,일산선,정발산,7548,7683,15231,7615.5
20240724,일산선,주엽,10763,10958,21721,10860.5
20240724,일산선,대화,13983,10899,24882,12441
20240724,장항선,봉명,1530,1526,3056,1528
20240724,장항선,쌍용(나사렛대),2342,2233,4575,2287.5
20240724,장항선,아산,3387,3182,6569,3284.5
20240724,장항선,탕정,1709,1572,3281,1640.5
20240724,장항선,배방,1191,1170,2361,1180.5
20240724,장항선,온양온천,4920,4896,9816,4908
20240724,장항선,신창(순천향대),1106,1102,2208,1104
20240724,중앙선,회기,25078,23731,48809,24404.5
20240724,중앙선,중랑,5789,5697,11486,5743
20240724,중앙선,상봉,6081,6120,12201,6100.5
20240724,중앙선,망우,7952,7866,15818,7909
20240725,수인선,고색,5854,5375,11229,5614.5
20240725,중앙선,지평,64,52,116,58
20240725,중앙선,용문,3294,3270,6564,3282
20240725,중앙선,원덕,366,354,720,360
20240725,중앙선,양평,3182,3224,6406,3203
20240725,중앙선,오빈,342,344,686,343
20240725,중앙선,아신,530,494,1024,512
20240725,중앙선,국수,740,766,1506,753
20240725,중앙선,신원,189,157,346,173
20240725,중앙선,양수,2100,2103,4203,2101.5
20240725,중앙선,운길산,641,671,1312,656
20240725,중앙선,팔당,853,886,1739,869.5
20240725,중앙선,도심,2545,2000,4545,2272.5
20240725,중앙선,덕소,5501,5447,10948,5474
20240725,중앙선,양정,638,541,1179,589.5
20240725,중앙선,도농,11817,10722,22539,11269.5
20240725,중앙선,구리,13930,13888,27818,13909
20240725,2호선,용답,2992,2936,5928,2964
20240725,일산선,지축,1,0,1,0.5
20240725,1호선,서울역,60007,57025,117032,58516
20240725,1호선,시청,28443,28733,57176,28588
20240725,1호선,종각,45632,44163,89795,44897.5
20240725,1호선,종로3가,27316,24944,52260,26130
20240725,1호선,종로5가,26101,25736,51837,25918.5
20240725,1호선,동대문,12035,11681,23716,11858
20240725,1호선,신설동,15455,15031,30486,15243
20240725,1호선,제기동,17284,17397,34681,17340.5
20240725,1호선,청량리(서울시립대입구),23813,23620,47433,23716.5
20240725,1호선,동묘앞,9051,8956,18007,9003.5
20240725,2호선,시청,31090,29733,60823,30411.5
20240725,2호선,을지로입구,54782,56606,111388,55694
20240725,2호선,을지로3가,28882,28179,57061,28530.5
20240725,2호선,을지로4가,16245,15936,32181,16090.5
20240725,2호선,동대문역사문화공원(DDP),16521,18897,35418,17709
20240725,2호선,신당,15795,16591,32386,16193
20240725,2호선,상왕십리,15615,15610,31225,15612.5
20240725,2호선,왕십리(성동구청),16729,15207,31936,15968
20240725,2호선,한양대,9192,9840,19032,9516
20240725,2호선,뚝섬,27694,29352,57046,28523
20240725,2호선,성수,48100,52375,100475,50237.5
20240725,2호선,건대입구,36469,37856,74325,37162.5
20240725,2호선,구의(광진구청),27232,26489,53721,26860.5
20240725,2호선,강변(동서울터미널),32195,30485,62680,31340
20240725,2호선,잠실나루,16680,16233,32913,16456.5
20240725,2호선,잠실(송파구청),88720,87964,176684,88342
20240725,2호선,잠실새내,26177,25565,51742,25871
20240725,2호선,종합운동장,21462,22558,44020,22010
20240725,2호선,삼성(무역센터),68188,68596,136784,68392
20240725,2호선,선릉,67753,59772,127525,63762.5
20240725,2호선,역삼,60918,69368,130286,65143
20240725,2호선,강남,93236,90294,183530,91765
20240725,2호선,교대(법원.검찰청),36061,42693,78754,39377
20240725,2호선,서초,23944,23349,47293,23646.5
20240725,2호선,방배,16659,17334,33993,16996.5
20240725,2호선,사당,43614,47435,91049,45524.5
20240725,2호선,낙성대(강감찬),30225,29493,59718,29859
20240725,2호선,서울대입구(관악구청),49389,48152,97541,48770.5
20240725,2호선,봉천,26588,25098,51686,25843
20240725,2호선,신림,59061,56632,115693,57846.5
20240725,2호선,신대방,26608,25669,52277,26138.5
20240725,2호선,구로디지털단지,63243,62799,126042,63021
20240725,2호선,대림(구로구청),25212,25741,50953,25476.5
20240725,2호선,신도림,55006,52879,107885,53942.5
20240725,2호선,문래,25764,26402,52166,26083
20240725,2호선,영등포구청,25179,25793,50972,25486
20240725,2호선,당산,19385,22652,42037,21018.5
20240725,2호선,합정,34820,37315,72135,36067.5
20240725,2호선,홍대입구,74614,79565,154179,77089.5
20240725,2호선,신촌,39389,39790,79179,39589.5
20240725,2호선,이대,16068,15996,32064,16032
20240725,2호선,아현,12015,11170,23185,11592.5
20240725,2호선,충정로(경기대입구),11558,12121,23679,11839.5
20240725,2호선,신답,1805,2055,3860,1930
20240725,2호선,신설동,3814,3708,7522,3761
20240725,2호선,도림천,1519,1545,3064,1532
20240725,2호선,양천구청,7326,7718,15044,7522
20240725,2호선,신정네거리,10811,11225,22036,11018
20240725,2호선,용두(동대문구청),2726,2783,5509,2754.5
20240725,3호선,지축,8342,8081,16423,8211.5
20240725,3호선,구파발,24289,23541,47830,23915
20240725,3호선,연신내,36521,34720,71241,35620.5
20240725,3호선,불광,18128,19289,37417,18708.5
20240725,3호선,녹번,16733,15325,32058,16029
20240725,3호선,홍제,18874,17773,36647,18323.5
20240725,3호선,무악재,4971,4857,9828,4914
20240725,3호선,독립문,7829,7779,15608,7804
20240725,3호선,경복궁(정부서울청사),25098,25193,50291,25145.5
20240725,3호선,안국,27948,28859,56807,28403.5
20240725,3호선,종로3가,13290,14041,27331,13665.5
20240725,3호선,을지로3가,13441,13246,26687,13343.5
20240725,3호선,충무로,8,0,8,4
20240725,3호선,동대입구,9530,10194,19724,9862
20240725,3호선,약수,13679,13560,27239,13619.5
20240725,3호선,금호,8715,8142,16857,8428.5
20240725,3호선,옥수,9460,9715,19175,9587.5
20240725,3호선,압구정,34869,36773,71642,35821
20240725,3호선,신사,30888,32017,62905,31452.5
20240725,3호선,잠원,5495,5242,10737,5368.5
20240725,3호선,고속터미널,49943,47040,96983,48491.5
20240725,3호선,교대(법원.검찰청),19720,11659,31379,15689.5
20240725,3호선,남부터미널(예술의전당),32185,32697,64882,32441
20240725,3호선,양재(서초구청),41528,44726,86254,43127
20240725,3호선,매봉,14201,13799,28000,14000
20240725,3호선,도곡,6189,5904,12093,6046.5
20240725,3호선,대치,14177,13775,27952,13976
20240725,3호선,학여울,2668,2714,5382,2691
20240725,3호선,대청,11681,11019,22700,11350
20240725,3호선,일원,11952,11993,23945,11972.5
20240725,3호선,수서,19803,19900,39703,19851.5
20240725,3호선,가락시장,10214,9786,20000,10000
20240725,3호선,경찰병원,8634,8677,17311,8655.5
20240725,3호선,오금,7321,6437,13758,6879
20240725,4호선,당고개,10325,8935,19260,9630
20240725,4호선,상계,20381,18950,39331,19665.5
20240725,4호선,노원,30178,33467,63645,31822.5
20240725,4호선,창동,27952,29560,57512,28756
20240725,4호선,쌍문,31186,28995,60181,30090.5
20240725,4호선,수유(강북구청),35713,35874,71587,35793.5
20240725,4호선,미아(서울사이버대학),16189,15773,31962,15981
20240725,4호선,미아사거리,28018,27868,55886,27943
20240725,4호선,길음,22863,22069,44932,22466
20240725,4호선,성신여대입구(돈암),21990,21470,43460,21730
20240725,4호선,한성대입구(삼선교),13781,13415,27196,13598
20240725,4호선,혜화,37985,38367,76352,38176
20240725,4호선,동대문,22435,22943,45378,22689
20240725,4호선,동대문역사문화공원(DDP),21255,18987,40242,20121
20240725,4호선,충무로,33437,34146,67583,33791.5
20240725,4호선,명동,34951,36448,71399,35699.5
20240725,4호선,회현(남대문시장),29704,30652,60356,30178
20240725,4호선,서울역,14744,24887,39631,19815.5
20240725,4호선,숙대입구(갈월),15005,14687,29692,14846
20240725,4호선,삼각지,7034,7628,14662,7331
20240725,4호선,신용산,23127,24760,47887,23943.5
20240725,4호선,이촌(국립중앙박물관),9110,10009,19119,9559.5
20240725,4호선,동작(현충원),1358,1500,2858,1429
20240725,4호선,총신대입구(이수),20163,21814,41977,20988.5
20240725,4호선,사당,28221,24366,52587,26293.5
20240725,4호선,남태령,1404,1253,2657,1328.5
20240725,5호선,방화,7543,7210,14753,7376.5
20240725,5호선,개화산,6640,6316,12956,6478
20240725,5호선,김포공항,11797,8704,20501,10250.5
20240725,5호선,송정,6837,6442,13279,6639.5
20240725,5호선,마곡,13520,13818,27338,13669
20240725,5호선,발산,25178,25684,50862,25431
20240725,5호선,우장산,15442,15420,30862,15431
20240725,5호선,화곡,30505,28437,58942,29471
20240725,5호선,까치산,29711,28486,58197,29098.5
20240725,5호선,신정(은행정),14475,12204,26679,13339.5
20240725,5호선,목동,18125,19531,37656,18828
20240725,5호선,오목교(목동운동장앞),22902,24261,47163,23581.5
20240725,5호선,양평,8794,8498,17292,8646
20240725,5호선,영등포구청,5244,5253,10497,5248.5
20240725,5호선,영등포시장,12299,12510,24809,12404.5
20240725,5호선,신길,5392,5616,11008,5504
20240725,5호선,여의도,33431,34833,68264,34132
20240725,5호선,여의나루,12901,14654,27555,13777.5
20240725,5호선,마포,16647,17001,33648,16824
20240725,5호선,공덕,16323,17322,33645,16822.5
20240725,5호선,애오개,7900,7839,15739,7869.5
20240725,5호선,충정로(경기대입구),5494,5649,11143,5571.5
20240725,5호선,서대문,22328,22896,45224,22612
20240725,5호선,광화문(세종문화회관),37180,38783,75963,37981.5
20240725,5호선,종로3가,16563,16362,32925,16462.5
20240725,5호선,을지로4가,7188,7200,14388,7194
20240725,5호선,동대문역사문화공원(DDP),3611,4110,7721,3860.5
20240725,5호선,청구,4305,4061,8366,4183
20240725,5호선,신금호,6881,7262,14143,7071.5
20240725,5호선,행당,8821,7821,16642,8321
20240725,5호선,왕십리(성동구청),5005,5683,10688,5344
20240725,5호선,마장,6245,5869,12114,6057
20240725,5호선,답십리,17345,15732,33077,16538.5
20240725,5호선,장한평,21651,21416,43067,21533.5
20240725,5호선,군자(능동),12127,13176,25303,12651.5
20240725,5호선,아차산(어린이대공원후문),14868,14739,29607,14803.5
20240725,5호선,광나루(장신대),13991,12934,26925,13462.5
20240725,5호선,천호(풍납토성),20871,20638,41509,20754.5
20240725,5호선,강동,19876,19260,39136,19568
20240725,5호선,길동,9061,9263,18324,9162
20240725,5호선,굽은다리(강동구민회관앞),10902,10559,21461,10730.5
20240725,5호선,명일,9273,9581,18854,9427
20240725,5호선,고덕,11733,11452,23185,11592.5
20240725,5호선,상일동,16351,15478,31829,15914.5
20240725,5호선,둔촌동,10926,11215,22141,11070.5
20240725,5호선,올림픽공원(한국체대),5727,4780,10507,5253.5
20240725,5호선,방이,8141,8516,16657,8328.5
20240725,5호선,오금,3861,3962,7823,3911.5
20240725,5호선,개롱,7277,7495,14772,7386
20240725,5호선,거여,10877,10658,21535,10767.5
20240725,5호선,마천,8060,7256,15316,7658
20240725,5호선,강일,6429,6009,12438,6219
20240725,5호선,미사,19105,19382,38487,19243.5
20240725,5호선,하남풍산,4905,4892,9797,4898.5
20240725,5호선,하남시청(덕풍·신장),8752,8339,17091,8545.5
20240725,5호선,하남검단산,6709,6327,13036,6518
20240725,6호선,응암,18830,18586,37416,18708
20240725,6호선,역촌,4212,4809,9021,4510.5
20240725,6호선,불광,5356,5088,10444,5222
20240725,6호선,독바위,3091,3223,6314,3157
20240725,6호선,연신내,1,0,1,0.5
20240725,6호선,구산,8908,7079,15987,7993.5
20240725,6호선,새절(신사),14068,12792,26860,13430
20240725,6호선,증산(명지대앞),10405,10483,20888,10444
20240725,6호선,디지털미디어시티,16019,17603,33622,16811
20240725,6호선,월드컵경기장(성산),4685,4747,9432,4716
20240725,6호선,마포구청,16193,14674,30867,15433.5
20240725,6호선,망원,16442,17332,33774,16887
20240725,6호선,합정,14516,14254,28770,14385
20240725,6호선,상수,10546,11356,21902,10951
20240725,6호선,광흥창(서강),10383,10105,20488,10244
20240725,6호선,대흥(서강대앞),9447,9965,19412,9706
20240725,6호선,공덕,20927,20705,41632,20816
20240725,6호선,효창공원앞,7961,7008,14969,7484.5
20240725,6호선,삼각지,7838,6910,14748,7374
20240725,6호선,녹사평(용산구청),5135,5103,10238,5119
20240725,6호선,이태원,10738,11558,22296,11148
20240725,6호선,한강진,9858,11492,21350,10675
20240725,6호선,버티고개,2291,2365,4656,2328
20240725,6호선,약수,4194,3928,8122,4061
20240725,6호선,청구,4328,4290,8618,4309
20240725,6호선,신당,9556,9807,19363,9681.5
20240725,6호선,동묘앞,8458,8757,17215,8607.5
20240725,6호선,창신,3675,2918,6593,3296.5
20240725,6호선,보문,8378,7721,16099,8049.5
20240725,6호선,안암(고대병원앞),11873,11585,23458,11729
20240725,6호선,고려대(종암),8958,8573,17531,8765.5
20240725,6호선,월곡(동덕여대),12609,12289,24898,12449
20240725,6호선,상월곡(한국과학기술연구원),7218,6883,14101,7050.5
20240725,6호선,돌곶이,10995,10190,21185,10592.5
20240725,6호선,석계,13158,13630,26788,13394
20240725,6호선,태릉입구,6059,6633,12692,6346
20240725,6호선,화랑대(서울여대입구),12298,9591,21889,10944.5
20240725,6호선,봉화산(서울의료원),9933,9187,19120,9560
20240725,7호선,장암,3129,1340,4469,2234.5
20240725,7호선,도봉산,9469,10828,20297,10148.5
20240725,7호선,수락산,13381,13298,26679,13339.5
20240725,7호선,마들,14295,13493,27788,13894
20240725,7호선,노원,26249,27059,53308,26654
20240725,7호선,중계,15390,14217,29607,14803.5
20240725,7호선,하계,19155,18024,37179,18589.5
20240725,7호선,공릉(서울과학기술대),12396,12287,24683,12341.5
20240725,7호선,태릉입구,9243,8492,17735,8867.5
20240725,7호선,먹골,11035,10938,21973,10986.5
20240725,7호선,중화,11213,10915,22128,11064
20240725,7호선,상봉,18693,17831,36524,18262
20240725,7호선,면목,15859,15229,31088,15544
20240725,7호선,사가정,17242,17293,34535,17267.5
20240725,7호선,용마산(용마폭포공원),6077,5945,12022,6011
20240725,7호선,중곡,11581,11079,22660,11330
20240725,7호선,군자(능동),16702,13365,30067,15033.5
20240725,7호선,어린이대공원(세종대),14523,14300,28823,14411.5
20240725,7호선,건대입구,13697,14054,27751,13875.5
20240725,7호선,자양(뚝섬한강공원),9441,9278,18719,9359.5
20240725,7호선,청담,20753,23117,43870,21935
20240725,7호선,강남구청,18259,20211,38470,19235
20240725,7호선,학동,27119,28265,55384,27692
20240725,7호선,논현,20718,21440,42158,21079
20240725,7호선,반포,6971,6709,13680,6840
20240725,7호선,고속터미널,17700,15162,32862,16431
20240725,7호선,내방,16398,16486,32884,16442
20240725,7호선,이수,18007,17652,35659,17829.5
20240725,7호선,남성,12375,11775,24150,12075
20240725,7호선,숭실대입구(살피재),13276,13145,26421,13210.5
20240725,7호선,상도,12098,11733,23831,11915.5
20240725,7호선,장승배기,10113,9943,20056,10028
20240725,7호선,신대방삼거리,16290,15689,31979,15989.5
20240725,7호선,보라매,7161,7423,14584,7292
20240725,7호선,신풍,12160,11384,23544,11772
20240725,7호선,대림(구로구청),9148,9287,18435,9217.5
20240725,7호선,남구로,16115,17052,33167,16583.5
20240725,7호선,가산디지털단지,50872,51220,102092,51046
20240725,7호선,철산,23410,23782,47192,23596
20240725,7호선,광명사거리,21487,21068,42555,21277.5
20240725,7호선,천왕,12692,12310,25002,12501
20240725,7호선,온수(성공회대입구),10360,9316,19676,9838
20240725,8호선,암사,20464,18175,38639,19319.5
20240725,8호선,천호(풍납토성),16540,18378,34918,17459
20240725,8호선,강동구청,11498,11921,23419,11709.5
20240725,8호선,몽촌토성(평화의문),7304,7462,14766,7383
20240725,8호선,잠실(송파구청),18081,20546,38627,19313.5
20240725,8호선,석촌,8740,10057,18797,9398.5
20240725,8호선,송파,10324,10219,20543,10271.5
20240725,8호선,가락시장,8570,9497,18067,9033.5
20240725,8호선,문정,24754,26213,50967,25483.5
20240725,8호선,장지,18569,17183,35752,17876
20240725,8호선,복정,10161,8401,18562,9281
20240725,8호선,산성,6722,6889,13611,6805.5
20240725,8호선,남한산성입구(성남법원.검찰청),13594,12201,25795,12897.5
20240725,8호선,단대오거리,12637,12321,24958,12479
20240725,8호선,신흥,5492,5682,11174,5587
20240725,8호선,수진,5662,5357,11019,5509.5
20240725,8호선,모란,5056,3822,8878,4439
20240725,8호선,남위례,7702,7743,15445,7722.5
20240725,9호선,개화,3114,2055,5169,2584.5
20240725,9호선,김포공항,7533,10946,18479,9239.5
20240725,9호선,공항시장,3300,3611,6911,3455.5
20240725,9호선,신방화,7680,7570,15250,7625
20240725,9호선,마곡나루(서울식물원),15636,15173,30809,15404.5
20240725,9호선,양천향교,11114,11324,22438,11219
20240725,9호선,가양,24138,23592,47730,23865
20240725,9호선,증미,9276,9048,18324,9162
20240725,9호선,등촌,13932,13318,27250,13625
20240725,9호선,염창,19610,18732,38342,19171
20240725,9호선,신목동,5038,4523,9561,4780.5
20240725,9호선,선유도,10230,9679,19909,9954.5
20240725,9호선,당산,22167,21633,43800,21900
20240725,9호선,국회의사당,18949,19576,38525,19262.5
20240725,9호선,여의도,35053,34014,69067,34533.5
20240725,9호선,샛강,7664,7541,15205,7602.5
20240725,9호선,노량진,27297,26607,53904,26952
20240725,9호선,노들,5235,4388,9623,4811.5
20240725,9호선,흑석(중앙대입구),9197,9537,18734,9367
20240725,9호선,동작(현충원),2032,1645,3677,1838.5
20240725,9호선,구반포,1719,1688,3407,1703.5
20240725,9호선,신반포,4404,4338,8742,4371
20240725,9호선,고속터미널,15791,21430,37221,18610.5
20240725,9호선,사평,4408,4368,8776,4388
20240725,9호선,신논현,34976,34847,69823,34911.5
20240725,9호선2~3단계,언주,13590,13852,27442,13721
20240725,9호선2~3단계,선정릉,11465,12160,23625,11812.5
20240725,9호선2~3단계,삼성중앙,9295,9559,18854,9427
20240725,9호선2~3단계,봉은사,27670,29238,56908,28454
20240725,9호선2~3단계,종합운동장,5513,5642,11155,5577.5
20240725,9호선2~3단계,삼전,8927,8446,17373,8686.5
20240725,9호선2~3단계,석촌고분,8126,8087,16213,8106.5
20240725,9호선2~3단계,석촌,10546,9270,19816,9908
20240725,9호선2~3단계,송파나루,6487,6974,13461,6730.5
20240725,9호선2~3단계,한성백제,3309,3027,6336,3168
20240725,9호선2~3단계,올림픽공원(한국체대),5698,5830,11528,5764
20240725,9호선2~3단계,둔촌오륜,1371,1384,2755,1377.5
20240725,9호선2~3단계,중앙보훈병원,13800,12313,26113,13056.5
20240725,경강선,판교,6426,6214,12640,6320
20240725,경강선,이매,1134,1017,2151,1075.5
20240725,경강선,삼동,2737,2599,5336,2668
20240725,경강선,경기광주,8311,7806,16117,8058.5
20240725,경강선,초월,3673,3484,7157,3578.5
20240725,경강선,곤지암,2231,2186,4417,2208.5
20240725,경강선,신둔도예촌,1512,1438,2950,1475
20240725,경강선,이천,2961,3142,6103,3051.5
20240725,경강선,부발,2264,2258,4522,2261
20240725,경강선,세종대왕릉,335,357,692,346
20240725,경강선,여주,2769,2881,5650,2825
20240725,경강선,성남,1098,974,2072,1036
20240725,경부선,서울역,9601,3758,13359,6679.5
20240725,경부선,남영,10135,10585,20720,10360
20240725,경부선,용산,43420,44706,88126,44063
20240725,경부선,노량진,7959,7890,15849,7924.5
20240725,경부선,대방,10962,11976,22938,11469
20240725,경부선,영등포,43387,43839,87226,43613
20240725,경부선,신도림,4133,4432,8565,4282.5
20240725,경부선,신길,9237,7838,17075,8537.5
20240725,경부선,구로,18593,18890,37483,18741.5
20240725,경부선,가산디지털단지,19521,22353,41874,20937
20240725,경부선,금천구청,11680,11999,23679,11839.5
20240725,경부선,석수,9182,8322,17504,8752
20240725,경부선,관악,7679,7456,15135,7567.5
20240725,경부선,안양,21940,21848,43788,21894
20240725,경부선,명학,9338,9096,18434,9217
20240725,경부선,금정,29891,30314,60205,30102.5
20240725,경부선,군포,7764,7549,15313,7656.5
20240725,경부선,의왕,9531,9308,18839,9419.5
20240725,경부선,성균관대,15478,15191,30669,15334.5
20240725,경부선,화서,12112,11759,23871,11935.5
20240725,경부선,수원,36064,38302,74366,37183
20240725,경부선,독산,19102,19671,38773,19386.5
20240725,경부선,세류,3563,3303,6866,3433
20240725,경부선,병점,14934,14693,29627,14813.5
20240725,경부선,세마,3403,3155,6558,3279
20240725,경부선,오산대,3671,3353,7024,3512
20240725,경부선,오산,9954,10148,20102,10051
20240725,경부선,진위,1672,1565,3237,1618.5
20240725,경부선,송탄,4351,4170,8521,4260.5
20240725,경부선,서정리,8167,7617,15784,7892
20240725,경부선,평택지제,4106,4010,8116,4058
20240725,경부선,평택,12032,11711,23743,11871.5
20240725,경부선,성환,3721,3681,7402,3701
20240725,경부선,직산,992,1003,1995,997.5
20240725,경부선,두정,6566,6612,13178,6589
20240725,경부선,천안,5742,5844,11586,5793
20240725,경부선,당정,6371,6021,12392,6196
20240725,경부선,서동탄,1668,1330,2998,1499
20240725,경부선,광명,3893,3393,7286,3643
20240725,경원선,이촌(국립중앙박물관),4373,3412,7785,3892.5
20240725,경원선,서빙고,2283,2157,4440,2220
20240725,경원선,한남,4274,4176,8450,4225
20240725,경원선,옥수,46,51,97,48.5
20240725,경원선,응봉,1973,1672,3645,1822.5
20240725,경원선,왕십리(성동구청),17657,17941,35598,17799
20240725,경원선,청량리(서울시립대입구),16692,17952,34644,17322
20240725,경원선,외대앞,8741,8427,17168,8584
20240725,경원선,신이문,9115,8424,17539,8769.5
20240725,경원선,석계,7819,8810,16629,8314.5
20240725,경원선,광운대,8262,7736,15998,7999
20240725,경원선,월계,6819,6249,13068,6534
20240725,경원선,녹천,4861,4087,8948,4474
20240725,경원선,창동,2,0,2,1
20240725,경원선,방학,10502,10217,20719,10359.5
20240725,경원선,도봉,6832,6479,13311,6655.5
20240725,경원선,도봉산,7856,4981,12837,6418.5
20240725,경원선,망월사,7751,7726,15477,7738.5
20240725,경원선,회룡,13830,13543,27373,13686.5
20240725,경원선,의정부,19436,19602,39038,19519
20240725,경원선,가능,6631,6680,13311,6655.5
20240725,경원선,녹양,4787,4488,9275,4637.5
20240725,경원선,양주,7623,7120,14743,7371.5
20240725,경원선,덕계,6313,5738,12051,6025.5
20240725,경원선,덕정,6126,5756,11882,5941
20240725,경원선,지행,6659,6722,13381,6690.5
20240725,경원선,동두천중앙,3222,3161,6383,3191.5
20240725,경원선,보산,1410,1381,2791,1395.5
20240725,경원선,동두천,1767,1731,3498,1749
20240725,경원선,소요산,1846,1838,3684,1842
20240725,경원선,청산,167,140,307,153.5
20240725,경원선,전곡,1029,962,1991,995.5
20240725,경원선,연천,1127,1167,2294,1147
20240725,경의선,서울역,5033,6381,11414,5707
20240725,경의선,신촌,1068,1367,2435,1217.5
20240725,경의선,효창공원앞,3496,3934,7430,3715
20240725,경의선,공덕,4680,3872,8552,4276
20240725,경의선,서강대,2258,2150,4408,2204
20240725,경의선,홍대입구,2197,2789,4986,2493
20240725,경의선,가좌,6282,5990,12272,6136
20240725,경의선,디지털미디어시티,2908,2735,5643,2821.5
20240725,경의선,수색,3701,3763,7464,3732
20240725,경의선,한국항공대,2032,1753,3785,1892.5
20240725,경의선,강매,3544,2955,6499,3249.5
20240725,경의선,행신,8778,8701,17479,8739.5
20240725,경의선,능곡,5037,4703,9740,4870
20240725,경의선,곡산,727,753,1480,740
20240725,경의선,백마,7881,7654,15535,7767.5
20240725,경의선,풍산,6675,6390,13065,6532.5
20240725,경의선,일산,11135,10869,22004,11002
20240725,경의선,탄현,8180,8047,16227,8113.5
20240725,경의선,야당,9203,9319,18522,9261
20240725,경의선,운정,8163,7570,15733,7866.5
20240725,경의선,금릉,5913,5513,11426,5713
20240725,경의선,금촌,6728,6406,13134,6567
20240725,경의선,월롱,2063,1754,3817,1908.5
20240725,경의선,파주,1067,933,2000,1000
20240725,경의선,문산,5476,5549,11025,5512.5
20240725,경의선,임진강,17,24,41,20.5
20240725,경의선,운천,7,3,10,5
20240725,경인선,개봉,22703,22599,45302,22651
20240725,경인선,오류동,12591,11543,24134,12067
20240725,경인선,역곡,27100,27144,54244,27122
20240725,경인선,부천,33128,32778,65906,32953
20240725,경인선,송내,28170,27766,55936,27968
20240725,경인선,부평,29848,31495,61343,30671.5
20240725,경인선,백운,8044,7791,15835,7917.5
20240725,경인선,동암,16391,16505,32896,16448
20240725,경인선,주안,19414,17400,36814,18407
20240725,경인선,제물포,10546,10291,20837,10418.5
20240725,경인선,동인천,14867,13835,28702,14351
20240725,경인선,인천,3855,3105,6960,3480
20240725,경인선,구일,6620,6512,13132,6566
20240725,경인선,소사,7701,7374,15075,7537.5
20240725,경인선,부개,9175,8705,17880,8940
20240725,경인선,간석,6177,5876,12053,6026.5
20240725,경인선,도원,2860,3009,5869,2934.5
20240725,경인선,온수(성공회대입구),6478,6147,12625,6312.5
20240725,경인선,중동,9764,9192,18956,9478
20240725,경인선,도화,4474,4103,8577,4288.5
20240725,경춘선,신내,2917,2642,5559,2779.5
20240725,경춘선,갈매,3111,2769,5880,2940
20240725,경춘선,별내,3665,3454,7119,3559.5
20240725,경춘선,퇴계원,3682,3366,7048,3524
20240725,경춘선,사릉,2155,2160,4315,2157.5
20240725,경춘선,금곡,1562,1481,3043,1521.5
20240725,경춘선,평내호평,6310,6141,12451,6225.5
20240725,경춘선,천마산,1537,1432,2969,1484.5
20240725,경춘선,마석,3618,3582,7200,3600
20240725,경춘선,대성리,991,816,1807,903.5
20240725,경춘선,청평,1898,1888,3786,1893
20240725,경춘선,상천,266,255,521,260.5
20240725,경춘선,가평,2411,2606,5017,2508.5
20240725,경춘선,굴봉산,166,160,326,163
20240725,경춘선,백양리,89,76,165,82.5
20240725,경춘선,강촌,473,497,970,485
20240725,경춘선,김유정,402,380,782,391
20240725,경춘선,남춘천,2452,2600,5052,2526
20240725,경춘선,춘천,1487,1257,2744,1372
20240725,공항철도 1호선,서울역,14303,12881,27184,13592
20240725,공항철도 1호선,공덕,3393,4192,7585,3792.5
20240725,공항철도 1호선,홍대입구,16816,15709,32525,16262.5
20240725,공항철도 1호선,디지털미디어시티,15792,15047,30839,15419.5
20240725,공항철도 1호선,마곡나루(서울식물원),12434,11625,24059,12029.5
20240725,공항철도 1호선,김포공항,10756,6233,16989,8494.5
20240725,공항철도 1호선,계양,14654,13773,28427,14213.5
20240725,공항철도 1호선,검암,7020,7079,14099,7049.5
20240725,공항철도 1호선,청라국제도시,8386,7838,16224,8112
20240725,공항철도 1호선,운서,10137,10295,20432,10216
20240725,공항철도 1호선,공항화물청사,2261,2453,4714,2357
20240725,공항철도 1호선,인천공항1터미널,15263,16751,32014,16007
20240725,공항철도 1호선,인천공항2터미널,7639,7324,14963,7481.5
20240725,공항철도 1호선,영종,4485,4590,9075,4537.5
20240725,과천선,선바위,8112,7365,15477,7738.5
20240725,과천선,경마공원,1348,1361,2709,1354.5
20240725,과천선,대공원,3055,3105,6160,3080
20240725,과천선,과천,7085,6601,13686,6843
20240725,과천선,정부과천청사,13640,14273,27913,13956.5
20240725,과천선,인덕원,26960,27994,54954,27477
20240725,과천선,평촌,19759,19305,39064,19532
20240725,과천선,범계,29008,28976,57984,28992
20240725,분당선,선릉,15356,23337,38693,19346.5
20240725,분당선,한티,18017,19197,37214,18607
20240725,분당선,도곡,8183,8559,16742,8371
20240725,분당선,구룡,3814,3787,7601,3800.5
20240725,분당선,개포동,4902,5010,9912,4956
20240725,분당선,대모산입구,6495,6145,12640,6320
20240725,분당선,수서,18085,18954,37039,18519.5
20240725,분당선,복정,6,0,6,3
20240725,분당선,수원,8220,7598,15818,7909
20240725,분당선,서울숲,13865,13981,27846,13923
20240725,분당선,압구정로데오,23102,25036,48138,24069
20240725,분당선,강남구청,10723,12613,23336,11668
20240725,분당선,선정릉,9030,9423,18453,9226.5
20240725,분당선,가천대,6671,7041,13712,6856
20240725,분당선,태평,14057,13422,27479,13739.5
20240725,분당선,모란,20940,20818,41758,20879
20240725,분당선,야탑,27868,29295,57163,28581.5
20240725,분당선,서현,26419,26813,53232,26616
20240725,분당선,수내,15735,15984,31719,15859.5
20240725,분당선,정자,20525,21500,42025,21012.5
20240725,분당선,미금,16599,17344,33943,16971.5
20240725,분당선,오리,12754,10920,23674,11837
20240725,분당선,이매,5738,5742,11480,5740
20240725,분당선,보정,2637,2373,5010,2505
20240725,분당선,죽전,13421,14849,28270,14135
20240725,분당선,구성,6685,6884,13569,6784.5
20240725,분당선,신갈,5322,5151,10473,5236.5
20240725,분당선,기흥,11440,10281,21721,10860.5
20240725,분당선,상갈,5757,5484,11241,5620.5
20240725,분당선,청명,4839,4696,9535,4767.5
20240725,분당선,영통,9278,9353,18631,9315.5
20240725,분당선,망포,16684,15872,32556,16278
20240725,분당선,매탄권선,5627,5517,11144,5572
20240725,분당선,수원시청,14654,15567,30221,15110.5
20240725,분당선,매교,5299,5161,10460,5230
20240725,서해선,김포공항,3269,4050,7319,3659.5
20240725,서해선,원종,4993,4999,9992,4996
20240725,서해선,부천종합운동장,2826,2383,5209,2604.5
20240725,수인선,오목천,3964,3634,7598,3799
20240725,수인선,어천,1493,1471,2964,1482
20240725,수인선,야목,460,388,848,424
20240725,수인선,사리,5232,4525,9757,4878.5
20240725,수인선,달월,132,82,214,107
20240725,수인선,월곶,3420,3162,6582,3291
20240725,수인선,소래포구,4866,4512,9378,4689
20240725,수인선,인천논현,5914,6175,12089,6044.5
20240725,수인선,호구포,4258,4406,8664,4332
20240725,수인선,남동인더스파크,2686,3024,5710,2855
20240725,수인선,원인재,4568,4756,9324,4662
20240725,수인선,연수,4986,4795,9781,4890.5
20240725,수인선,송도,2507,2303,4810,2405
20240725,수인선,인하대,6861,6304,13165,6582.5
20240725,수인선,숭의,4337,3994,8331,4165.5
20240725,수인선,신포,1925,1834,3759,1879.5
20240725,수인선,인천,1170,1846,3016,1508
20240725,신림선,샛강,3174,3751,6925,3462.5
20240725,신림선,대방,3041,2445,5486,2743
20240725,신림선,서울지방병무청,3604,3938,7542,3771
20240725,신림선,보라매,4601,4144,8745,4372.5
20240725,신림선,보라매공원,2545,2718,5263,2631.5
20240725,신림선,보라매병원,9161,9686,18847,9423.5
20240725,신림선,당곡,5498,5404,10902,5451
20240725,신림선,신림,2145,2887,5032,2516
20240725,신림선,서원,3926,3530,7456,3728
20240725,신림선,서울대벤처타운,10052,9381,19433,9716.5
20240725,신림선,관악산(서울대),3149,3124,6273,3136.5
20240725,안산선,산본,17241,18129,35370,17685
20240725,안산선,대야미,5222,4591,9813,4906.5
20240725,안산선,반월,4369,4171,8540,4270
20240725,안산선,상록수,15301,15799,31100,15550
20240725,안산선,한대앞,9192,9263,18455,9227.5
20240725,안산선,중앙,18861,19829,38690,19345
20240725,안산선,고잔,9286,8901,18187,9093.5
20240725,안산선,초지,5321,5385,10706,5353
20240725,안산선,안산,12175,11213,23388,11694
20240725,안산선,신길온천,2138,1915,4053,2026.5
20240725,안산선,정왕,9094,9153,18247,9123.5
20240725,안산선,오이도,8274,8093,16367,8183.5
20240725,안산선,수리산,4336,3524,7860,3930
20240725,우이신설선,북한산우이,3012,2786,5798,2899
20240725,우이신설선,솔밭공원,2897,2733,5630,2815
20240725,우이신설선,4.19민주묘지,3290,3101,6391,3195.5
20240725,우이신설선,가오리,4810,4771,9581,4790.5
20240725,우이신설선,화계,3819,3741,7560,3780
20240725,우이신설선,삼양,2304,2347,4651,2325.5
20240725,우이신설선,삼양사거리,2752,2800,5552,2776
20240725,우이신설선,솔샘,6339,6015,12354,6177
20240725,우이신설선,북한산보국문,6425,6249,12674,6337
20240725,우이신설선,정릉,5048,4673,9721,4860.5
20240725,우이신설선,성신여대입구(돈암),3826,4205,8031,4015.5
20240725,우이신설선,보문,1737,1712,3449,1724.5
20240725,우이신설선,신설동,2437,2394,4831,2415.5
20240725,일산선,원흥,12605,11984,24589,12294.5
20240725,일산선,삼송,20390,19455,39845,19922.5
20240725,일산선,원당,11665,11123,22788,11394
20240725,일산선,화정,18253,18912,37165,18582.5
20240725,일산선,대곡,3116,2442,5558,2779
20240725,일산선,백석,11105,11165,22270,11135
20240725,일산선,마두,8645,8912,17557,8778.5
20240725,일산선,정발산,7591,7698,15289,7644.5
20240725,일산선,주엽,10678,10901,21579,10789.5
20240725,일산선,대화,14223,11156,25379,12689.5
20240725,장항선,봉명,1512,1443,2955,1477.5
20240725,장항선,쌍용(나사렛대),2332,2143,4475,2237.5
20240725,장항선,아산,3490,3264,6754,3377
20240725,장항선,탕정,1730,1554,3284,1642
20240725,장항선,배방,1242,1187,2429,1214.5
20240725,장항선,온양온천,4204,4127,8331,4165.5
20240725,장항선,신창(순천향대),1135,1088,2223,1111.5
20240725,중앙선,회기,25630,24261,49891,24945.5
20240725,중앙선,중랑,5895,5527,11422,5711
20240725,중앙선,상봉,6053,6075,12128,6064
20240725,중앙선,망우,8057,7831,15888,7944
20240725,중앙선,양원,3128,3142,6270,3135
20240726,중앙선,용문,2040,2327,4367,2183.5
20240726,1호선,서울역,62593,60493,123086,61543
20240726,1호선,시청,27296,27597,54893,27446.5
20240726,1호선,종각,43291,43313,86604,43302
20240726,1호선,종로3가,27017,25570,52587,26293.5
20240726,1호선,종로5가,25938,25273,51211,25605.5
20240726,1호선,동대문,12089,11004,23093,11546.5
20240726,1호선,신설동,15600,15122,30722,15361
20240726,1호선,제기동,17081,16730,33811,16905.5
20240726,1호선,청량리(서울시립대입구),23742,23610,47352,23676
20240726,1호선,동묘앞,8933,9024,17957,8978.5
20240726,2호선,시청,29603,28578,58181,29090.5
20240726,2호선,을지로입구,52680,54128,106808,53404
20240726,2호선,을지로3가,28251,28530,56781,28390.5
20240726,2호선,을지로4가,16093,15865,31958,15979
20240726,2호선,동대문역사문화공원(DDP),15809,17627,33436,16718
20240726,2호선,신당,16041,17051,33092,16546
20240726,2호선,상왕십리,15594,15284,30878,15439
20240726,2호선,왕십리(성동구청),16803,15874,32677,16338.5
20240726,2호선,한양대,8870,9025,17895,8947.5
20240726,2호선,뚝섬,27644,29039,56683,28341.5
20240726,2호선,성수,48629,52650,101279,50639.5
20240726,2호선,건대입구,37934,41045,78979,39489.5
20240726,2호선,구의(광진구청),27164,26153,53317,26658.5
20240726,2호선,강변(동서울터미널),33685,34227,67912,33956
20240726,2호선,잠실나루,16126,15272,31398,15699
20240726,2호선,잠실(송파구청),89158,87888,177046,88523
20240726,2호선,잠실새내,26535,26214,52749,26374.5
20240726,2호선,종합운동장,9679,10266,19945,9972.5
20240726,2호선,삼성(무역센터),65368,65154,130522,65261
20240726,2호선,선릉,65477,57590,123067,61533.5
20240726,2호선,역삼,57369,64343,121712,60856
20240726,2호선,강남,94644,93240,187884,93942
20240726,2호선,교대(법원.검찰청),35194,42188,77382,38691
20240726,2호선,서초,23421,22666,46087,23043.5
20240726,2호선,방배,16524,16975,33499,16749.5
20240726,2호선,사당,44751,48898,93649,46824.5
20240726,2호선,낙성대(강감찬),30523,28246,58769,29384.5
20240726,2호선,서울대입구(관악구청),50961,48272,99233,49616.5
20240726,2호선,봉천,26427,24116,50543,25271.5
20240726,2호선,신림,59768,56861,116629,58314.5
20240726,2호선,신대방,26766,25248,52014,26007
20240726,2호선,구로디지털단지,62712,62280,124992,62496
20240726,2호선,대림(구로구청),25258,25458,50716,25358
20240726,2호선,신도림,54933,53615,108548,54274
20240726,2호선,문래,26061,27037,53098,26549
20240726,2호선,영등포구청,24270,25002,49272,24636
20240726,2호선,당산,18999,22180,41179,20589.5
20240726,2호선,합정,37244,41785,79029,39514.5
20240726,2호선,홍대입구,76520,85186,161706,80853
20240726,2호선,신촌,38799,40164,78963,39481.5
20240726,2호선,이대,16231,17463,33694,16847
20240726,2호선,아현,11542,10527,22069,11034.5
20240726,2호선,충정로(경기대입구),10949,11655,22604,11302
20240726,2호선,용답,3108,2902,6010,3005
20240726,2호선,신답,1751,1935,3686,1843
20240726,2호선,신설동,4140,4039,8179,4089.5
20240726,2호선,도림천,1378,1431,2809,1404.5
20240726,2호선,양천구청,7142,7508,14650,7325
20240726,2호선,신정네거리,10865,11114,21979,10989.5
20240726,2호선,용두(동대문구청),2721,2736,5457,2728.5
20240726,3호선,지축,8035,7968,16003,8001.5
20240726,3호선,구파발,23709,22788,46497,23248.5
20240726,3호선,연신내,36465,34785,71250,35625
20240726,3호선,불광,17878,19043,36921,18460.5
20240726,3호선,녹번,16436,14518,30954,15477
20240726,3호선,홍제,19098,17954,37052,18526
20240726,3호선,무악재,4904,4614,9518,4759
20240726,3호선,독립문,7799,7658,15457,7728.5
20240726,3호선,경복궁(정부서울청사),24567,24261,48828,24414
20240726,3호선,안국,27571,28221,55792,27896
20240726,3호선,종로3가,13220,14966,28186,14093
20240726,3호선,을지로3가,13354,13687,27041,13520.5
20240726,3호선,충무로,23,0,23,11.5
20240726,3호선,동대입구,11460,11892,23352,11676
20240726,3호선,약수,13803,13841,27644,13822
20240726,3호선,금호,8682,7983,16665,8332.5
20240726,3호선,옥수,9471,9684,19155,9577.5
20240726,3호선,압구정,36339,38184,74523,37261.5
20240726,3호선,신사,32381,34250,66631,33315.5
20240726,3호선,잠원,5537,5240,10777,5388.5
20240726,3호선,고속터미널,56206,58358,114564,57282
20240726,3호선,교대(법원.검찰청),19314,11520,30834,15417
20240726,3호선,남부터미널(예술의전당),34029,34553,68582,34291
20240726,3호선,양재(서초구청),42122,43889,86011,43005.5
20240726,3호선,매봉,14214,13690,27904,13952
20240726,3호선,도곡,6227,6006,12233,6116.5
20240726,3호선,대치,14341,13798,28139,14069.5
20240726,3호선,학여울,2642,2630,5272,2636
20240726,3호선,대청,11665,10897,22562,11281
20240726,3호선,일원,12047,11378,23425,11712.5
20240726,3호선,수서,21260,20679,41939,20969.5
20240726,3호선,가락시장,10076,9738,19814,9907
20240726,3호선,경찰병원,8428,8353,16781,8390.5
20240726,3호선,오금,7380,6236,13616,6808
20240726,4호선,당고개,10189,8653,18842,9421
20240726,4호선,상계,20250,18850,39100,19550
20240726,4호선,노원,30098,34268,64366,32183
20240726,4호선,창동,27998,29718,57716,28858
20240726,4호선,쌍문,30974,28532,59506,29753
20240726,4호선,수유(강북구청),35731,35902,71633,35816.5
20240726,4호선,미아(서울사이버대학),16079,15337,31416,15708
20240726,4호선,미아사거리,28070,27871,55941,27970.5
20240726,4호선,길음,22431,21481,43912,21956
20240726,4호선,성신여대입구(돈암),22165,21497,43662,21831
20240726,4호선,한성대입구(삼선교),13775,12968,26743,13371.5
20240726,4호선,혜화,36844,37515,74359,37179.5
20240726,4호선,동대문,22243,21967,44210,22105
20240726,4호선,동대문역사문화공원(DDP),20674,17760,38434,19217
20240726,4호선,충무로,32448,33779,66227,33113.5
20240726,4호선,명동,33540,36644,70184,35092
20240726,4호선,회현(남대문시장),29246,29957,59203,29601.5
20240726,4호선,서울역,14360,25630,39990,19995
20240726,4호선,숙대입구(갈월),15141,14915,30056,15028
20240726,4호선,삼각지,6949,8078,15027,7513.5
20240726,4호선,신용산,22607,24653,47260,23630
20240726,4호선,이촌(국립중앙박물관),9966,10698,20664,10332
20240726,4호선,동작(현충원),1344,1449,2793,1396.5
20240726,4호선,총신대입구(이수),20465,22133,42598,21299
20240726,4호선,사당,28550,25189,53739,26869.5
20240726,4호선,남태령,1504,1203,2707,1353.5
20240726,5호선,방화,7362,7014,14376,7188
20240726,5호선,개화산,6586,6173,12759,6379.5
20240726,5호선,김포공항,12200,8711,20911,10455.5
20240726,5호선,송정,6919,6400,13319,6659.5
20240726,5호선,마곡,13381,13481,26862,13431
20240726,5호선,발산,23754,25015,48769,24384.5
20240726,5호선,우장산,15422,14983,30405,15202.5
20240726,5호선,화곡,30427,27830,58257,29128.5
20240726,5호선,까치산,29423,27897,57320,28660
20240726,5호선,신정(은행정),14467,11763,26230,13115
20240726,5호선,목동,18067,19250,37317,18658.5
20240726,5호선,오목교(목동운동장앞),22887,24352,47239,23619.5
20240726,5호선,양평,8509,8015,16524,8262
20240726,5호선,영등포구청,5012,4934,9946,4973
20240726,5호선,영등포시장,12715,12770,25485,12742.5
20240726,5호선,신길,5234,5242,10476,5238
20240726,5호선,여의도,32583,34295,66878,33439
20240726,5호선,여의나루,12014,14229,26243,13121.5
20240726,5호선,마포,16326,16469,32795,16397.5
20240726,5호선,공덕,15703,16812,32515,16257.5
20240726,5호선,애오개,7549,7311,14860,7430
20240726,5호선,충정로(경기대입구),5240,5163,10403,5201.5
20240726,5호선,서대문,21863,22119,43982,21991
20240726,5호선,광화문(세종문화회관),35223,37546,72769,36384.5
20240726,5호선,종로3가,16295,17403,33698,16849
20240726,5호선,을지로4가,6931,7214,14145,7072.5
20240726,5호선,동대문역사문화공원(DDP),3640,4207,7847,3923.5
20240726,5호선,청구,4111,4057,8168,4084
20240726,5호선,신금호,6719,6969,13688,6844
20240726,5호선,행당,8689,7580,16269,8134.5
20240726,5호선,왕십리(성동구청),5125,6042,11167,5583.5
20240726,5호선,마장,6137,5694,11831,5915.5
20240726,5호선,답십리,17174,15389,32563,16281.5
20240726,5호선,장한평,21385,21088,42473,21236.5
20240726,5호선,군자(능동),12128,13443,25571,12785.5
20240726,5호선,아차산(어린이대공원후문),14857,14402,29259,14629.5
20240726,5호선,광나루(장신대),13820,12328,26148,13074
20240726,5호선,천호(풍납토성),21530,21035,42565,21282.5
20240726,5호선,강동,19944,19116,39060,19530
20240726,5호선,길동,9256,9379,18635,9317.5
20240726,5호선,굽은다리(강동구민회관앞),11016,10615,21631,10815.5
20240726,5호선,명일,9281,9499,18780,9390
20240726,5호선,고덕,11367,11248,22615,11307.5
20240726,5호선,상일동,15650,14789,30439,15219.5
20240726,5호선,둔촌동,9616,9578,19194,9597
20240726,5호선,올림픽공원(한국체대),5660,4538,10198,5099
20240726,5호선,방이,7873,8139,16012,8006
20240726,5호선,오금,3839,3852,7691,3845.5
20240726,5호선,개롱,6922,7094,14016,7008
20240726,5호선,거여,10789,10381,21170,10585
20240726,5호선,마천,7909,7040,14949,7474.5
20240726,5호선,강일,6307,5719,12026,6013
20240726,5호선,미사,18898,19201,38099,19049.5
20240726,5호선,하남풍산,4672,4775,9447,4723.5
20240726,5호선,하남시청(덕풍·신장),8772,8222,16994,8497
20240726,5호선,하남검단산,6825,6409,13234,6617
20240726,6호선,응암,18756,18284,37040,18520
20240726,6호선,역촌,4287,4753,9040,4520
20240726,6호선,불광,5523,5066,10589,5294.5
20240726,6호선,독바위,3057,3119,6176,3088
20240726,6호선,연신내,9,0,9,4.5
20240726,6호선,구산,8795,6948,15743,7871.5
20240726,6호선,새절(신사),13581,12411,25992,12996
20240726,6호선,증산(명지대앞),10333,10213,20546,10273
20240726,6호선,디지털미디어시티,15585,16669,32254,16127
20240726,6호선,월드컵경기장(성산),4530,4816,9346,4673
20240726,6호선,마포구청,15911,14138,30049,15024.5
20240726,6호선,망원,16336,17416,33752,16876
20240726,6호선,합정,15171,15303,30474,15237
20240726,6호선,상수,10995,13036,24031,12015.5
20240726,6호선,광흥창(서강),10298,9939,20237,10118.5
20240726,6호선,대흥(서강대앞),9512,9730,19242,9621
20240726,6호선,공덕,21014,20599,41613,20806.5
20240726,6호선,효창공원앞,7863,6857,14720,7360
20240726,6호선,삼각지,7798,6961,14759,7379.5
20240726,6호선,녹사평(용산구청),5656,5970,11626,5813
20240726,6호선,이태원,11558,15364,26922,13461
20240726,6호선,한강진,10083,12096,22179,11089.5
20240726,6호선,버티고개,2361,2271,4632,2316
20240726,6호선,약수,4223,3918,8141,4070.5
20240726,6호선,청구,4237,4134,8371,4185.5
20240726,6호선,신당,9729,9083,18812,9406
20240726,6호선,동묘앞,8633,8446,17079,8539.5
20240726,6호선,창신,3562,2727,6289,3144.5
20240726,6호선,보문,8605,7566,16171,8085.5
20240726,6호선,안암(고대병원앞),11357,10962,22319,11159.5
20240726,6호선,고려대(종암),8952,8316,17268,8634
20240726,6호선,월곡(동덕여대),12493,11966,24459,12229.5
20240726,6호선,상월곡(한국과학기술연구원),6636,5840,12476,6238
20240726,6호선,돌곶이,10752,9806,20558,10279
20240726,6호선,석계,13070,13306,26376,13188
20240726,6호선,태릉입구,6127,6595,12722,6361
20240726,6호선,화랑대(서울여대입구),12266,9457,21723,10861.5
20240726,6호선,봉화산(서울의료원),9661,8896,18557,9278.5
20240726,6호선,신내,1,0,1,0.5
20240726,7호선,장암,2850,1248,4098,2049
20240726,7호선,도봉산,9226,10721,19947,9973.5
20240726,7호선,수락산,13236,12945,26181,13090.5
20240726,7호선,마들,14076,13101,27177,13588.5
20240726,7호선,노원,26257,27783,54040,27020
20240726,7호선,중계,14906,13366,28272,14136
20240726,7호선,하계,18545,17071,35616,17808
20240726,7호선,공릉(서울과학기술대),12525,12283,24808,12404
20240726,7호선,태릉입구,9382,8609,17991,8995.5
20240726,7호선,먹골,11029,10881,21910,10955
20240726,7호선,중화,11140,10811,21951,10975.5
20240726,7호선,상봉,19182,18598,37780,18890
20240726,7호선,면목,15760,14912,30672,15336
20240726,7호선,사가정,17157,17156,34313,17156.5
20240726,7호선,용마산(용마폭포공원),5976,5655,11631,5815.5
20240726,7호선,중곡,11491,11034,22525,11262.5
20240726,7호선,군자(능동),16856,13311,30167,15083.5
20240726,7호선,어린이대공원(세종대),14902,14198,29100,14550
20240726,7호선,건대입구,14062,14393,28455,14227.5
20240726,7호선,자양(뚝섬한강공원),9039,9026,18065,9032.5
20240726,7호선,청담,20252,22406,42658,21329
20240726,7호선,강남구청,17768,19785,37553,18776.5
20240726,7호선,학동,25867,26930,52797,26398.5
20240726,7호선,논현,20639,21698,42337,21168.5
20240726,7호선,반포,7017,6674,13691,6845.5
20240726,7호선,고속터미널,20076,16261,36337,18168.5
20240726,7호선,내방,16071,16034,32105,16052.5
20240726,7호선,이수,18467,18108,36575,18287.5
20240726,7호선,남성,12149,11215,23364,11682
20240726,7호선,숭실대입구(살피재),13357,12983,26340,13170
20240726,7호선,상도,12245,11509,23754,11877
20240726,7호선,장승배기,10139,9675,19814,9907
20240726,7호선,신대방삼거리,16303,15438,31741,15870.5
20240726,7호선,보라매,7257,7334,14591,7295.5
20240726,7호선,신풍,11914,11025,22939,11469.5
20240726,7호선,대림(구로구청),9045,9414,18459,9229.5
20240726,7호선,남구로,15714,16592,32306,16153
20240726,7호선,가산디지털단지,49318,48825,98143,49071.5
20240726,7호선,철산,23538,23970,47508,23754
20240726,7호선,광명사거리,21389,21218,42607,21303.5
20240726,7호선,천왕,12401,11709,24110,12055
20240726,7호선,온수(성공회대입구),10062,9006,19068,9534
20240726,8호선,암사,20459,17959,38418,19209
20240726,8호선,천호(풍납토성),17057,19286,36343,18171.5
20240726,8호선,강동구청,11189,11512,22701,11350.5
20240726,8호선,몽촌토성(평화의문),7318,7342,14660,7330
20240726,8호선,잠실(송파구청),18438,21402,39840,19920
20240726,8호선,석촌,8672,9967,18639,9319.5
20240726,8호선,송파,10270,10048,20318,10159
20240726,8호선,가락시장,8415,9588,18003,9001.5
20240726,8호선,문정,23976,24988,48964,24482
20240726,8호선,장지,18477,16917,35394,17697
20240726,8호선,복정,9998,8333,18331,9165.5
20240726,8호선,산성,6721,6645,13366,6683
20240726,8호선,남한산성입구(성남법원.검찰청),13510,11730,25240,12620
20240726,8호선,단대오거리,12591,11911,24502,12251
20240726,8호선,신흥,5541,5691,11232,5616
20240726,8호선,수진,5747,5282,11029,5514.5
20240726,8호선,모란,4983,3910,8893,4446.5
20240726,8호선,남위례,7492,7411,14903,7451.5
20240726,9호선,개화,3083,2140,5223,2611.5
20240726,9호선,김포공항,7621,11485,19106,9553
20240726,9호선,공항시장,3410,3549,6959,3479.5
20240726,9호선,신방화,7759,7568,15327,7663.5
20240726,9호선,마곡나루(서울식물원),15116,14805,29921,14960.5
20240726,9호선,양천향교,11302,10988,22290,11145
20240726,9호선,가양,24003,23115,47118,23559
20240726,9호선,증미,9047,8489,17536,8768
20240726,9호선,등촌,13784,12974,26758,13379
20240726,9호선,염창,19314,18340,37654,18827
20240726,9호선,신목동,4755,4244,8999,4499.5
20240726,9호선,선유도,9842,9113,18955,9477.5
20240726,9호선,당산,22162,21294,43456,21728
20240726,9호선,국회의사당,19130,19534,38664,19332
20240726,9호선,여의도,35472,33135,68607,34303.5
20240726,9호선,샛강,7293,7354,14647,7323.5
20240726,9호선,노량진,27636,26946,54582,27291
20240726,9호선,노들,5161,4251,9412,4706
20240726,9호선,흑석(중앙대입구),9259,9391,18650,9325
20240726,9호선,동작(현충원),1827,1469,3296,1648
20240726,9호선,구반포,1459,1446,2905,1452.5
20240726,9호선,신반포,4245,4125,8370,4185
20240726,9호선,고속터미널,17246,24903,42149,21074.5
20240726,9호선,사평,4417,4269,8686,4343
20240726,9호선,신논현,35899,37107,73006,36503
20240726,9호선2~3단계,언주,13755,13794,27549,13774.5
20240726,9호선2~3단계,선정릉,10776,11483,22259,11129.5
20240726,9호선2~3단계,삼성중앙,8751,8880,17631,8815.5
20240726,9호선2~3단계,봉은사,26620,27352,53972,26986
20240726,9호선2~3단계,종합운동장,5697,5668,11365,5682.5
20240726,9호선2~3단계,삼전,8924,8326,17250,8625
20240726,9호선2~3단계,석촌고분,8157,7839,15996,7998
20240726,9호선2~3단계,석촌,10586,9194,19780,9890
20240726,9호선2~3단계,송파나루,6416,7021,13437,6718.5
20240726,9호선2~3단계,한성백제,3259,2895,6154,3077
20240726,9호선2~3단계,올림픽공원(한국체대),5537,5804,11341,5670.5
20240726,9호선2~3단계,둔촌오륜,1304,1251,2555,1277.5
20240726,9호선2~3단계,중앙보훈병원,13431,11451,24882,12441
20240726,경강선,판교,6198,6195,12393,6196.5
20240726,경강선,이매,1136,951,2087,1043.5
20240726,경강선,삼동,2723,2467,5190,2595
20240726,경강선,경기광주,8533,7965,16498,8249
20240726,경강선,초월,3817,3437,7254,3627
20240726,경강선,곤지암,2475,2375,4850,2425
20240726,경강선,신둔도예촌,1622,1474,3096,1548
20240726,경강선,이천,3283,3560,6843,3421.5
20240726,경강선,부발,2863,2413,5276,2638
20240726,경강선,세종대왕릉,402,383,785,392.5
20240726,경강선,여주,2896,3219,6115,3057.5
20240726,경강선,성남,1138,1049,2187,1093.5
20240726,경부선,서울역,12014,4771,16785,8392.5
20240726,경부선,남영,10064,10418,20482,10241
20240726,경부선,용산,49057,50146,99203,49601.5
20240726,경부선,노량진,8444,8092,16536,8268
20240726,경부선,대방,10951,11823,22774,11387
20240726,경부선,영등포,46746,48397,95143,47571.5
20240726,경부선,신도림,4104,4489,8593,4296.5
20240726,경부선,신길,9125,7370,16495,8247.5
20240726,경부선,구로,18847,19085,37932,18966
20240726,경부선,가산디지털단지,18989,21526,40515,20257.5
20240726,경부선,금천구청,11471,11645,23116,11558
20240726,경부선,석수,9064,8096,17160,8580
20240726,경부선,관악,7680,7425,15105,7552.5
20240726,경부선,안양,22095,22247,44342,22171
20240726,경부선,명학,9031,8760,17791,8895.5
20240726,경부선,금정,30216,30669,60885,30442.5
20240726,경부선,군포,7641,7389,15030,7515
20240726,경부선,의왕,9526,9317,18843,9421.5
20240726,경부선,성균관대,15718,15217,30935,15467.5
20240726,경부선,화서,12522,12283,24805,12402.5
20240726,경부선,수원,39628,42961,82589,41294.5
20240726,경부선,독산,18634,19044,37678,18839
20240726,경부선,세류,3714,3350,7064,3532
20240726,경부선,병점,15690,15209,30899,15449.5
20240726,경부선,세마,3528,3211,6739,3369.5
20240726,경부선,오산대,3863,3631,7494,3747
20240726,경부선,오산,10803,10635,21438,10719
20240726,경부선,진위,1854,1608,3462,1731
20240726,경부선,송탄,4949,4484,9433,4716.5
20240726,경부선,서정리,9476,8045,17521,8760.5
20240726,경부선,평택지제,4884,4716,9600,4800
20240726,경부선,평택,14160,13381,27541,13770.5
20240726,경부선,성환,4417,3904,8321,4160.5
20240726,경부선,직산,1160,1069,2229,1114.5
20240726,경부선,두정,7552,7357,14909,7454.5
20240726,경부선,천안,6513,6837,13350,6675
20240726,경부선,당정,6273,6057,12330,6165
20240726,경부선,서동탄,1596,1406,3002,1501
20240726,경부선,광명,4400,3973,8373,4186.5
20240726,경원선,이촌(국립중앙박물관),4233,3319,7552,3776
20240726,경원선,서빙고,2226,2195,4421,2210.5
20240726,경원선,한남,4225,4187,8412,4206
20240726,경원선,옥수,80,45,125,62.5
20240726,경원선,응봉,1880,1573,3453,1726.5
20240726,경원선,왕십리(성동구청),18656,18704,37360,18680
20240726,경원선,청량리(서울시립대입구),18783,20147,38930,19465
20240726,경원선,외대앞,8712,8304,17016,8508
20240726,경원선,신이문,9024,8293,17317,8658.5
20240726,경원선,석계,7737,8839,16576,8288
20240726,경원선,광운대,8076,7506,15582,7791
20240726,경원선,월계,6465,5981,12446,6223
20240726,경원선,녹천,4784,3906,8690,4345
20240726,경원선,창동,2,0,2,1
20240726,경원선,방학,10446,10006,20452,10226
20240726,경원선,도봉,6309,5946,12255,6127.5
20240726,경원선,도봉산,7506,4744,12250,6125
20240726,경원선,망월사,7399,7332,14731,7365.5
20240726,경원선,회룡,13675,13287,26962,13481
20240726,경원선,의정부,19539,20146,39685,19842.5
20240726,경원선,가능,6767,6476,13243,6621.5
20240726,경원선,녹양,4549,4331,8880,4440
20240726,경원선,양주,7651,7306,14957,7478.5
20240726,경원선,덕계,6102,5701,11803,5901.5
20240726,경원선,덕정,5759,5415,11174,5587
20240726,경원선,지행,6864,6741,13605,6802.5
20240726,경원선,동두천중앙,2973,2963,5936,2968
20240726,경원선,보산,1671,1464,3135,1567.5
20240726,경원선,동두천,1883,1761,3644,1822
20240726,경원선,소요산,2070,2142,4212,2106
20240726,경원선,청산,169,139,308,154
20240726,경원선,전곡,1198,1215,2413,1206.5
20240726,경원선,연천,1173,1471,2644,1322
20240726,경의선,서울역,5340,6466,11806,5903
20240726,경의선,신촌,1070,1315,2385,1192.5
20240726,경의선,효창공원앞,3540,3904,7444,3722
20240726,경의선,공덕,4686,3796,8482,4241
20240726,경의선,서강대,2330,2181,4511,2255.5
20240726,경의선,홍대입구,2329,2883,5212,2606
20240726,경의선,가좌,6181,5903,12084,6042
20240726,경의선,디지털미디어시티,3117,2817,5934,2967
20240726,경의선,수색,3491,3516,7007,3503.5
20240726,경의선,한국항공대,1955,1761,3716,1858
20240726,경의선,강매,3386,2811,6197,3098.5
20240726,경의선,행신,8777,8846,17623,8811.5
20240726,경의선,능곡,5064,4644,9708,4854
20240726,경의선,곡산,667,733,1400,700
20240726,경의선,백마,7934,7743,15677,7838.5
20240726,경의선,풍산,6434,6314,12748,6374
20240726,경의선,일산,10874,10789,21663,10831.5
20240726,경의선,탄현,8307,8127,16434,8217
20240726,경의선,야당,9274,9594,18868,9434
20240726,경의선,운정,8194,7424,15618,7809
20240726,경의선,금릉,5826,5536,11362,5681
20240726,경의선,금촌,7083,6918,14001,7000.5
20240726,경의선,월롱,2330,1739,4069,2034.5
20240726,경의선,파주,1228,973,2201,1100.5
20240726,경의선,문산,5769,5956,11725,5862.5
20240726,경의선,임진강,8,4,12,6
20240726,경의선,운천,3,4,7,3.5
20240726,경인선,개봉,22910,22539,45449,22724.5
20240726,경인선,오류동,11995,11069,23064,11532
20240726,경인선,역곡,26662,26633,53295,26647.5
20240726,경인선,부천,33077,33336,66413,33206.5
20240726,경인선,송내,27884,27578,55462,27731
20240726,경인선,부평,30671,33493,64164,32082
20240726,경인선,백운,7803,7436,15239,7619.5
20240726,경인선,동암,16294,16372,32666,16333
20240726,경인선,주안,19412,17312,36724,18362
20240726,경인선,제물포,10666,10041,20707,10353.5
20240726,경인선,동인천,14593,13650,28243,14121.5
20240726,경인선,인천,4001,3229,7230,3615
20240726,경인선,구일,12571,14223,26794,13397
20240726,경인선,소사,7581,7225,14806,7403
20240726,경인선,부개,9025,8478,17503,8751.5
20240726,경인선,간석,6134,5815,11949,5974.5
20240726,경인선,도원,2891,2949,5840,2920
20240726,경인선,온수(성공회대입구),6220,5968,12188,6094
20240726,경인선,중동,9416,8842,18258,9129
20240726,경인선,도화,4384,4048,8432,4216
20240726,경춘선,신내,2814,2463,5277,2638.5
20240726,경춘선,갈매,3136,2742,5878,2939
20240726,경춘선,별내,3709,3443,7152,3576
20240726,경춘선,퇴계원,3746,3397,7143,3571.5
20240726,경춘선,사릉,2151,2087,4238,2119
20240726,경춘선,금곡,1513,1523,3036,1518
20240726,경춘선,평내호평,6211,6148,12359,6179.5
20240726,경춘선,천마산,1541,1365,2906,1453
20240726,경춘선,마석,3797,3711,7508,3754
20240726,경춘선,대성리,887,1140,2027,1013.5
20240726,경춘선,청평,2089,2249,4338,2169
20240726,경춘선,상천,258,264,522,261
20240726,경춘선,가평,2645,2666,5311,2655.5
20240726,경춘선,굴봉산,252,130,382,191
20240726,경춘선,백양리,112,70,182,91
20240726,경춘선,강촌,558,518,1076,538
20240726,경춘선,김유정,401,431,832,416
20240726,경춘선,남춘천,2766,3071,5837,2918.5
20240726,경춘선,춘천,1576,1327,2903,1451.5
20240726,공항철도 1호선,서울역,15989,14603,30592,15296
20240726,공항철도 1호선,공덕,3418,4358,7776,3888
20240726,공항철도 1호선,홍대입구,16766,16751,33517,16758.5
20240726,공항철도 1호선,디지털미디어시티,14967,13861,28828,14414
20240726,공항철도 1호선,마곡나루(서울식물원),11957,10754,22711,11355.5
20240726,공항철도 1호선,김포공항,10563,6027,16590,8295
20240726,공항철도 1호선,계양,14416,13508,27924,13962
20240726,공항철도 1호선,검암,6927,7111,14038,7019
20240726,공항철도 1호선,청라국제도시,8202,7748,15950,7975
20240726,공항철도 1호선,운서,9969,10257,20226,10113
20240726,공항철도 1호선,공항화물청사,2227,2334,4561,2280.5
20240726,공항철도 1호선,인천공항1터미널,17030,16224,33254,16627
20240726,공항철도 1호선,인천공항2터미널,8227,7009,15236,7618
20240726,공항철도 1호선,영종,4441,4636,9077,4538.5
20240726,과천선,선바위,8255,7009,15264,7632
20240726,과천선,경마공원,7648,7743,15391,7695.5
20240726,과천선,대공원,2691,2790,5481,2740.5
20240726,과천선,과천,7281,6533,13814,6907
20240726,과천선,정부과천청사,13351,13731,27082,13541
20240726,과천선,인덕원,27180,27920,55100,27550
20240726,과천선,평촌,19164,18617,37781,18890.5
20240726,과천선,범계,29712,29991,59703,29851.5
20240726,분당선,선릉,14726,22385,37111,18555.5
20240726,분당선,한티,18617,19402,38019,19009.5
20240726,분당선,도곡,8163,8383,16546,8273
20240726,분당선,구룡,3814,3660,7474,3737
20240726,분당선,개포동,4749,4852,9601,4800.5
20240726,분당선,대모산입구,6317,5907,12224,6112
20240726,분당선,수서,18797,20147,38944,19472
20240726,분당선,복정,5,0,5,2.5
20240726,분당선,수원,8490,8303,16793,8396.5
20240726,분당선,서울숲,14099,14127,28226,14113
20240726,분당선,압구정로데오,22091,25433,47524,23762
20240726,분당선,강남구청,10682,12261,22943,11471.5
20240726,분당선,선정릉,8346,8624,16970,8485
20240726,분당선,가천대,6480,6623,13103,6551.5
20240726,분당선,태평,14196,13129,27325,13662.5
20240726,분당선,모란,21113,21369,42482,21241
20240726,분당선,야탑,27310,29313,56623,28311.5
20240726,분당선,서현,27216,27726,54942,27471
20240726,분당선,수내,15502,15573,31075,15537.5
20240726,분당선,정자,20337,21065,41402,20701
20240726,분당선,미금,16246,17035,33281,16640.5
20240726,분당선,오리,12353,10414,22767,11383.5
20240726,분당선,이매,5644,5435,11079,5539.5
20240726,분당선,보정,2761,2409,5170,2585
20240726,분당선,죽전,13852,15132,28984,14492
20240726,분당선,구성,6833,6731,13564,6782
20240726,분당선,신갈,5130,4939,10069,5034.5
20240726,분당선,기흥,11120,10286,21406,10703
20240726,분당선,상갈,5757,5550,11307,5653.5
20240726,분당선,청명,5067,4803,9870,4935
20240726,분당선,영통,10159,9923,20082,10041
20240726,분당선,망포,17100,15808,32908,16454
20240726,분당선,매탄권선,5804,5336,11140,5570
20240726,분당선,수원시청,14912,17166,32078,16039
20240726,분당선,매교,5323,5161,10484,5242
20240726,서해선,김포공항,3297,4028,7325,3662.5
20240726,서해선,원종,5048,5145,10193,5096.5
20240726,서해선,부천종합운동장,2863,2356,5219,2609.5
20240726,수인선,고색,5787,5124,10911,5455.5
20240726,수인선,오목천,4341,3665,8006,4003
20240726,수인선,어천,1669,1505,3174,1587
20240726,수인선,야목,496,387,883,441.5
20240726,수인선,사리,5529,4589,10118,5059
20240726,수인선,달월,109,68,177,88.5
20240726,수인선,월곶,3028,2786,5814,2907
20240726,수인선,소래포구,4893,4497,9390,4695
20240726,수인선,인천논현,5979,6272,12251,6125.5
20240726,수인선,호구포,4275,4416,8691,4345.5
20240726,수인선,남동인더스파크,2564,2880,5444,2722
20240726,수인선,원인재,4537,4704,9241,4620.5
20240726,수인선,연수,4979,4933,9912,4956
20240726,수인선,송도,2433,2153,4586,2293
20240726,수인선,인하대,6654,6176,12830,6415
20240726,수인선,숭의,4397,4042,8439,4219.5
20240726,수인선,신포,1859,1954,3813,1906.5
20240726,중앙선,지평,48,61,109,54.5
20240726,수인선,인천,1191,1822,3013,1506.5
20240726,신림선,샛강,2977,3526,6503,3251.5
20240726,신림선,대방,3168,2556,5724,2862
20240726,신림선,서울지방병무청,3632,3730,7362,3681
20240726,신림선,보라매,4645,4106,8751,4375.5
20240726,신림선,보라매공원,2543,2677,5220,2610
20240726,신림선,보라매병원,8379,8606,16985,8492.5
20240726,신림선,당곡,5463,5182,10645,5322.5
20240726,신림선,신림,2157,2844,5001,2500.5
20240726,신림선,서원,3901,3287,7188,3594
20240726,신림선,서울대벤처타운,10175,9180,19355,9677.5
20240726,신림선,관악산(서울대),3129,3025,6154,3077
20240726,안산선,산본,17786,18923,36709,18354.5
20240726,안산선,대야미,5375,4537,9912,4956
20240726,안산선,반월,4527,4335,8862,4431
20240726,안산선,상록수,15602,15695,31297,15648.5
20240726,안산선,한대앞,9374,9513,18887,9443.5
20240726,안산선,중앙,19575,21043,40618,20309
20240726,안산선,고잔,9321,8750,18071,9035.5
20240726,안산선,초지,5302,5221,10523,5261.5
20240726,안산선,안산,12400,11762,24162,12081
20240726,안산선,신길온천,2134,1975,4109,2054.5
20240726,안산선,정왕,9633,9564,19197,9598.5
20240726,안산선,오이도,8408,8394,16802,8401
20240726,안산선,수리산,4297,3405,7702,3851
20240726,우이신설선,북한산우이,2914,2751,5665,2832.5
20240726,우이신설선,솔밭공원,2769,2647,5416,2708
20240726,우이신설선,4.19민주묘지,3091,2911,6002,3001
20240726,우이신설선,가오리,4648,4617,9265,4632.5
20240726,우이신설선,화계,3717,3610,7327,3663.5
20240726,우이신설선,삼양,2256,2363,4619,2309.5
20240726,우이신설선,삼양사거리,2809,2767,5576,2788
20240726,우이신설선,솔샘,6205,5729,11934,5967
20240726,우이신설선,북한산보국문,6261,5982,12243,6121.5
20240726,우이신설선,정릉,4987,4456,9443,4721.5
20240726,우이신설선,성신여대입구(돈암),3772,4191,7963,3981.5
20240726,우이신설선,보문,1708,1696,3404,1702
20240726,우이신설선,신설동,2533,2350,4883,2441.5
20240726,일산선,원흥,12300,11576,23876,11938
20240726,일산선,지축,4,0,4,2
20240726,일산선,삼송,20375,19493,39868,19934
20240726,일산선,원당,11693,11056,22749,11374.5
20240726,일산선,화정,17827,18508,36335,18167.5
20240726,일산선,대곡,3125,2603,5728,2864
20240726,일산선,백석,10851,11180,22031,11015.5
20240726,일산선,마두,8803,9024,17827,8913.5
20240726,일산선,정발산,7895,8417,16312,8156
20240726,일산선,주엽,10675,11136,21811,10905.5
20240726,일산선,대화,18930,18585,37515,18757.5
20240726,장항선,봉명,1455,1333,2788,1394
20240726,장항선,쌍용(나사렛대),2386,2271,4657,2328.5
20240726,장항선,아산,4033,4159,8192,4096
20240726,장항선,탕정,1832,1612,3444,1722
20240726,장항선,배방,1411,1296,2707,1353.5
20240726,장항선,온양온천,4584,4589,9173,4586.5
20240726,장항선,신창(순천향대),1350,1159,2509,1254.5
20240726,중앙선,회기,25158,23119,48277,24138.5
20240726,중앙선,중랑,6043,5635,11678,5839
20240726,중앙선,상봉,6340,6188,12528,6264
20240726,중앙선,망우,8023,7695,15718,7859
20240726,중앙선,양원,2993,2961,5954,2977
20240726,중앙선,구리,13801,14106,27907,13953.5
20240726,중앙선,도농,11507,10571,22078,11039
20240726,중앙선,양정,635,530,1165,582.5
20240726,중앙선,덕소,5593,5515,11108,5554
20240726,중앙선,도심,2473,1934,4407,2203.5
20240726,중앙선,팔당,751,797,1548,774
20240726,중앙선,운길산,645,633,1278,639
20240726,중앙선,양수,2217,2143,4360,2180
20240726,중앙선,신원,180,167,347,173.5
20240726,중앙선,국수,725,733,1458,729
20240726,중앙선,아신,557,569,1126,563
20240726,중앙선,오빈,292,312,604,302
20240726,중앙선,양평,3123,3487,6610,3305
20240726,중앙선,원덕,370,386,756,378
20240727,경부선,송탄,4825,4407,9232,4616
20240727,중앙선,도심,1641,1335,2976,1488
20240727,중앙선,덕소,4189,4208,8397,4198.5
20240727,중앙선,양정,461,385,846,423
20240727,중앙선,도농,7195,6932,14127,7063.5
20240727,중앙선,구리,10108,9968,20076,10038
20240727,중앙선,양원,1911,1789,3700,1850
20240727,중앙선,망우,6339,6240,12579,6289.5
20240727,중앙선,상봉,4929,4843,9772,4886
20240727,중앙선,중랑,4492,4208,8700,4350
20240727,중앙선,회기,19575,17956,37531,18765.5
20240727,장항선,신창(순천향대),1001,1007,2008,1004
20240727,장항선,온양온천,4664,4521,9185,4592.5
20240727,장항선,배방,1136,1091,2227,1113.5
20240727,장항선,탕정,1450,1297,2747,1373.5
20240727,장항선,아산,3312,3295,6607,3303.5
20240727,장항선,쌍용(나사렛대),1872,1715,3587,1793.5
20240727,장항선,봉명,839,759,1598,799
20240727,일산선,대화,10059,8481,18540,9270
20240727,일산선,주엽,7648,7431,15079,7539.5
20240727,일산선,정발산,6733,6791,13524,6762
20240727,일산선,마두,5236,5096,10332,5166
20240727,일산선,백석,7631,7678,15309,7654.5
20240727,일산선,대곡,2134,1838,3972,1986
20240727,일산선,화정,12860,13155,26015,13007.5
20240727,일산선,원당,8040,7537,15577,7788.5
20240727,일산선,삼송,14160,13431,27591,13795.5
20240727,일산선,지축,5,0,5,2.5
20240727,일산선,원흥,7895,7288,15183,7591.5
20240727,우이신설선,신설동,1472,1436,2908,1454
20240727,우이신설선,보문,1274,1268,2542,1271
20240727,우이신설선,성신여대입구(돈암),3074,3416,6490,3245
20240727,우이신설선,정릉,3532,3030,6562,3281
20240727,우이신설선,북한산보국문,4739,4125,8864,4432
20240727,우이신설선,솔샘,4059,3590,7649,3824.5
20240727,우이신설선,삼양사거리,2079,2007,4086,2043
20240727,우이신설선,삼양,1743,1857,3600,1800
20240727,우이신설선,화계,2672,2390,5062,2531
20240727,우이신설선,가오리,3251,3087,6338,3169
20240727,우이신설선,4.19민주묘지,2496,2188,4684,2342
20240727,우이신설선,솔밭공원,2021,1966,3987,1993.5
20240727,우이신설선,북한산우이,3379,3565,6944,3472
20240727,안산선,수리산,2799,2370,5169,2584.5
20240727,안산선,오이도,6992,7070,14062,7031
20240727,안산선,정왕,7611,7586,15197,7598.5
20240727,안산선,신길온천,1758,1579,3337,1668.5
20240727,안산선,안산,10879,11759,22638,11319
20240727,안산선,초지,3514,3560,7074,3537
20240727,안산선,고잔,5794,5546,11340,5670
20240727,안산선,중앙,15948,16914,32862,16431
20240727,안산선,한대앞,7221,7145,14366,7183
20240727,안산선,상록수,11929,11776,23705,11852.5
20240727,안산선,반월,3503,3230,6733,3366.5
20240727,안산선,대야미,3844,3246,7090,3545
20240727,안산선,산본,13065,13715,26780,13390
20240727,신림선,관악산(서울대),3454,3497,6951,3475.5
20240727,신림선,서울대벤처타운,7999,6822,14821,7410.5
20240727,신림선,서원,2803,2449,5252,2626
20240727,신림선,신림,1549,2059,3608,1804
20240727,신림선,당곡,3813,3506,7319,3659.5
20240727,신림선,보라매병원,3344,3309,6653,3326.5
20240727,신림선,보라매공원,1369,1453,2822,1411
20240727,신림선,보라매,2968,2624,5592,2796
20240727,신림선,서울지방병무청,2076,2283,4359,2179.5
20240727,신림선,대방,2222,1628,3850,1925
20240727,신림선,샛강,987,1351,2338,1169
20240727,수인선,인천,1283,2083,3366,1683
20240727,수인선,신포,1565,1577,3142,1571
20240727,수인선,숭의,3403,3000,6403,3201.5
20240727,수인선,인하대,4456,4173,8629,4314.5
20240727,수인선,송도,1908,1797,3705,1852.5
20240727,수인선,연수,4178,4160,8338,4169
20240727,수인선,원인재,3595,3759,7354,3677
20240727,수인선,남동인더스파크,973,1007,1980,990
20240727,수인선,호구포,2671,2446,5117,2558.5
20240727,수인선,인천논현,4349,4498,8847,4423.5
20240727,수인선,소래포구,4181,4240,8421,4210.5
20240727,수인선,월곶,2275,2227,4502,2251
20240727,수인선,달월,47,43,90,45
20240727,수인선,사리,3762,3023,6785,3392.5
20240727,수인선,야목,313,250,563,281.5
20240727,수인선,어천,1414,1111,2525,1262.5
20240727,수인선,오목천,2997,2375,5372,2686
20240727,수인선,고색,3050,2901,5951,2975.5
20240727,서해선,부천종합운동장,1828,1411,3239,1619.5
20240727,서해선,원종,3904,3776,7680,3840
20240727,서해선,김포공항,2676,3982,6658,3329
20240727,분당선,매교,3356,3239,6595,3297.5
20240727,분당선,수원시청,11316,12740,24056,12028
20240727,분당선,매탄권선,3855,3684,7539,3769.5
20240727,분당선,망포,9739,8848,18587,9293.5
20240727,분당선,영통,7056,6765,13821,6910.5
20240727,분당선,청명,2922,2830,5752,2876
20240727,분당선,상갈,3680,3731,7411,3705.5
20240727,분당선,기흥,6930,6340,13270,6635
20240727,분당선,신갈,2822,2805,5627,2813.5
20240727,분당선,구성,4288,4504,8792,4396
20240727,분당선,죽전,9022,10177,19199,9599.5
20240727,분당선,보정,1453,1373,2826,1413
20240727,분당선,이매,3864,3657,7521,3760.5
20240727,분당선,오리,7293,6043,13336,6668
20240727,분당선,미금,10281,10487,20768,10384
20240727,분당선,정자,10462,10561,21023,10511.5
20240727,분당선,수내,8652,8263,16915,8457.5
20240727,분당선,서현,18136,18457,36593,18296.5
20240727,분당선,야탑,17266,17977,35243,17621.5
20240727,분당선,모란,15562,16077,31639,15819.5
20240727,분당선,태평,10294,9682,19976,9988
20240727,분당선,가천대,4555,4637,9192,4596
20240727,분당선,선정릉,3179,3070,6249,3124.5
20240727,분당선,강남구청,4756,5773,10529,5264.5
20240727,분당선,압구정로데오,17652,20407,38059,19029.5
20240727,분당선,서울숲,8521,8795,17316,8658
20240727,분당선,수원,7472,6962,14434,7217
20240727,분당선,복정,6,0,6,3
20240727,분당선,수서,13301,13736,27037,13518.5
20240727,분당선,대모산입구,4018,3665,7683,3841.5
20240727,분당선,개포동,3155,3064,6219,3109.5
20240727,분당선,구룡,2314,2170,4484,2242
20240727,분당선,도곡,4881,4746,9627,4813.5
20240727,분당선,한티,15209,14604,29813,14906.5
20240727,분당선,선릉,5343,8086,13429,6714.5
20240727,과천선,범계,21548,21277,42825,21412.5
20240727,과천선,평촌,9043,8737,17780,8890
20240727,과천선,인덕원,16458,16189,32647,16323.5
20240727,과천선,정부과천청사,6906,6632,13538,6769
20240727,과천선,과천,4878,4451,9329,4664.5
20240727,과천선,대공원,4161,4246,8407,4203.5
20240727,과천선,경마공원,12339,12436,24775,12387.5
20240727,과천선,선바위,4841,3987,8828,4414
20240727,공항철도 1호선,영종,3754,3859,7613,3806.5
20240727,공항철도 1호선,인천공항2터미널,7779,6411,14190,7095
20240727,공항철도 1호선,인천공항1터미널,15031,14229,29260,14630
20240727,공항철도 1호선,공항화물청사,1295,1364,2659,1329.5
20240727,공항철도 1호선,운서,8684,9477,18161,9080.5
20240727,공항철도 1호선,청라국제도시,5166,4830,9996,4998
20240727,공항철도 1호선,검암,4424,4584,9008,4504
20240727,공항철도 1호선,계양,9484,8391,17875,8937.5
20240727,공항철도 1호선,김포공항,8151,4438,12589,6294.5
20240727,공항철도 1호선,마곡나루(서울식물원),4165,4509,8674,4337
20240727,공항철도 1호선,디지털미디어시티,5470,5343,10813,5406.5
20240727,공항철도 1호선,홍대입구,17155,16944,34099,17049.5
20240727,공항철도 1호선,공덕,2051,3044,5095,2547.5
20240727,공항철도 1호선,서울역,13684,13189,26873,13436.5
20240727,경춘선,춘천,1832,1534,3366,1683
20240727,경춘선,남춘천,3559,3725,7284,3642
20240727,경춘선,김유정,363,489,852,426
20240727,경춘선,강촌,597,659,1256,628
20240727,경춘선,백양리,120,94,214,107
20240727,경춘선,굴봉산,208,176,384,192
20240727,경춘선,가평,2551,3312,5863,2931.5
20240727,경춘선,상천,314,311,625,312.5
20240727,경춘선,청평,2056,2419,4475,2237.5
20240727,경춘선,대성리,982,1093,2075,1037.5
20240727,경춘선,마석,3101,3034,6135,3067.5
20240727,경춘선,천마산,1193,1153,2346,1173
20240727,경춘선,평내호평,4462,4251,8713,4356.5
20240727,경춘선,금곡,1085,980,2065,1032.5
20240727,경춘선,사릉,1396,1385,2781,1390.5
20240727,경춘선,퇴계원,2548,2383,4931,2465.5
20240727,경춘선,별내,2480,2272,4752,2376
20240727,경춘선,갈매,1810,1614,3424,1712
20240727,경춘선,신내,1661,1476,3137,1568.5
20240727,경인선,도화,3172,3033,6205,3102.5
20240727,경인선,중동,6704,6225,12929,6464.5
20240727,경인선,온수(성공회대입구),4620,4165,8785,4392.5
20240727,경인선,도원,6640,6795,13435,6717.5
20240727,경인선,간석,4609,4387,8996,4498
20240727,경인선,부개,6696,6153,12849,6424.5
20240727,경인선,소사,5485,5126,10611,5305.5
20240727,경인선,구일,10784,11678,22462,11231
20240727,경인선,인천,4648,4002,8650,4325
20240727,경인선,동인천,12265,12178,24443,12221.5
20240727,경인선,제물포,7320,7129,14449,7224.5
20240727,경인선,주안,15908,13715,29623,14811.5
20240727,경인선,동암,12866,12858,25724,12862
20240727,경인선,백운,5931,5700,11631,5815.5
20240727,경인선,부평,27845,31033,58878,29439
20240727,경인선,송내,18128,17598,35726,17863
20240727,경인선,부천,28379,28639,57018,28509
20240727,경인선,역곡,18866,18699,37565,18782.5
20240727,경인선,오류동,8795,8028,16823,8411.5
20240727,경인선,개봉,16120,15577,31697,15848.5
20240727,경의선,운천,10,4,14,7
20240727,경의선,임진강,103,58,161,80.5
20240727,경의선,문산,5359,4824,10183,5091.5
20240727,경의선,파주,1095,772,1867,933.5
20240727,경의선,월롱,1204,1152,2356,1178
20240727,경의선,금촌,5837,5424,11261,5630.5
20240727,경의선,금릉,4277,4016,8293,4146.5
20240727,경의선,운정,5740,5067,10807,5403.5
20240727,경의선,야당,7394,7473,14867,7433.5
20240727,경의선,탄현,5805,5457,11262,5631
20240727,경의선,일산,7599,7176,14775,7387.5
20240727,경의선,풍산,5030,4734,9764,4882
20240727,경의선,백마,4955,4678,9633,4816.5
20240727,경의선,곡산,446,455,901,450.5
20240727,경의선,능곡,3465,3391,6856,3428
20240727,경의선,행신,5442,5690,11132,5566
20240727,경의선,강매,1973,1772,3745,1872.5
20240727,경의선,한국항공대,1113,1034,2147,1073.5
20240727,경의선,수색,1655,1698,3353,1676.5
20240727,경의선,디지털미디어시티,2219,1894,4113,2056.5
20240727,경의선,가좌,4135,4066,8201,4100.5
20240727,경의선,홍대입구,2333,3023,5356,2678
20240727,경의선,서강대,1714,1595,3309,1654.5
20240727,경의선,공덕,3385,2316,5701,2850.5
20240727,경의선,효창공원앞,1935,2263,4198,2099
20240727,경의선,신촌,344,354,698,349
20240727,경의선,서울역,1386,1547,2933,1466.5
20240727,경원선,연천,1574,1579,3153,1576.5
20240727,경원선,전곡,1429,1222,2651,1325.5
20240727,경원선,청산,152,123,275,137.5
20240727,경원선,소요산,2777,2733,5510,2755
20240727,경원선,동두천,1464,1484,2948,1474
20240727,경원선,보산,1514,1478,2992,1496
20240727,경원선,동두천중앙,2534,2414,4948,2474
20240727,경원선,지행,5695,5612,11307,5653.5
20240727,경원선,덕정,4613,4326,8939,4469.5
20240727,경원선,덕계,4391,4068,8459,4229.5
20240727,경원선,양주,6200,5890,12090,6045
20240727,경원선,녹양,3258,3061,6319,3159.5
20240727,경원선,가능,5109,4793,9902,4951
20240727,경원선,의정부,17287,18090,35377,17688.5
20240727,경원선,회룡,9844,9687,19531,9765.5
20240727,경원선,망월사,5570,5524,11094,5547
20240727,경원선,도봉산,7825,5355,13180,6590
20240727,경원선,도봉,4595,4176,8771,4385.5
20240727,경원선,방학,7522,7241,14763,7381.5
20240727,경원선,창동,6,0,6,3
20240727,경원선,녹천,2979,2649,5628,2814
20240727,경원선,월계,4664,4142,8806,4403
20240727,경원선,광운대,6239,5738,11977,5988.5
20240727,경원선,석계,6274,6385,12659,6329.5
20240727,경원선,신이문,6210,5673,11883,5941.5
20240727,경원선,외대앞,7002,6426,13428,6714
20240727,경원선,청량리(서울시립대입구),18382,19922,38304,19152
20240727,경원선,왕십리(성동구청),15403,15603,31006,15503
20240727,경원선,응봉,1310,1124,2434,1217
20240727,경원선,옥수,39,27,66,33
20240727,경원선,한남,2263,2384,4647,2323.5
20240727,경원선,서빙고,1545,1561,3106,1553
20240727,경원선,이촌(국립중앙박물관),2848,2288,5136,2568
20240727,경부선,광명,3234,2838,6072,3036
20240727,경부선,서동탄,1112,1062,2174,1087
20240727,경부선,당정,3842,3570,7412,3706
20240727,경부선,천안,7067,7172,14239,7119.5
20240727,경부선,두정,6319,6134,12453,6226.5
20240727,경부선,직산,885,799,1684,842
20240727,경부선,성환,3505,3143,6648,3324
20240727,경부선,평택,15153,14850,30003,15001.5
20240727,경부선,평택지제,3836,3599,7435,3717.5
20240727,경부선,서정리,7778,6594,14372,7186
20240727,경부선,진위,1120,969,2089,1044.5
20240727,경부선,오산,9782,9107,18889,9444.5
20240727,경부선,오산대,2896,2689,5585,2792.5
20240727,경부선,세마,2738,2345,5083,2541.5
20240727,경부선,병점,13232,12717,25949,12974.5
20240727,경부선,세류,3011,2988,5999,2999.5
20240727,경부선,독산,8975,8743,17718,8859
20240727,경부선,수원,40537,44720,85257,42628.5
20240727,경부선,화서,11972,11841,23813,11906.5
20240727,경부선,성균관대,10856,10733,21589,10794.5
20240727,경부선,의왕,5784,5539,11323,5661.5
20240727,경부선,군포,4131,3907,8038,4019
20240727,경부선,금정,19823,19866,39689,19844.5
20240727,경부선,명학,4519,4199,8718,4359
20240727,경부선,안양,17215,16804,34019,17009.5
20240727,경부선,관악,5469,5445,10914,5457
20240727,경부선,석수,6195,5628,11823,5911.5
20240727,경부선,금천구청,7547,7448,14995,7497.5
20240727,경부선,가산디지털단지,6384,8097,14481,7240.5
20240727,경부선,구로,13141,13689,26830,13415
20240727,경부선,신길,5763,4724,10487,5243.5
20240727,경부선,신도림,2624,3177,5801,2900.5
20240727,경부선,영등포,44463,46098,90561,45280.5
20240727,경부선,대방,6183,6596,12779,6389.5
20240727,경부선,노량진,7557,6918,14475,7237.5
20240727,경부선,용산,47176,51637,98813,49406.5
20240727,경부선,남영,6264,6713,12977,6488.5
20240727,경부선,서울역,10584,3850,14434,7217
20240727,경강선,성남,718,672,1390,695
20240727,경강선,여주,2972,3283,6255,3127.5
20240727,경강선,세종대왕릉,334,391,725,362.5
20240727,경강선,부발,2198,2001,4199,2099.5
20240727,경강선,이천,3178,3369,6547,3273.5
20240727,경강선,신둔도예촌,1312,1171,2483,1241.5
20240727,경강선,곤지암,2140,2059,4199,2099.5
20240727,경강선,초월,2455,2321,4776,2388
20240727,경강선,경기광주,5672,5213,10885,5442.5
20240727,경강선,삼동,1612,1510,3122,1561
20240727,경강선,이매,809,666,1475,737.5
20240727,경강선,판교,3764,3423,7187,3593.5
20240727,9호선2~3단계,중앙보훈병원,6031,5297,11328,5664
20240727,9호선2~3단계,둔촌오륜,1229,1088,2317,1158.5
20240727,9호선2~3단계,올림픽공원(한국체대),12009,11051,23060,11530
20240727,9호선2~3단계,한성백제,2096,1852,3948,1974
20240727,9호선2~3단계,송파나루,4760,5247,10007,5003.5
20240727,9호선2~3단계,석촌,7758,6358,14116,7058
20240727,9호선2~3단계,석촌고분,5465,5112,10577,5288.5
20240727,9호선2~3단계,삼전,5840,5161,11001,5500.5
20240727,9호선2~3단계,종합운동장,4469,3933,8402,4201
20240727,9호선2~3단계,봉은사,17237,18031,35268,17634
20240727,9호선2~3단계,삼성중앙,3449,3419,6868,3434
20240727,9호선2~3단계,선정릉,4527,5147,9674,4837
20240727,9호선2~3단계,언주,6924,6910,13834,6917
20240727,9호선,신논현,26145,26995,53140,26570
20240727,9호선,사평,2695,2496,5191,2595.5
20240727,9호선,고속터미널,14947,23130,38077,19038.5
20240727,9호선,신반포,2780,2618,5398,2699
20240727,9호선,구반포,833,782,1615,807.5
20240727,9호선,동작(현충원),1374,1222,2596,1298
20240727,9호선,흑석(중앙대입구),5909,5800,11709,5854.5
20240727,9호선,노들,3471,2843,6314,3157
20240727,9호선,노량진,21164,20583,41747,20873.5
20240727,9호선,샛강,2907,2945,5852,2926
20240727,9호선,여의도,15561,14416,29977,14988.5
20240727,9호선,국회의사당,4660,4948,9608,4804
20240727,9호선,당산,13267,12458,25725,12862.5
20240727,9호선,선유도,4108,3904,8012,4006
20240727,9호선,신목동,2574,2189,4763,2381.5
20240727,9호선,염창,12613,11423,24036,12018
20240727,9호선,등촌,7872,7343,15215,7607.5
20240727,9호선,증미,3822,3540,7362,3681
20240727,9호선,가양,14982,14179,29161,14580.5
20240727,9호선,양천향교,5943,5684,11627,5813.5
20240727,9호선,마곡나루(서울식물원),8933,8666,17599,8799.5
20240727,9호선,신방화,5144,4763,9907,4953.5
20240727,9호선,공항시장,2358,2396,4754,2377
20240727,9호선,김포공항,6345,10424,16769,8384.5
20240727,9호선,개화,1597,1250,2847,1423.5
20240727,8호선,남위례,4370,4374,8744,4372
20240727,8호선,모란,4026,3480,7506,3753
20240727,8호선,수진,4435,3947,8382,4191
20240727,8호선,신흥,4141,4302,8443,4221.5
20240727,8호선,단대오거리,8177,7678,15855,7927.5
20240727,8호선,남한산성입구(성남법원.검찰청),8666,7417,16083,8041.5
20240727,8호선,산성,4525,4610,9135,4567.5
20240727,8호선,복정,5858,4758,10616,5308
20240727,8호선,장지,12299,11149,23448,11724
20240727,8호선,문정,9085,8978,18063,9031.5
20240727,8호선,가락시장,5486,5597,11083,5541.5
20240727,8호선,석촌,6477,7977,14454,7227
20240727,8호선,잠실(송파구청),15981,17673,33654,16827
20240727,8호선,몽촌토성(평화의문),4562,4528,9090,4545
20240727,8호선,강동구청,6297,6126,12423,6211.5
20240727,8호선,천호(풍납토성),12304,14237,26541,13270.5
20240727,8호선,암사,12851,11658,24509,12254.5
20240727,7호선,온수(성공회대입구),5342,5155,10497,5248.5
20240727,7호선,천왕,7029,6722,13751,6875.5
20240727,7호선,광명사거리,15499,15623,31122,15561
20240727,7호선,철산,15825,15678,31503,15751.5
20240727,7호선,가산디지털단지,13759,12319,26078,13039
20240727,7호선,남구로,8216,8755,16971,8485.5
20240727,7호선,대림(구로구청),8029,8578,16607,8303.5
20240727,7호선,신풍,8070,7466,15536,7768
20240727,7호선,보라매,4926,4945,9871,4935.5
20240727,7호선,신대방삼거리,10656,9963,20619,10309.5
20240727,7호선,장승배기,6722,6227,12949,6474.5
20240727,7호선,상도,8191,7473,15664,7832
20240727,7호선,숭실대입구(살피재),8522,8065,16587,8293.5
20240727,7호선,남성,8268,7690,15958,7979
20240727,7호선,이수,12919,12377,25296,12648
20240727,7호선,내방,8302,8041,16343,8171.5
20240727,7호선,고속터미널,15967,11879,27846,13923
20240727,7호선,반포,4959,4740,9699,4849.5
20240727,7호선,논현,10333,11228,21561,10780.5
20240727,7호선,학동,9965,10196,20161,10080.5
20240727,7호선,강남구청,8752,9837,18589,9294.5
20240727,7호선,청담,10166,10581,20747,10373.5
20240727,7호선,자양(뚝섬한강공원),6973,6590,13563,6781.5
20240727,7호선,건대입구,11341,11594,22935,11467.5
20240727,7호선,어린이대공원(세종대),10190,9332,19522,9761
20240727,7호선,군자(능동),11586,8586,20172,10086
20240727,7호선,중곡,7184,6588,13772,6886
20240727,7호선,용마산(용마폭포공원),4134,3928,8062,4031
20240727,7호선,사가정,11863,11510,23373,11686.5
20240727,7호선,면목,10550,9789,20339,10169.5
20240727,7호선,상봉,14168,13855,28023,14011.5
20240727,7호선,중화,7494,6958,14452,7226
20240727,7호선,먹골,7737,7453,15190,7595
20240727,7호선,태릉입구,7020,6402,13422,6711
20240727,7호선,공릉(서울과학기술대),8557,8183,16740,8370
20240727,7호선,하계,12521,11477,23998,11999
20240727,7호선,중계,9736,8748,18484,9242
20240727,7호선,노원,20080,20513,40593,20296.5
20240727,7호선,마들,9333,8667,18000,9000
20240727,7호선,수락산,10163,9870,20033,10016.5
20240727,7호선,도봉산,6199,8334,14533,7266.5
20240727,7호선,장암,2009,1450,3459,1729.5
20240727,6호선,봉화산(서울의료원),5392,5230,10622,5311
20240727,6호선,화랑대(서울여대입구),7388,5625,13013,6506.5
20240727,6호선,태릉입구,4457,4669,9126,4563
20240727,6호선,석계,8766,8819,17585,8792.5
20240727,6호선,돌곶이,6695,6022,12717,6358.5
20240727,6호선,상월곡(한국과학기술연구원),4114,3543,7657,3828.5
20240727,6호선,월곡(동덕여대),7753,7324,15077,7538.5
20240727,6호선,고려대(종암),5585,5098,10683,5341.5
20240727,6호선,안암(고대병원앞),7165,6591,13756,6878
20240727,6호선,보문,5379,4768,10147,5073.5
20240727,6호선,창신,2183,1839,4022,2011
20240727,6호선,동묘앞,7796,7151,14947,7473.5
20240727,6호선,신당,7264,6516,13780,6890
20240727,6호선,청구,2714,2399,5113,2556.5
20240727,6호선,약수,2777,2697,5474,2737
20240727,6호선,버티고개,1459,1531,2990,1495
20240727,6호선,한강진,8806,10458,19264,9632
20240727,6호선,이태원,11300,15182,26482,13241
20240727,6호선,녹사평(용산구청),4742,5288,10030,5015
20240727,6호선,삼각지,6579,5543,12122,6061
20240727,6호선,효창공원앞,4865,4098,8963,4481.5
20240727,6호선,공덕,10756,10307,21063,10531.5
20240727,6호선,대흥(서강대앞),5977,5942,11919,5959.5
20240727,6호선,광흥창(서강),5403,4985,10388,5194
20240727,6호선,상수,9732,11669,21401,10700.5
20240727,6호선,합정,12546,11919,24465,12232.5
20240727,6호선,망원,13542,14209,27751,13875.5
20240727,6호선,마포구청,9789,8671,18460,9230
20240727,6호선,월드컵경기장(성산),4653,4778,9431,4715.5
20240727,6호선,디지털미디어시티,7823,8038,15861,7930.5
20240727,6호선,증산(명지대앞),7221,7008,14229,7114.5
20240727,6호선,새절(신사),9106,8550,17656,8828
20240727,6호선,구산,6061,4662,10723,5361.5
20240727,6호선,연신내,8,0,8,4
20240727,6호선,독바위,2076,2213,4289,2144.5
20240727,6호선,불광,4515,3742,8257,4128.5
20240727,6호선,역촌,2968,3281,6249,3124.5
20240727,6호선,응암,12651,12298,24949,12474.5
20240727,5호선,하남검단산,5637,5463,11100,5550
20240727,5호선,하남시청(덕풍·신장),6643,6219,12862,6431
20240727,5호선,하남풍산,3058,3019,6077,3038.5
20240727,5호선,미사,13715,13726,27441,13720.5
20240727,5호선,강일,4045,3542,7587,3793.5
20240727,5호선,마천,4797,4657,9454,4727
20240727,5호선,거여,6459,6113,12572,6286
20240727,5호선,개롱,4733,4847,9580,4790
20240727,5호선,오금,2197,2083,4280,2140
20240727,5호선,방이,5427,5262,10689,5344.5
20240727,5호선,올림픽공원(한국체대),6845,7554,14399,7199.5
20240727,5호선,둔촌동,6620,6778,13398,6699
20240727,5호선,상일동,9155,8753,17908,8954
20240727,5호선,고덕,7206,6859,14065,7032.5
20240727,5호선,명일,6181,6085,12266,6133
20240727,5호선,굽은다리(강동구민회관앞),8448,8154,16602,8301
20240727,5호선,길동,6543,6605,13148,6574
20240727,5호선,강동,12521,11948,24469,12234.5
20240727,5호선,천호(풍납토성),17766,16823,34589,17294.5
20240727,5호선,광나루(장신대),10231,9806,20037,10018.5
20240727,5호선,아차산(어린이대공원후문),11071,10676,21747,10873.5
20240727,5호선,군자(능동),8808,9804,18612,9306
20240727,5호선,장한평,12242,11932,24174,12087
20240727,5호선,답십리,10533,9417,19950,9975
20240727,5호선,마장,3685,3545,7230,3615
20240727,5호선,왕십리(성동구청),3589,4558,8147,4073.5
20240727,5호선,행당,5746,4784,10530,5265
20240727,5호선,신금호,4329,4591,8920,4460
20240727,5호선,청구,2527,2490,5017,2508.5
20240727,5호선,동대문역사문화공원(DDP),1537,1947,3484,1742
20240727,5호선,을지로4가,3449,3814,7263,3631.5
20240727,5호선,종로3가,14554,15212,29766,14883
20240727,5호선,광화문(세종문화회관),18002,18328,36330,18165
20240727,5호선,서대문,7982,7645,15627,7813.5
20240727,5호선,충정로(경기대입구),1947,1871,3818,1909
20240727,5호선,애오개,3782,3587,7369,3684.5
20240727,5호선,공덕,7530,7824,15354,7677
20240727,5호선,마포,8277,8434,16711,8355.5
20240727,5호선,여의나루,7795,16090,23885,11942.5
20240727,5호선,여의도,14474,14563,29037,14518.5
20240727,5호선,신길,3402,3458,6860,3430
20240727,5호선,영등포시장,8307,8223,16530,8265
20240727,5호선,영등포구청,2320,2186,4506,2253
20240727,5호선,양평,4032,3769,7801,3900.5
20240727,5호선,오목교(목동운동장앞),16248,16281,32529,16264.5
20240727,5호선,목동,11308,10948,22256,11128
20240727,5호선,신정(은행정),8900,7504,16404,8202
20240727,5호선,까치산,20432,19034,39466,19733
20240727,5호선,화곡,20166,18139,38305,19152.5
20240727,5호선,우장산,10163,9851,20014,10007
20240727,5호선,발산,13636,14671,28307,14153.5
20240727,5호선,마곡,7003,6913,13916,6958
20240727,5호선,송정,5122,4721,9843,4921.5
20240727,5호선,김포공항,10021,7892,17913,8956.5
20240727,5호선,개화산,3979,3831,7810,3905
20240727,5호선,방화,4995,4702,9697,4848.5
20240727,4호선,남태령,1058,680,1738,869
20240727,4호선,사당,22401,20241,42642,21321
20240727,4호선,총신대입구(이수),14500,15470,29970,14985
20240727,4호선,동작(현충원),973,1046,2019,1009.5
20240727,4호선,이촌(국립중앙박물관),9058,9378,18436,9218
20240727,4호선,신용산,15219,17222,32441,16220.5
20240727,4호선,삼각지,5694,6933,12627,6313.5
20240727,4호선,숙대입구(갈월),10531,10416,20947,10473.5
20240727,4호선,서울역,7302,18882,26184,13092
20240727,4호선,회현(남대문시장),21157,21386,42543,21271.5
20240727,4호선,명동,27401,31046,58447,29223.5
20240727,4호선,충무로,16021,17427,33448,16724
20240727,4호선,동대문역사문화공원(DDP),17757,15164,32921,16460.5
20240727,4호선,동대문,15697,15820,31517,15758.5
20240727,4호선,혜화,32970,34883,67853,33926.5
20240727,4호선,한성대입구(삼선교),10028,9635,19663,9831.5
20240727,4호선,성신여대입구(돈암),17468,16660,34128,17064
20240727,4호선,길음,14677,13729,28406,14203
20240727,4호선,미아사거리,21177,20669,41846,20923
20240727,4호선,미아(서울사이버대학),11481,10641,22122,11061
20240727,4호선,수유(강북구청),26344,25523,51867,25933.5
20240727,4호선,쌍문,21537,19381,40918,20459
20240727,4호선,창동,20514,21573,42087,21043.5
20240727,4호선,노원,23321,25778,49099,24549.5
20240727,4호선,상계,14104,12749,26853,13426.5
20240727,4호선,당고개,7676,6980,14656,7328
20240727,3호선,오금,4098,3784,7882,3941
20240727,3호선,경찰병원,4412,4343,8755,4377.5
20240727,3호선,가락시장,6484,6040,12524,6262
20240727,3호선,수서,14806,13883,28689,14344.5
20240727,3호선,일원,5462,5246,10708,5354
20240727,3호선,대청,6194,5776,11970,5985
20240727,3호선,학여울,1672,1755,3427,1713.5
20240727,3호선,대치,11386,9994,21380,10690
20240727,3호선,도곡,3372,3136,6508,3254
20240727,3호선,매봉,6420,6132,12552,6276
20240727,3호선,양재(서초구청),19072,20002,39074,19537
20240727,3호선,남부터미널(예술의전당),20060,20226,40286,20143
20240727,3호선,교대(법원.검찰청),9486,4940,14426,7213
20240727,3호선,고속터미널,56680,57452,114132,57066
20240727,3호선,잠원,3438,3257,6695,3347.5
20240727,3호선,신사,21234,22228,43462,21731
20240727,3호선,압구정,24195,25393,49588,24794
20240727,3호선,옥수,6330,6436,12766,6383
20240727,3호선,금호,5887,5392,11279,5639.5
20240727,3호선,약수,9173,8965,18138,9069
20240727,3호선,동대입구,9224,9600,18824,9412
20240727,3호선,충무로,16,0,16,8
20240727,3호선,을지로3가,6439,6765,13204,6602
20240727,3호선,종로3가,8491,10761,19252,9626
20240727,3호선,안국,19057,19774,38831,19415.5
20240727,3호선,경복궁(정부서울청사),17188,17930,35118,17559
20240727,3호선,독립문,5854,5841,11695,5847.5
20240727,3호선,무악재,2985,2933,5918,2959
20240727,3호선,홍제,13871,12899,26770,13385
20240727,3호선,불광,13304,14610,27914,13957
20240727,3호선,연신내,27740,25826,53566,26783
20240727,3호선,구파발,17129,17332,34461,17230.5
20240727,3호선,지축,5337,5012,10349,5174.5
20240727,2호선,용두(동대문구청),1889,1853,3742,1871
20240727,2호선,신정네거리,7346,7346,14692,7346
20240727,2호선,양천구청,4532,4451,8983,4491.5
20240727,2호선,도림천,936,941,1877,938.5
20240727,2호선,신설동,3765,3309,7074,3537
20240727,2호선,신답,1010,1033,2043,1021.5
20240727,2호선,용답,2188,1990,4178,2089
20240727,2호선,충정로(경기대입구),5016,5161,10177,5088.5
20240727,2호선,아현,7967,7120,15087,7543.5
20240727,2호선,이대,11395,12035,23430,11715
20240727,2호선,신촌,32648,32975,65623,32811.5
20240727,2호선,홍대입구,77368,87446,164814,82407
20240727,2호선,합정,28876,33330,62206,31103
20240727,2호선,당산,11060,12104,23164,11582
20240727,2호선,영등포구청,12296,12706,25002,12501
20240727,2호선,문래,12785,13639,26424,13212
20240727,2호선,신도림,40339,39819,80158,40079
20240727,2호선,대림(구로구청),18718,19423,38141,19070.5
20240727,2호선,구로디지털단지,35979,34762,70741,35370.5
20240727,2호선,신대방,20009,18564,38573,19286.5
20240727,2호선,신림,45152,42463,87615,43807.5
20240727,2호선,봉천,18098,16262,34360,17180
20240727,2호선,서울대입구(관악구청),35913,34037,69950,34975
20240727,2호선,낙성대(강감찬),21183,18959,40142,20071
20240727,2호선,사당,32854,36541,69395,34697.5
20240727,2호선,방배,9251,9145,18396,9198
20240727,2호선,서초,11351,10099,21450,10725
20240727,2호선,교대(법원.검찰청),15838,19907,35745,17872.5
20240727,2호선,강남,59582,58710,118292,59146
20240727,2호선,역삼,18019,19736,37755,18877.5
20240727,2호선,선릉,26367,23351,49718,24859
20240727,2호선,삼성(무역센터),36621,35282,71903,35951.5
20240727,2호선,종합운동장,10211,11591,21802,10901
20240727,2호선,잠실새내,19502,19662,39164,19582
20240727,2호선,잠실(송파구청),75404,73164,148568,74284
20240727,2호선,잠실나루,8253,7960,16213,8106.5
20240727,2호선,강변(동서울터미널),26342,27057,53399,26699.5
20240727,2호선,구의(광진구청),17811,16871,34682,17341
20240727,2호선,건대입구,32637,35967,68604,34302
20240727,2호선,성수,29694,35477,65171,32585.5
20240727,2호선,뚝섬,16361,16413,32774,16387
20240727,2호선,한양대,3908,4062,7970,3985
20240727,2호선,왕십리(성동구청),12603,12105,24708,12354
20240727,2호선,상왕십리,10037,9413,19450,9725
20240727,2호선,신당,11566,12725,24291,12145.5
20240727,2호선,동대문역사문화공원(DDP),14904,17125,32029,16014.5
20240727,2호선,을지로4가,8889,8955,17844,8922
20240727,2호선,을지로3가,13144,13216,26360,13180
20240727,2호선,을지로입구,29392,29288,58680,29340
20240727,2호선,시청,11649,9890,21539,10769.5
20240727,1호선,동묘앞,11109,11145,22254,11127
20240727,1호선,청량리(서울시립대입구),20096,20348,40444,20222
20240727,1호선,제기동,13918,14132,28050,14025
20240727,1호선,신설동,10079,9823,19902,9951
20240727,1호선,동대문,10663,10826,21489,10744.5
20240727,1호선,종로5가,19579,18652,38231,19115.5
20240727,1호선,종로3가,22126,21794,43920,21960
20240727,1호선,종각,20530,20615,41145,20572.5
20240727,1호선,시청,13851,13594,27445,13722.5
20240727,1호선,서울역,43266,41601,84867,42433.5
20240727,8호선,송파,6564,6417,12981,6490.5
20240727,3호선,녹번,10212,8781,18993,9496.5
20240727,중앙선,지평,64,79,143,71.5
20240727,중앙선,용문,2218,2543,4761,2380.5
20240727,중앙선,원덕,365,349,714,357
20240727,중앙선,양평,2792,3093,5885,2942.5
20240727,중앙선,오빈,242,252,494,247
20240727,중앙선,아신,508,549,1057,528.5
20240727,중앙선,국수,593,592,1185,592.5
20240727,중앙선,신원,179,163,342,171
20240727,중앙선,양수,2138,2255,4393,2196.5
20240727,중앙선,운길산,715,743,1458,729
20240727,중앙선,팔당,1018,1107,2125,1062.5
20240728,6호선,이태원,10793,9126,19919,9959.5
20240728,경원선,이촌(국립중앙박물관),2605,2056,4661,2330.5
20240728,경원선,서빙고,1995,1964,3959,1979.5
20240728,경원선,한남,1732,1730,3462,1731
20240728,경원선,옥수,67,32,99,49.5
20240728,경원선,응봉,1102,994,2096,1048
20240728,경원선,왕십리(성동구청),11415,11818,23233,11616.5
20240728,경원선,청량리(서울시립대입구),16279,15284,31563,15781.5
20240728,경원선,외대앞,5167,4914,10081,5040.5
20240728,경원선,신이문,4896,4632,9528,4764
20240728,경원선,석계,4813,5141,9954,4977
20240728,경원선,광운대,4474,4401,8875,4437.5
20240728,경원선,월계,3673,3301,6974,3487
20240728,경원선,녹천,2674,2388,5062,2531
20240728,경원선,창동,7,0,7,3.5
20240728,경원선,방학,6255,5943,12198,6099
20240728,경원선,도봉,3703,3430,7133,3566.5
20240728,경원선,도봉산,8068,5426,13494,6747
20240728,경원선,망월사,4667,4825,9492,4746
20240728,경원선,회룡,7813,7702,15515,7757.5
20240728,경원선,의정부,14296,14309,28605,14302.5
20240728,경원선,가능,4033,3826,7859,3929.5
20240728,경원선,녹양,2602,2422,5024,2512
20240728,경원선,양주,5042,4962,10004,5002
20240728,경원선,덕계,3547,3311,6858,3429
20240728,경원선,덕정,3604,3559,7163,3581.5
20240728,경원선,지행,4823,4906,9729,4864.5
20240728,경원선,동두천중앙,2083,2089,4172,2086
20240728,경원선,보산,1143,1406,2549,1274.5
20240728,경원선,동두천,1146,1241,2387,1193.5
20240728,경원선,소요산,3016,2929,5945,2972.5
20240728,경원선,청산,137,113,250,125
20240728,경원선,전곡,1252,1213,2465,1232.5
20240728,경원선,연천,1361,1471,2832,1416
20240728,경의선,서울역,1070,1136,2206,1103
20240728,경의선,신촌,310,342,652,326
20240728,경의선,효창공원앞,1475,1736,3211,1605.5
20240728,경의선,공덕,2102,1748,3850,1925
20240728,경의선,서강대,1331,1340,2671,1335.5
20240728,경의선,홍대입구,2101,2655,4756,2378
20240728,경의선,가좌,3212,3324,6536,3268
20240728,경의선,디지털미디어시티,1645,1501,3146,1573
20240728,경의선,수색,1331,1436,2767,1383.5
20240728,경의선,한국항공대,969,986,1955,977.5
20240728,경의선,강매,1515,1424,2939,1469.5
20240728,경의선,행신,4885,4733,9618,4809
20240728,경의선,능곡,2807,2688,5495,2747.5
20240728,경의선,곡산,353,353,706,353
20240728,경의선,백마,3877,3754,7631,3815.5
20240728,경의선,풍산,4124,3946,8070,4035
20240728,경의선,일산,6787,6479,13266,6633
20240728,경의선,탄현,4536,4315,8851,4425.5
20240728,경의선,야당,5987,6002,11989,5994.5
20240728,경의선,운정,4072,3956,8028,4014
20240728,경의선,금릉,3371,3254,6625,3312.5
20240728,경의선,금촌,4461,4848,9309,4654.5
20240728,경의선,월롱,897,1266,2163,1081.5
20240728,경의선,파주,839,763,1602,801
20240728,경의선,문산,4073,4445,8518,4259
20240728,경의선,임진강,58,63,121,60.5
20240728,경의선,운천,11,6,17,8.5
20240728,경인선,개봉,12355,12054,24409,12204.5
20240728,경인선,오류동,6995,6597,13592,6796
20240728,경인선,역곡,14082,14113,28195,14097.5
20240728,경인선,부천,21788,21530,43318,21659
20240728,경인선,송내,13238,12986,26224,13112
20240728,경인선,부평,23287,22765,46052,23026
20240728,경인선,백운,4468,4332,8800,4400
20240728,경인선,동암,10104,9729,19833,9916.5
20240728,경인선,주안,12062,10514,22576,11288
20240728,경인선,제물포,5685,5451,11136,5568
20240728,경인선,동인천,9634,9238,18872,9436
20240728,경인선,인천,4160,3518,7678,3839
20240728,경인선,구일,9854,10815,20669,10334.5
20240728,경인선,소사,4582,4242,8824,4412
20240728,경인선,부개,5056,4723,9779,4889.5
20240728,경인선,간석,3315,3163,6478,3239
20240728,경인선,도원,1788,1775,3563,1781.5
20240728,경인선,온수(성공회대입구),3962,3533,7495,3747.5
20240728,경인선,중동,5226,4875,10101,5050.5
20240728,경인선,도화,2445,2254,4699,2349.5
20240728,경춘선,신내,1218,1229,2447,1223.5
20240728,경춘선,갈매,1425,1302,2727,1363.5
20240728,경춘선,별내,1988,1907,3895,1947.5
20240728,경춘선,퇴계원,1981,1818,3799,1899.5
20240728,경춘선,사릉,1232,1223,2455,1227.5
20240728,경춘선,금곡,883,824,1707,853.5
20240728,경춘선,평내호평,3413,3424,6837,3418.5
20240728,경춘선,천마산,1024,973,1997,998.5
20240728,경춘선,마석,2951,2857,5808,2904
20240728,경춘선,대성리,1048,684,1732,866
20240728,경춘선,청평,2439,1815,4254,2127
20240728,경춘선,상천,384,302,686,343
20240728,경춘선,가평,3271,2314,5585,2792.5
20240728,경춘선,굴봉산,305,224,529,264.5
20240728,경춘선,백양리,147,79,226,113
20240728,경춘선,강촌,925,516,1441,720.5
20240728,경춘선,김유정,443,407,850,425
20240728,경춘선,남춘천,2711,2808,5519,2759.5
20240728,경춘선,춘천,1715,1411,3126,1563
20240728,공항철도 1호선,서울역,13890,12160,26050,13025
20240728,공항철도 1호선,공덕,1624,2277,3901,1950.5
20240728,공항철도 1호선,홍대입구,15369,13801,29170,14585
20240728,공항철도 1호선,디지털미디어시티,3957,3988,7945,3972.5
20240728,공항철도 1호선,마곡나루(서울식물원),2890,3105,5995,2997.5
20240728,공항철도 1호선,김포공항,8085,4311,12396,6198
20240728,공항철도 1호선,계양,7167,6948,14115,7057.5
20240728,공항철도 1호선,검암,3612,3581,7193,3596.5
20240728,공항철도 1호선,청라국제도시,4004,4006,8010,4005
20240728,공항철도 1호선,운서,7853,8454,16307,8153.5
20240728,공항철도 1호선,공항화물청사,1006,1018,2024,1012
20240728,공항철도 1호선,인천공항1터미널,14564,14668,29232,14616
20240728,공항철도 1호선,인천공항2터미널,7375,6371,13746,6873
20240728,공항철도 1호선,영종,3126,3164,6290,3145
20240728,과천선,선바위,3791,3262,7053,3526.5
20240728,과천선,경마공원,14803,14966,29769,14884.5
20240728,과천선,대공원,4436,4491,8927,4463.5
20240728,과천선,과천,3860,3710,7570,3785
20240728,과천선,정부과천청사,5091,4949,10040,5020
20240728,과천선,인덕원,12672,12932,25604,12802
20240728,과천선,평촌,6345,6166,12511,6255.5
20240728,과천선,범계,15732,15460,31192,15596
20240728,분당선,선릉,3137,4445,7582,3791
20240728,분당선,한티,11254,10381,21635,10817.5
20240728,분당선,도곡,3101,3170,6271,3135.5
20240728,분당선,구룡,1490,1667,3157,1578.5
20240728,분당선,개포동,2475,2542,5017,2508.5
20240728,분당선,대모산입구,2703,2740,5443,2721.5
20240728,분당선,수서,10276,10701,20977,10488.5
20240728,분당선,복정,7,0,7,3.5
20240728,분당선,수원,6162,5603,11765,5882.5
20240728,분당선,서울숲,7087,6917,14004,7002
20240728,분당선,압구정로데오,10233,10879,21112,10556
20240728,분당선,강남구청,2900,3561,6461,3230.5
20240728,분당선,선정릉,2025,2049,4074,2037
20240728,분당선,가천대,3789,4245,8034,4017
20240728,분당선,태평,8147,7680,15827,7913.5
20240728,분당선,모란,11378,11793,23171,11585.5
20240728,분당선,야탑,13451,13786,27237,13618.5
20240728,분당선,서현,14196,14160,28356,14178
20240728,분당선,수내,6314,6099,12413,6206.5
20240728,분당선,정자,7836,7914,15750,7875
20240728,분당선,미금,7861,8055,15916,7958
20240728,분당선,오리,5318,4859,10177,5088.5
20240728,분당선,이매,3315,3458,6773,3386.5
20240728,분당선,보정,1151,1097,2248,1124
20240728,분당선,죽전,7274,8392,15666,7833
20240728,분당선,구성,3424,3579,7003,3501.5
20240728,분당선,신갈,2128,2304,4432,2216
20240728,분당선,기흥,5330,5067,10397,5198.5
20240728,분당선,상갈,2775,2936,5711,2855.5
20240728,분당선,청명,2270,2271,4541,2270.5
20240728,분당선,영통,5269,5006,10275,5137.5
20240728,분당선,망포,6630,7164,13794,6897
20240728,분당선,매탄권선,2920,2843,5763,2881.5
20240728,분당선,수원시청,7884,7871,15755,7877.5
20240728,분당선,매교,2430,2486,4916,2458
20240728,서해선,김포공항,2695,3234,5929,2964.5
20240728,서해선,원종,3004,3061,6065,3032.5
20240728,서해선,부천종합운동장,1350,1140,2490,1245
20240728,수인선,고색,2074,2195,4269,2134.5
20240728,수인선,오목천,2234,2121,4355,2177.5
20240728,수인선,어천,936,1088,2024,1012
20240728,수인선,야목,255,187,442,221
20240728,수인선,사리,2817,2457,5274,2637
20240728,수인선,달월,53,56,109,54.5
20240728,수인선,월곶,1992,1916,3908,1954
20240728,수인선,소래포구,3656,3372,7028,3514
20240728,수인선,인천논현,3185,3342,6527,3263.5
20240728,수인선,호구포,2149,2285,4434,2217
20240728,수인선,남동인더스파크,742,733,1475,737.5
20240728,수인선,원인재,2867,2891,5758,2879
20240728,수인선,연수,3859,3862,7721,3860.5
20240728,수인선,송도,1446,1460,2906,1453
20240728,수인선,인하대,3558,3357,6915,3457.5
20240728,수인선,숭의,2083,1884,3967,1983.5
20240728,수인선,신포,1216,1174,2390,1195
20240728,수인선,인천,1339,1908,3247,1623.5
20240728,신림선,샛강,956,1091,2047,1023.5
20240728,신림선,대방,1750,1432,3182,1591
20240728,신림선,서울지방병무청,1948,2118,4066,2033
20240728,신림선,보라매,2487,2149,4636,2318
20240728,신림선,보라매공원,1254,1228,2482,1241
20240728,신림선,보라매병원,2437,2587,5024,2512
20240728,신림선,당곡,2838,2870,5708,2854
20240728,신림선,신림,1281,1850,3131,1565.5
20240728,신림선,서원,2199,1985,4184,2092
20240728,신림선,서울대벤처타운,6027,5745,11772,5886
20240728,신림선,관악산(서울대),3984,4194,8178,4089
20240728,안산선,산본,9556,9890,19446,9723
20240728,안산선,대야미,2933,2686,5619,2809.5
20240728,안산선,반월,2488,2484,4972,2486
20240728,안산선,상록수,9363,9469,18832,9416
20240728,안산선,한대앞,5809,5697,11506,5753
20240728,안산선,중앙,12777,12649,25426,12713
20240728,안산선,고잔,4435,4166,8601,4300.5
20240728,안산선,초지,2647,2631,5278,2639
20240728,안산선,안산,11613,10557,22170,11085
20240728,안산선,신길온천,1476,1397,2873,1436.5
20240728,안산선,정왕,6607,6635,13242,6621
20240728,안산선,오이도,6046,5824,11870,5935
20240728,안산선,수리산,2193,1966,4159,2079.5
20240728,우이신설선,북한산우이,3981,4027,8008,4004
20240728,우이신설선,솔밭공원,1726,1593,3319,1659.5
20240728,우이신설선,4.19민주묘지,2160,2000,4160,2080
20240728,우이신설선,가오리,2599,2457,5056,2528
20240728,우이신설선,화계,2421,2274,4695,2347.5
20240728,우이신설선,삼양,1356,1449,2805,1402.5
20240728,우이신설선,삼양사거리,1751,1652,3403,1701.5
20240728,우이신설선,솔샘,3109,2843,5952,2976
20240728,우이신설선,북한산보국문,4039,3552,7591,3795.5
20240728,우이신설선,정릉,3019,2558,5577,2788.5
20240728,우이신설선,성신여대입구(돈암),2471,2758,5229,2614.5
20240728,우이신설선,보문,1111,1129,2240,1120
20240728,우이신설선,신설동,1381,1367,2748,1374
20240728,일산선,원흥,6106,5850,11956,5978
20240728,일산선,삼송,11051,10922,21973,10986.5
20240728,일산선,원당,6227,6043,12270,6135
20240728,일산선,화정,10573,10946,21519,10759.5
20240728,일산선,대곡,1645,1391,3036,1518
20240728,일산선,백석,5878,5859,11737,5868.5
20240728,일산선,마두,3526,3583,7109,3554.5
20240728,일산선,정발산,5867,5710,11577,5788.5
20240728,일산선,주엽,5501,5603,11104,5552
20240728,일산선,대화,7246,6724,13970,6985
20240728,장항선,봉명,666,652,1318,659
20240728,장항선,쌍용(나사렛대),1420,1441,2861,1430.5
20240728,장항선,아산,3483,2770,6253,3126.5
20240728,장항선,탕정,1059,1071,2130,1065
20240728,장항선,배방,876,987,1863,931.5
20240728,장항선,온양온천,4014,4014,8028,4014
20240728,장항선,신창(순천향대),1056,1028,2084,1042
20240728,중앙선,회기,15070,14824,29894,14947
20240728,중앙선,중랑,3526,3435,6961,3480.5
20240728,중앙선,상봉,3973,3909,7882,3941
20240728,중앙선,망우,4860,4815,9675,4837.5
20240728,중앙선,양원,1513,1503,3016,1508
20240728,중앙선,구리,7522,7677,15199,7599.5
20240728,중앙선,도농,5345,5356,10701,5350.5
20240728,중앙선,양정,433,335,768,384
20240728,중앙선,덕소,3391,3404,6795,3397.5
20240728,중앙선,도심,1276,1196,2472,1236
20240728,중앙선,팔당,996,1055,2051,1025.5
20240728,중앙선,운길산,742,694,1436,718
20240728,중앙선,양수,1946,1792,3738,1869
20240728,중앙선,신원,155,111,266,133
20240728,중앙선,국수,584,503,1087,543.5
20240728,중앙선,아신,558,512,1070,535
20240728,중앙선,오빈,225,202,427,213.5
20240728,중앙선,양평,3576,3344,6920,3460
20240728,중앙선,원덕,330,280,610,305
20240728,중앙선,용문,2465,2099,4564,2282
20240728,중앙선,지평,71,56,127,63.5
20240728,1호선,서울역,37091,34653,71744,35872
20240728,1호선,시청,10099,9739,19838,9919
20240728,1호선,종각,14442,13718,28160,14080
20240728,1호선,종로3가,14655,13659,28314,14157
20240728,1호선,종로5가,11087,10644,21731,10865.5
20240728,1호선,동대문,10719,11764,22483,11241.5
20240728,1호선,신설동,8645,8619,17264,8632
20240728,1호선,제기동,9900,10421,20321,10160.5
20240728,1호선,청량리(서울시립대입구),15980,15851,31831,15915.5
20240728,1호선,동묘앞,12607,12512,25119,12559.5
20240728,2호선,시청,8714,6528,15242,7621
20240728,2호선,을지로입구,24600,24224,48824,24412
20240728,2호선,을지로3가,11678,11393,23071,11535.5
20240728,2호선,을지로4가,5727,5445,11172,5586
20240728,2호선,동대문역사문화공원(DDP),12072,14694,26766,13383
20240728,2호선,신당,9613,10220,19833,9916.5
20240728,2호선,상왕십리,7579,7725,15304,7652
20240728,2호선,왕십리(성동구청),9229,8758,17987,8993.5
20240728,2호선,한양대,2752,2940,5692,2846
20240728,2호선,뚝섬,12755,12663,25418,12709
20240728,2호선,성수,25045,27054,52099,26049.5
20240728,2호선,건대입구,26358,27185,53543,26771.5
20240728,2호선,구의(광진구청),12471,12599,25070,12535
20240728,2호선,강변(동서울터미널),22369,20735,43104,21552
20240728,2호선,잠실나루,5425,5550,10975,5487.5
20240728,2호선,잠실(송파구청),59635,56616,116251,58125.5
20240728,2호선,잠실새내,13838,14193,28031,14015.5
20240728,2호선,종합운동장,17318,18839,36157,18078.5
20240728,2호선,삼성(무역센터),24090,22907,46997,23498.5
20240728,2호선,선릉,14772,12962,27734,13867
20240728,2호선,역삼,11658,12762,24420,12210
20240728,2호선,강남,35209,33645,68854,34427
20240728,2호선,교대(법원.검찰청),10021,12006,22027,11013.5
20240728,2호선,서초,13706,13206,26912,13456
20240728,2호선,방배,6806,7107,13913,6956.5
20240728,2호선,사당,23887,25639,49526,24763
20240728,2호선,낙성대(강감찬),16438,16809,33247,16623.5
20240728,2호선,서울대입구(관악구청),26235,26773,53008,26504
20240728,2호선,봉천,13412,12909,26321,13160.5
20240728,2호선,신림,35048,34276,69324,34662
20240728,2호선,신대방,16015,15513,31528,15764
20240728,2호선,구로디지털단지,25605,25091,50696,25348
20240728,2호선,대림(구로구청),16286,16707,32993,16496.5
20240728,2호선,신도림,29844,29685,59529,29764.5
20240728,2호선,문래,8544,8915,17459,8729.5
20240728,2호선,영등포구청,8120,8268,16388,8194
20240728,2호선,당산,8150,8959,17109,8554.5
20240728,2호선,합정,22520,24012,46532,23266
20240728,2호선,홍대입구,66403,68489,134892,67446
20240728,2호선,신촌,24460,24423,48883,24441.5
20240728,2호선,이대,8419,9295,17714,8857
20240728,2호선,아현,5655,5504,11159,5579.5
20240728,2호선,충정로(경기대입구),3689,3973,7662,3831
20240728,2호선,용답,1801,1771,3572,1786
20240728,2호선,신답,775,863,1638,819
20240728,2호선,신설동,3251,3255,6506,3253
20240728,2호선,도림천,578,635,1213,606.5
20240728,2호선,양천구청,3539,3529,7068,3534
20240728,2호선,신정네거리,5585,5541,11126,5563
20240728,2호선,용두(동대문구청),1438,1411,2849,1424.5
20240728,3호선,지축,3983,3936,7919,3959.5
20240728,3호선,구파발,13461,13687,27148,13574
20240728,3호선,연신내,21113,19974,41087,20543.5
20240728,3호선,불광,10079,11655,21734,10867
20240728,3호선,녹번,7326,6791,14117,7058.5
20240728,3호선,홍제,10114,9749,19863,9931.5
20240728,3호선,무악재,2200,2281,4481,2240.5
20240728,3호선,독립문,4769,4793,9562,4781
20240728,3호선,경복궁(정부서울청사),14006,14759,28765,14382.5
20240728,3호선,안국,14739,15383,30122,15061
20240728,3호선,종로3가,5867,6930,12797,6398.5
20240728,3호선,을지로3가,5007,4673,9680,4840
20240728,3호선,충무로,6,0,6,3
20240728,3호선,동대입구,7442,7823,15265,7632.5
20240728,3호선,약수,7502,7133,14635,7317.5
20240728,3호선,금호,4556,4384,8940,4470
20240728,3호선,옥수,5300,5455,10755,5377.5
20240728,3호선,압구정,15278,15817,31095,15547.5
20240728,3호선,신사,11703,12109,23812,11906
20240728,3호선,잠원,2389,2478,4867,2433.5
20240728,3호선,고속터미널,49337,44523,93860,46930
20240728,3호선,교대(법원.검찰청),5746,3078,8824,4412
20240728,3호선,남부터미널(예술의전당),15200,15056,30256,15128
20240728,3호선,양재(서초구청),13346,15390,28736,14368
20240728,3호선,매봉,4909,4767,9676,4838
20240728,3호선,도곡,2212,2052,4264,2132
20240728,3호선,대치,8174,6853,15027,7513.5
20240728,3호선,학여울,792,785,1577,788.5
20240728,3호선,대청,4651,4580,9231,4615.5
20240728,3호선,일원,4098,4193,8291,4145.5
20240728,3호선,수서,11476,11214,22690,11345
20240728,3호선,가락시장,3652,3850,7502,3751
20240728,3호선,경찰병원,3117,3330,6447,3223.5
20240728,3호선,오금,3097,3085,6182,3091
20240728,4호선,당고개,6206,5939,12145,6072.5
20240728,4호선,상계,10932,9983,20915,10457.5
20240728,4호선,노원,17881,19302,37183,18591.5
20240728,4호선,창동,16309,17047,33356,16678
20240728,4호선,쌍문,16757,15339,32096,16048
20240728,4호선,수유(강북구청),21304,20303,41607,20803.5
20240728,4호선,미아(서울사이버대학),8899,8141,17040,8520
20240728,4호선,미아사거리,16526,15729,32255,16127.5
20240728,4호선,길음,11436,11186,22622,11311
20240728,4호선,성신여대입구(돈암),14013,13423,27436,13718
20240728,4호선,한성대입구(삼선교),8276,8389,16665,8332.5
20240728,4호선,혜화,27518,28744,56262,28131
20240728,4호선,동대문,9217,10067,19284,9642
20240728,4호선,동대문역사문화공원(DDP),15293,13353,28646,14323
20240728,4호선,충무로,11586,12076,23662,11831
20240728,4호선,명동,27284,30267,57551,28775.5
20240728,4호선,회현(남대문시장),10980,11049,22029,11014.5
20240728,4호선,서울역,5694,15186,20880,10440
20240728,4호선,숙대입구(갈월),9320,9055,18375,9187.5
20240728,4호선,삼각지,4144,5316,9460,4730
20240728,4호선,신용산,12549,13014,25563,12781.5
20240728,4호선,이촌(국립중앙박물관),7532,7688,15220,7610
20240728,4호선,동작(현충원),983,1061,2044,1022
20240728,4호선,총신대입구(이수),10856,11881,22737,11368.5
20240728,4호선,사당,16523,15792,32315,16157.5
20240728,4호선,남태령,858,622,1480,740
20240728,5호선,방화,4112,4072,8184,4092
20240728,5호선,개화산,3066,3036,6102,3051
20240728,5호선,김포공항,9131,6893,16024,8012
20240728,5호선,송정,3722,3612,7334,3667
20240728,5호선,마곡,4314,4447,8761,4380.5
20240728,5호선,발산,10148,10784,20932,10466
20240728,5호선,우장산,7455,7776,15231,7615.5
20240728,5호선,화곡,14557,13961,28518,14259
20240728,5호선,까치산,15771,15550,31321,15660.5
20240728,5호선,신정(은행정),6523,6018,12541,6270.5
20240728,5호선,목동,8095,8360,16455,8227.5
20240728,5호선,오목교(목동운동장앞),12358,12130,24488,12244
20240728,5호선,양평,2848,2840,5688,2844
20240728,5호선,영등포구청,1780,1654,3434,1717
20240728,5호선,영등포시장,6240,6457,12697,6348.5
20240728,5호선,신길,2685,2891,5576,2788
20240728,5호선,여의도,10477,10477,20954,10477
20240728,5호선,여의나루,11260,12327,23587,11793.5
20240728,5호선,마포,5869,5800,11669,5834.5
20240728,5호선,공덕,5182,5087,10269,5134.5
20240728,5호선,애오개,2817,2732,5549,2774.5
20240728,5호선,충정로(경기대입구),1591,1666,3257,1628.5
20240728,5호선,서대문,5536,5623,11159,5579.5
20240728,5호선,광화문(세종문화회관),14722,15416,30138,15069
20240728,5호선,종로3가,10587,10147,20734,10367
20240728,5호선,을지로4가,2181,2257,4438,2219
20240728,5호선,동대문역사문화공원(DDP),1373,1515,2888,1444
20240728,5호선,청구,1857,1937,3794,1897
20240728,5호선,신금호,3109,3451,6560,3280
20240728,5호선,행당,4041,3748,7789,3894.5
20240728,5호선,왕십리(성동구청),2517,3186,5703,2851.5
20240728,5호선,마장,3010,2835,5845,2922.5
20240728,5호선,답십리,7811,7225,15036,7518
20240728,5호선,장한평,9079,9194,18273,9136.5
20240728,5호선,군자(능동),6521,7339,13860,6930
20240728,5호선,아차산(어린이대공원후문),9347,9145,18492,9246
20240728,5호선,광나루(장신대),8141,7913,16054,8027
20240728,5호선,천호(풍납토성),13385,12654,26039,13019.5
20240728,5호선,강동,9360,9496,18856,9428
20240728,5호선,길동,4676,4730,9406,4703
20240728,5호선,굽은다리(강동구민회관앞),6063,5806,11869,5934.5
20240728,5호선,명일,5485,5397,10882,5441
20240728,5호선,고덕,4841,4874,9715,4857.5
20240728,5호선,상일동,6812,6757,13569,6784.5
20240728,5호선,둔촌동,5161,5202,10363,5181.5
20240728,5호선,올림픽공원(한국체대),5295,6672,11967,5983.5
20240728,5호선,방이,4380,4172,8552,4276
20240728,5호선,오금,1731,1665,3396,1698
20240728,5호선,개롱,3344,3500,6844,3422
20240728,5호선,거여,4703,4631,9334,4667
20240728,5호선,마천,3824,3777,7601,3800.5
20240728,5호선,강일,3280,2975,6255,3127.5
20240728,5호선,미사,9978,10435,20413,10206.5
20240728,5호선,하남풍산,2875,2908,5783,2891.5
20240728,5호선,하남시청(덕풍·신장),4921,4679,9600,4800
20240728,5호선,하남검단산,4859,4856,9715,4857.5
20240728,6호선,응암,9672,9600,19272,9636
20240728,6호선,역촌,2285,2571,4856,2428
20240728,6호선,불광,3456,2994,6450,3225
20240728,6호선,독바위,1591,1810,3401,1700.5
20240728,6호선,연신내,1,0,1,0.5
20240728,6호선,구산,4469,3520,7989,3994.5
20240728,6호선,새절(신사),6582,6419,13001,6500.5
20240728,6호선,증산(명지대앞),5560,5644,11204,5602
20240728,6호선,디지털미디어시티,5812,6220,12032,6016
20240728,6호선,월드컵경기장(성산),3270,3281,6551,3275.5
20240728,6호선,마포구청,7491,7041,14532,7266
20240728,6호선,망원,10571,11253,21824,10912
20240728,6호선,합정,9947,9107,19054,9527
20240728,6호선,상수,7851,8329,16180,8090
20240728,6호선,광흥창(서강),4727,4577,9304,4652
20240728,6호선,대흥(서강대앞),4397,4591,8988,4494
20240728,6호선,공덕,7493,7191,14684,7342
20240728,6호선,효창공원앞,3632,3244,6876,3438
20240728,6호선,삼각지,5066,4143,9209,4604.5
20240728,6호선,녹사평(용산구청),3903,3916,7819,3909.5
20240728,6호선,한강진,8033,9024,17057,8528.5
20240728,6호선,버티고개,1137,1225,2362,1181
20240728,6호선,약수,1966,1940,3906,1953
20240728,6호선,청구,2032,1826,3858,1929
20240728,6호선,신당,5215,5593,10808,5404
20240728,6호선,동묘앞,6882,6718,13600,6800
20240728,6호선,창신,1790,1611,3401,1700.5
20240728,6호선,보문,4229,4189,8418,4209
20240728,6호선,안암(고대병원앞),5009,5148,10157,5078.5
20240728,6호선,고려대(종암),4122,4037,8159,4079.5
20240728,6호선,월곡(동덕여대),5721,5555,11276,5638
20240728,6호선,상월곡(한국과학기술연구원),3463,3225,6688,3344
20240728,6호선,돌곶이,6284,6022,12306,6153
20240728,6호선,석계,6620,6821,13441,6720.5
20240728,6호선,태릉입구,3420,3733,7153,3576.5
20240728,6호선,화랑대(서울여대입구),5495,4727,10222,5111
20240728,6호선,봉화산(서울의료원),4113,4043,8156,4078
20240728,7호선,장암,1867,1372,3239,1619.5
20240728,7호선,도봉산,5025,7388,12413,6206.5
20240728,7호선,수락산,8702,8566,17268,8634
20240728,7호선,마들,6350,5914,12264,6132
20240728,7호선,노원,14698,14936,29634,14817
20240728,7호선,중계,7854,7288,15142,7571
20240728,7호선,하계,9607,8899,18506,9253
20240728,7호선,공릉(서울과학기술대),6614,6681,13295,6647.5
20240728,7호선,태릉입구,5290,5032,10322,5161
20240728,7호선,먹골,5640,5551,11191,5595.5
20240728,7호선,중화,5888,5848,11736,5868
20240728,7호선,상봉,10006,9432,19438,9719
20240728,7호선,면목,8002,7729,15731,7865.5
20240728,7호선,사가정,8915,8890,17805,8902.5
20240728,7호선,용마산(용마폭포공원),3037,3258,6295,3147.5
20240728,7호선,중곡,5712,5636,11348,5674
20240728,7호선,군자(능동),8569,6604,15173,7586.5
20240728,7호선,어린이대공원(세종대),7637,7594,15231,7615.5
20240728,7호선,건대입구,7524,7972,15496,7748
20240728,7호선,자양(뚝섬한강공원),7448,7124,14572,7286
20240728,7호선,청담,5661,6052,11713,5856.5
20240728,7호선,강남구청,5082,5567,10649,5324.5
20240728,7호선,학동,6359,6652,13011,6505.5
20240728,7호선,논현,6053,6453,12506,6253
20240728,7호선,반포,3216,3101,6317,3158.5
20240728,7호선,고속터미널,14683,8706,23389,11694.5
20240728,7호선,내방,5446,5657,11103,5551.5
20240728,7호선,이수,9025,8834,17859,8929.5
20240728,7호선,남성,6188,6090,12278,6139
20240728,7호선,숭실대입구(살피재),6170,6494,12664,6332
20240728,7호선,상도,5969,5877,11846,5923
20240728,7호선,장승배기,4726,4760,9486,4743
20240728,7호선,신대방삼거리,8020,7970,15990,7995
20240728,7호선,보라매,3720,3922,7642,3821
20240728,7호선,신풍,6210,5904,12114,6057
20240728,7호선,대림(구로구청),9281,8947,18228,9114
20240728,7호선,남구로,7028,6884,13912,6956
20240728,7호선,가산디지털단지,9915,9457,19372,9686
20240728,7호선,철산,10849,10924,21773,10886.5
20240728,7호선,광명사거리,11952,11956,23908,11954
20240728,7호선,천왕,5378,5128,10506,5253
20240728,7호선,온수(성공회대입구),4200,4165,8365,4182.5
20240728,8호선,암사,9413,8860,18273,9136.5
20240728,8호선,천호(풍납토성),9144,10371,19515,9757.5
20240728,8호선,강동구청,4718,4787,9505,4752.5
20240728,8호선,몽촌토성(평화의문),3622,3588,7210,3605
20240728,8호선,잠실(송파구청),12595,13687,26282,13141
20240728,8호선,석촌,4388,5638,10026,5013
20240728,8호선,송파,4977,4940,9917,4958.5
20240728,8호선,가락시장,3085,3858,6943,3471.5
20240728,8호선,문정,5303,5635,10938,5469
20240728,8호선,장지,9344,8971,18315,9157.5
20240728,8호선,복정,5025,4625,9650,4825
20240728,8호선,산성,3327,3675,7002,3501
20240728,8호선,남한산성입구(성남법원.검찰청),6575,5914,12489,6244.5
20240728,8호선,단대오거리,5966,5872,11838,5919
20240728,8호선,신흥,3117,3354,6471,3235.5
20240728,8호선,수진,3879,3656,7535,3767.5
20240728,8호선,모란,2929,2439,5368,2684
20240728,8호선,남위례,3312,3393,6705,3352.5
20240728,9호선,개화,1201,1046,2247,1123.5
20240728,9호선,김포공항,5945,8888,14833,7416.5
20240728,9호선,공항시장,1982,2139,4121,2060.5
20240728,9호선,신방화,3894,3948,7842,3921
20240728,9호선,마곡나루(서울식물원),5583,5859,11442,5721
20240728,9호선,양천향교,4779,4887,9666,4833
20240728,9호선,가양,11202,11259,22461,11230.5
20240728,9호선,증미,2715,2872,5587,2793.5
20240728,9호선,등촌,5721,5895,11616,5808
20240728,9호선,염창,9347,9152,18499,9249.5
20240728,9호선,신목동,1967,1807,3774,1887
20240728,9호선,선유도,3087,3138,6225,3112.5
20240728,9호선,당산,9556,9606,19162,9581
20240728,9호선,국회의사당,5716,5547,11263,5631.5
20240728,9호선,여의도,12335,10829,23164,11582
20240728,9호선,샛강,2137,1982,4119,2059.5
20240728,9호선,노량진,15048,15786,30834,15417
20240728,9호선,노들,2945,2593,5538,2769
20240728,9호선,흑석(중앙대입구),4283,4368,8651,4325.5
20240728,9호선,동작(현충원),1214,1068,2282,1141
20240728,9호선,구반포,366,401,767,383.5
20240728,9호선,신반포,2543,2624,5167,2583.5
20240728,9호선,고속터미널,13039,18639,31678,15839
20240728,9호선,사평,1936,2051,3987,1993.5
20240728,9호선,신논현,17395,17399,34794,17397
20240728,9호선2~3단계,언주,4456,4514,8970,4485
20240728,9호선2~3단계,선정릉,3208,3598,6806,3403
20240728,9호선2~3단계,삼성중앙,2237,2431,4668,2334
20240728,9호선2~3단계,봉은사,11763,12009,23772,11886
20240728,9호선2~3단계,종합운동장,3088,2961,6049,3024.5
20240728,9호선2~3단계,삼전,4124,4055,8179,4089.5
20240728,9호선2~3단계,석촌고분,3917,3812,7729,3864.5
20240728,9호선2~3단계,석촌,5523,4820,10343,5171.5
20240728,9호선2~3단계,송파나루,3706,4098,7804,3902
20240728,9호선2~3단계,한성백제,1745,1616,3361,1680.5
20240728,9호선2~3단계,올림픽공원(한국체대),11731,10630,22361,11180.5
20240728,9호선2~3단계,둔촌오륜,807,796,1603,801.5
20240728,9호선2~3단계,중앙보훈병원,4458,4470,8928,4464
20240728,경강선,판교,3114,2773,5887,2943.5
20240728,경강선,이매,776,569,1345,672.5
20240728,경강선,삼동,1115,1118,2233,1116.5
20240728,경강선,경기광주,4060,4251,8311,4155.5
20240728,경강선,초월,1805,1858,3663,1831.5
20240728,경강선,곤지암,1768,1860,3628,1814
20240728,경강선,신둔도예촌,993,978,1971,985.5
20240728,경강선,이천,2472,2626,5098,2549
20240728,경강선,부발,1616,2003,3619,1809.5
20240728,경강선,세종대왕릉,384,371,755,377.5
20240728,경강선,여주,2639,2639,5278,2639
20240728,경강선,성남,647,509,1156,578
20240728,경부선,서울역,11017,3367,14384,7192
20240728,경부선,남영,5177,5641,10818,5409
20240728,경부선,용산,43939,40265,84204,42102
20240728,경부선,노량진,5579,5210,10789,5394.5
20240728,경부선,대방,5044,5714,10758,5379
20240728,경부선,영등포,37759,37201,74960,37480
20240728,경부선,신도림,2317,2667,4984,2492
20240728,경부선,신길,4763,4173,8936,4468
20240728,경부선,구로,10257,10644,20901,10450.5
20240728,경부선,가산디지털단지,4924,6527,11451,5725.5
20240728,경부선,금천구청,5838,5885,11723,5861.5
20240728,경부선,석수,4711,4596,9307,4653.5
20240728,경부선,관악,4893,4529,9422,4711
20240728,경부선,안양,13815,13375,27190,13595
20240728,경부선,명학,3276,3113,6389,3194.5
20240728,경부선,금정,15572,16099,31671,15835.5
20240728,경부선,군포,2997,2797,5794,2897
20240728,경부선,의왕,4148,4289,8437,4218.5
20240728,경부선,성균관대,8437,8893,17330,8665
20240728,경부선,화서,10088,9884,19972,9986
20240728,경부선,수원,38171,37559,75730,37865
20240728,경부선,독산,6365,6458,12823,6411.5
20240728,경부선,세류,2463,2383,4846,2423
20240728,경부선,병점,10225,11110,21335,10667.5
20240728,경부선,세마,2081,1949,4030,2015
20240728,경부선,오산대,2438,2253,4691,2345.5
20240728,경부선,오산,8707,9019,17726,8863
20240728,경부선,진위,1025,969,1994,997
20240728,경부선,송탄,3816,4169,7985,3992.5
20240728,경부선,서정리,5357,6987,12344,6172
20240728,경부선,평택지제,3201,3000,6201,3100.5
20240728,경부선,평택,12772,13155,25927,12963.5
20240728,경부선,성환,2901,3085,5986,2993
20240728,경부선,직산,682,691,1373,686.5
20240728,경부선,두정,5395,5808,11203,5601.5
20240728,경부선,천안,7047,6810,13857,6928.5
20240728,경부선,당정,3120,3078,6198,3099
20240728,경부선,서동탄,801,821,1622,811
20240728,경부선,광명,3178,2284,5462,2731
20240729,1호선,청량리(서울시립대입구),22345,21700,44045,22022.5
20240729,1호선,동묘앞,7804,7626,15430,7715
20240729,2호선,시청,27790,26659,54449,27224.5
20240729,공항철도 1호선,운서,9749,10127,19876,9938
20240729,공항철도 1호선,청라국제도시,7478,6980,14458,7229
20240729,공항철도 1호선,검암,6743,6834,13577,6788.5
20240729,공항철도 1호선,계양,13620,12712,26332,13166
20240729,공항철도 1호선,김포공항,9399,5721,15120,7560
20240729,공항철도 1호선,마곡나루(서울식물원),11090,10482,21572,10786
20240729,공항철도 1호선,디지털미디어시티,14400,13567,27967,13983.5
20240729,공항철도 1호선,홍대입구,15165,14395,29560,14780
20240729,공항철도 1호선,공덕,3005,3794,6799,3399.5
20240729,공항철도 1호선,서울역,14359,12923,27282,13641
20240729,경춘선,춘천,1396,1292,2688,1344
20240729,경춘선,남춘천,2522,2584,5106,2553
20240729,경춘선,김유정,382,387,769,384.5
20240729,경춘선,강촌,444,441,885,442.5
20240729,경춘선,백양리,94,101,195,97.5
20240729,경춘선,굴봉산,173,128,301,150.5
20240729,경춘선,가평,2343,2716,5059,2529.5
20240729,경춘선,상천,242,222,464,232
20240729,경춘선,청평,1943,2006,3949,1974.5
20240729,경춘선,대성리,690,950,1640,820
20240729,경춘선,마석,3541,3377,6918,3459
20240729,경춘선,천마산,1428,1312,2740,1370
20240729,경춘선,평내호평,5953,5597,11550,5775
20240729,경춘선,금곡,1463,1418,2881,1440.5
20240729,경춘선,사릉,2023,1957,3980,1990
20240729,경춘선,퇴계원,3595,3420,7015,3507.5
20240729,경춘선,별내,3367,3146,6513,3256.5
20240729,경춘선,갈매,2966,2535,5501,2750.5
20240729,경춘선,신내,2726,2425,5151,2575.5
20240729,경인선,도화,4046,3756,7802,3901
20240729,경인선,중동,9146,8507,17653,8826.5
20240729,경인선,온수(성공회대입구),5966,5600,11566,5783
20240729,경인선,도원,2671,2722,5393,2696.5
20240729,경인선,간석,5781,5462,11243,5621.5
20240729,경인선,부개,8444,7972,16416,8208
20240729,경인선,소사,7338,6813,14151,7075.5
20240729,경인선,구일,6066,6194,12260,6130
20240729,경인선,인천,3741,3126,6867,3433.5
20240729,경인선,동인천,13052,12363,25415,12707.5
20240729,경인선,제물포,9967,9513,19480,9740
20240729,경인선,주안,18032,16284,34316,17158
20240729,경인선,동암,15473,15353,30826,15413
20240729,경인선,백운,7368,7138,14506,7253
20240729,경인선,부평,29177,30098,59275,29637.5
20240729,경인선,송내,26074,25615,51689,25844.5
20240729,경인선,부천,31059,30790,61849,30924.5
20240729,경인선,역곡,25225,25211,50436,25218
20240729,경인선,오류동,11449,10764,22213,11106.5
20240729,경인선,개봉,21295,21095,42390,21195
20240729,경의선,운천,4,2,6,3
20240729,경의선,임진강,8,2,10,5
20240729,경의선,문산,5783,5254,11037,5518.5
20240729,경의선,파주,1241,940,2181,1090.5
20240729,경의선,월롱,1887,1736,3623,1811.5
20240729,경의선,금촌,6514,6152,12666,6333
20240729,경의선,금릉,5540,5103,10643,5321.5
20240729,경의선,운정,7741,7155,14896,7448
20240729,경의선,야당,8574,8526,17100,8550
20240729,경의선,탄현,7842,7624,15466,7733
20240729,경의선,일산,10404,10295,20699,10349.5
20240729,경의선,풍산,6198,5994,12192,6096
20240729,경의선,백마,7287,7120,14407,7203.5
20240729,경의선,곡산,654,675,1329,664.5
20240729,경의선,능곡,4667,4293,8960,4480
20240729,경의선,행신,8176,8371,16547,8273.5
20240729,경의선,강매,3234,2682,5916,2958
20240729,경의선,한국항공대,1790,1690,3480,1740
20240729,경의선,수색,3452,3455,6907,3453.5
20240729,경의선,디지털미디어시티,2760,2598,5358,2679
20240729,경의선,가좌,5832,5626,11458,5729
20240729,경의선,홍대입구,2115,2602,4717,2358.5
20240729,경의선,서강대,2109,2008,4117,2058.5
20240729,경의선,공덕,4239,3638,7877,3938.5
20240729,경의선,효창공원앞,3168,3598,6766,3383
20240729,경의선,신촌,1014,1312,2326,1163
20240729,경의선,서울역,5050,6213,11263,5631.5
20240729,경원선,연천,1252,1031,2283,1141.5
20240729,경원선,전곡,1170,975,2145,1072.5
20240729,경원선,청산,153,125,278,139
20240729,경원선,소요산,1495,1448,2943,1471.5
20240729,경원선,동두천,1628,1625,3253,1626.5
20240729,경원선,보산,1435,1262,2697,1348.5
20240729,경원선,동두천중앙,3034,2815,5849,2924.5
20240729,경원선,지행,6343,6235,12578,6289
20240729,경원선,덕정,5903,5577,11480,5740
20240729,경원선,덕계,5813,5314,11127,5563.5
20240729,경원선,양주,7170,6817,13987,6993.5
20240729,경원선,녹양,4147,3980,8127,4063.5
20240729,경원선,가능,6528,6298,12826,6413
20240729,경원선,의정부,18380,18452,36832,18416
20240729,경원선,회룡,12816,12594,25410,12705
20240729,경원선,망월사,6973,7003,13976,6988
20240729,경원선,도봉산,7006,4205,11211,5605.5
20240729,경원선,도봉,5922,5652,11574,5787
20240729,경원선,방학,9666,9558,19224,9612
20240729,경원선,창동,2,0,2,1
20240729,경원선,녹천,4475,3829,8304,4152
20240729,경원선,월계,6289,5868,12157,6078.5
20240729,경원선,광운대,7477,7118,14595,7297.5
20240729,경원선,석계,7321,8368,15689,7844.5
20240729,경원선,신이문,8553,7835,16388,8194
20240729,경원선,외대앞,8252,8323,16575,8287.5
20240729,경원선,청량리(서울시립대입구),16411,17077,33488,16744
20240729,경원선,왕십리(성동구청),15863,16155,32018,16009
20240729,경원선,응봉,1785,1507,3292,1646
20240729,경원선,옥수,56,39,95,47.5
20240729,경원선,한남,4003,3987,7990,3995
20240729,경원선,서빙고,2107,1819,3926,1963
20240729,경원선,이촌(국립중앙박물관),3827,3079,6906,3453
20240729,5호선,방화,7080,6858,13938,6969
20240729,5호선,개화산,6084,5797,11881,5940.5
20240729,5호선,김포공항,10905,8017,18922,9461
20240729,5호선,송정,6356,6102,12458,6229
20240729,5호선,마곡,12642,12750,25392,12696
20240729,5호선,발산,22761,23300,46061,23030.5
20240729,5호선,우장산,14456,14305,28761,14380.5
20240729,5호선,화곡,28695,26762,55457,27728.5
20240729,5호선,까치산,27931,26977,54908,27454
20240729,5호선,신정(은행정),13717,11396,25113,12556.5
20240729,5호선,목동,16257,17770,34027,17013.5
20240729,5호선,오목교(목동운동장앞),20788,21842,42630,21315
20240729,5호선,양평,8074,7948,16022,8011
20240729,5호선,영등포구청,4771,4953,9724,4862
20240729,5호선,영등포시장,11612,11612,23224,11612
20240729,5호선,신길,5147,5266,10413,5206.5
20240729,5호선,여의도,31682,33034,64716,32358
20240729,5호선,여의나루,13365,15444,28809,14404.5
20240729,5호선,마포,15366,15552,30918,15459
20240729,5호선,공덕,14811,15717,30528,15264
20240729,5호선,애오개,6938,6790,13728,6864
20240729,5호선,충정로(경기대입구),4931,5053,9984,4992
20240729,5호선,서대문,20577,20902,41479,20739.5
20240729,5호선,광화문(세종문화회관),34097,35595,69692,34846
20240729,5호선,종로3가,14994,15094,30088,15044
20240729,5호선,을지로4가,6885,6878,13763,6881.5
20240729,5호선,동대문역사문화공원(DDP),3513,3815,7328,3664
20240729,5호선,신금호,6194,6608,12802,6401
20240729,5호선,행당,7826,7020,14846,7423
20240729,5호선,왕십리(성동구청),4389,5045,9434,4717
20240729,5호선,마장,5693,5280,10973,5486.5
20240729,5호선,답십리,15966,14524,30490,15245
20240729,5호선,장한평,19327,19207,38534,19267
20240729,5호선,군자(능동),11031,12090,23121,11560.5
20240729,5호선,아차산(어린이대공원후문),13296,13348,26644,13322
20240729,5호선,광나루(장신대),12743,11675,24418,12209
20240729,5호선,천호(풍납토성),19163,18846,38009,19004.5
20240729,5호선,강동,18604,18368,36972,18486
20240729,5호선,길동,8472,8757,17229,8614.5
20240729,5호선,굽은다리(강동구민회관앞),9610,9439,19049,9524.5
20240729,5호선,명일,8552,8687,17239,8619.5
20240729,5호선,고덕,10819,10750,21569,10784.5
20240729,5호선,상일동,15022,14123,29145,14572.5
20240729,5호선,둔촌동,8780,8696,17476,8738
20240729,5호선,올림픽공원(한국체대),5228,4360,9588,4794
20240729,5호선,방이,7149,7363,14512,7256
20240729,5호선,오금,3679,3738,7417,3708.5
20240729,5호선,개롱,6542,6777,13319,6659.5
20240729,5호선,거여,10005,9772,19777,9888.5
20240729,5호선,마천,7355,6784,14139,7069.5
20240729,5호선,강일,5972,5458,11430,5715
20240729,5호선,미사,17515,17734,35249,17624.5
20240729,5호선,하남풍산,4529,4495,9024,4512
20240729,5호선,하남시청(덕풍·신장),8404,7961,16365,8182.5
20240729,5호선,하남검단산,6384,5959,12343,6171.5
20240729,6호선,응암,17549,17405,34954,17477
20240729,6호선,역촌,3868,4475,8343,4171.5
20240729,6호선,불광,4838,4646,9484,4742
20240729,6호선,독바위,2859,2925,5784,2892
20240729,6호선,연신내,3,0,3,1.5
20240729,6호선,구산,8169,6346,14515,7257.5
20240729,6호선,새절(신사),12704,11724,24428,12214
20240729,6호선,증산(명지대앞),9753,9638,19391,9695.5
20240729,6호선,디지털미디어시티,15007,16419,31426,15713
20240729,6호선,월드컵경기장(성산),4274,4495,8769,4384.5
20240729,6호선,마포구청,14435,13217,27652,13826
20240729,6호선,망원,14418,15327,29745,14872.5
20240729,6호선,합정,12956,12548,25504,12752
20240729,6호선,상수,9144,9647,18791,9395.5
20240729,6호선,광흥창(서강),9537,9022,18559,9279.5
20240729,6호선,대흥(서강대앞),8419,8945,17364,8682
20240729,6호선,공덕,19711,19089,38800,19400
20240729,6호선,효창공원앞,7185,6304,13489,6744.5
20240729,6호선,삼각지,6534,6224,12758,6379
20240729,6호선,녹사평(용산구청),4698,4617,9315,4657.5
20240729,6호선,이태원,9903,10315,20218,10109
20240729,6호선,한강진,7280,8550,15830,7915
20240729,6호선,버티고개,2107,2121,4228,2114
20240729,6호선,약수,3645,3630,7275,3637.5
20240729,6호선,청구,4029,3894,7923,3961.5
20240729,6호선,신당,8493,8797,17290,8645
20240729,6호선,동묘앞,8093,8418,16511,8255.5
20240729,6호선,창신,3399,2721,6120,3060
20240729,6호선,보문,7797,7220,15017,7508.5
20240729,6호선,안암(고대병원앞),11105,11332,22437,11218.5
20240729,6호선,고려대(종암),8340,8137,16477,8238.5
20240729,6호선,월곡(동덕여대),12063,11884,23947,11973.5
20240729,6호선,상월곡(한국과학기술연구원),6364,5733,12097,6048.5
20240729,6호선,돌곶이,10087,9355,19442,9721
20240729,6호선,석계,12083,12387,24470,12235
20240729,6호선,태릉입구,5512,6040,11552,5776
20240729,6호선,화랑대(서울여대입구),11383,8956,20339,10169.5
20240729,6호선,봉화산(서울의료원),9124,8494,17618,8809
20240729,6호선,신내,1,0,1,0.5
20240729,7호선,장암,2769,1087,3856,1928
20240729,7호선,도봉산,8774,9943,18717,9358.5
20240729,7호선,수락산,11846,11958,23804,11902
20240729,7호선,마들,12810,12119,24929,12464.5
20240729,7호선,노원,24143,25046,49189,24594.5
20240729,7호선,중계,14192,13021,27213,13606.5
20240729,7호선,하계,17493,16494,33987,16993.5
20240729,7호선,공릉(서울과학기술대),11506,11491,22997,11498.5
20240729,7호선,태릉입구,8458,7967,16425,8212.5
20240729,7호선,먹골,10151,9983,20134,10067
20240729,7호선,중화,10488,10229,20717,10358.5
20240729,7호선,상봉,17436,16944,34380,17190
20240729,7호선,면목,14850,14311,29161,14580.5
20240729,7호선,사가정,15808,16115,31923,15961.5
20240729,7호선,용마산(용마폭포공원),5680,5444,11124,5562
20240729,7호선,중곡,10643,10171,20814,10407
20240729,7호선,군자(능동),15431,12390,27821,13910.5
20240729,7호선,어린이대공원(세종대),13192,13002,26194,13097
20240729,7호선,건대입구,12673,13026,25699,12849.5
20240729,7호선,자양(뚝섬한강공원),8761,8518,17279,8639.5
20240729,7호선,청담,19193,20876,40069,20034.5
20240729,7호선,강남구청,16344,17826,34170,17085
20240729,7호선,학동,24797,25447,50244,25122
20240729,7호선,논현,19308,19553,38861,19430.5
20240729,7호선,반포,6250,5954,12204,6102
20240729,7호선,고속터미널,18004,14326,32330,16165
20240729,7호선,내방,15037,15075,30112,15056
20240729,7호선,이수,16318,16020,32338,16169
20240729,7호선,남성,11151,10776,21927,10963.5
20240729,7호선,숭실대입구(살피재),11999,12086,24085,12042.5
20240729,7호선,상도,11071,10824,21895,10947.5
20240729,7호선,장승배기,9358,9241,18599,9299.5
20240729,7호선,신대방삼거리,15011,14586,29597,14798.5
20240729,7호선,보라매,6504,6817,13321,6660.5
20240729,7호선,신풍,10876,10236,21112,10556
20240729,7호선,대림(구로구청),9107,9093,18200,9100
20240729,7호선,남구로,15435,16156,31591,15795.5
20240729,7호선,가산디지털단지,48333,48313,96646,48323
20240729,7호선,철산,21507,21744,43251,21625.5
20240729,7호선,광명사거리,19853,19488,39341,19670.5
20240729,7호선,천왕,11436,11089,22525,11262.5
20240729,7호선,온수(성공회대입구),9254,8344,17598,8799
20240729,8호선,암사,19074,17098,36172,18086
20240729,8호선,천호(풍납토성),15315,17226,32541,16270.5
20240729,8호선,강동구청,10439,10859,21298,10649
20240729,8호선,몽촌토성(평화의문),6821,6910,13731,6865.5
20240729,8호선,잠실(송파구청),16938,19504,36442,18221
20240729,8호선,석촌,8105,9283,17388,8694
20240729,8호선,송파,9247,9166,18413,9206.5
20240729,8호선,가락시장,7823,8571,16394,8197
20240729,8호선,문정,23355,24417,47772,23886
20240729,8호선,장지,16899,16193,33092,16546
20240729,8호선,복정,8817,7500,16317,8158.5
20240729,8호선,산성,6169,6335,12504,6252
20240729,8호선,남한산성입구(성남법원.검찰청),12780,11535,24315,12157.5
20240729,8호선,단대오거리,11983,11628,23611,11805.5
20240729,8호선,신흥,5218,5379,10597,5298.5
20240729,8호선,수진,5389,4950,10339,5169.5
20240729,8호선,모란,5756,4437,10193,5096.5
20240729,8호선,남위례,7027,7034,14061,7030.5
20240729,9호선,개화,2936,2014,4950,2475
20240729,9호선,김포공항,6757,9658,16415,8207.5
20240729,9호선,공항시장,3053,3413,6466,3233
20240729,9호선,신방화,7083,7089,14172,7086
20240729,9호선,마곡나루(서울식물원),13853,13723,27576,13788
20240729,9호선,양천향교,10309,10424,20733,10366.5
20240729,9호선,가양,22507,22240,44747,22373.5
20240729,9호선,증미,8652,8422,17074,8537
20240729,9호선,등촌,12783,12337,25120,12560
20240729,9호선,염창,18088,17499,35587,17793.5
20240729,9호선,신목동,4452,3996,8448,4224
20240729,9호선,선유도,9162,8799,17961,8980.5
20240729,9호선,당산,19338,19395,38733,19366.5
20240729,9호선,국회의사당,17170,17799,34969,17484.5
20240729,9호선,여의도,32933,31858,64791,32395.5
20240729,9호선,샛강,6886,6965,13851,6925.5
20240729,9호선,노량진,25320,24768,50088,25044
20240729,9호선,노들,4856,4060,8916,4458
20240729,9호선,흑석(중앙대입구),8359,8670,17029,8514.5
20240729,9호선,동작(현충원),1721,1408,3129,1564.5
20240729,9호선,구반포,1405,1302,2707,1353.5
20240729,9호선,신반포,3934,3869,7803,3901.5
20240729,9호선,고속터미널,14902,19962,34864,17432
20240729,9호선,사평,3760,3666,7426,3713
20240729,9호선,신논현,31541,31490,63031,31515.5
20240729,9호선2~3단계,언주,12992,13316,26308,13154
20240729,9호선2~3단계,선정릉,10220,11045,21265,10632.5
20240729,9호선2~3단계,삼성중앙,8139,8735,16874,8437
20240729,9호선2~3단계,봉은사,20972,22084,43056,21528
20240729,9호선2~3단계,종합운동장,4768,4808,9576,4788
20240729,9호선2~3단계,삼전,8187,7764,15951,7975.5
20240729,9호선2~3단계,석촌고분,7339,7146,14485,7242.5
20240729,9호선2~3단계,석촌,9518,8382,17900,8950
20240729,9호선2~3단계,송파나루,5654,6111,11765,5882.5
20240729,9호선2~3단계,한성백제,3100,2732,5832,2916
20240729,9호선2~3단계,올림픽공원(한국체대),5097,5413,10510,5255
20240729,9호선2~3단계,둔촌오륜,1186,1212,2398,1199
20240729,9호선2~3단계,중앙보훈병원,12788,11212,24000,12000
20240729,경강선,판교,6113,5949,12062,6031
20240729,경강선,이매,1059,915,1974,987
20240729,경강선,삼동,2609,2523,5132,2566
20240729,경강선,경기광주,8130,7630,15760,7880
20240729,경강선,초월,3513,3424,6937,3468.5
20240729,경강선,곤지암,2189,2162,4351,2175.5
20240729,경강선,신둔도예촌,1455,1387,2842,1421
20240729,경강선,이천,2852,3001,5853,2926.5
20240729,경강선,부발,2218,2205,4423,2211.5
20240729,경강선,세종대왕릉,364,339,703,351.5
20240729,경강선,여주,2987,2706,5693,2846.5
20240729,경강선,성남,950,841,1791,895.5
20240729,경부선,서울역,10598,3705,14303,7151.5
20240729,경부선,남영,9419,9767,19186,9593
20240729,경부선,용산,42609,43558,86167,43083.5
20240729,경부선,노량진,7738,7585,15323,7661.5
20240729,경부선,대방,10352,11247,21599,10799.5
20240729,경부선,영등포,40581,41327,81908,40954
20240729,경부선,신도림,3811,4075,7886,3943
20240729,경부선,신길,8616,7367,15983,7991.5
20240729,경부선,구로,17660,17547,35207,17603.5
20240729,경부선,가산디지털단지,18305,21082,39387,19693.5
20240729,경부선,금천구청,10839,10933,21772,10886
20240729,경부선,석수,8336,7546,15882,7941
20240729,경부선,관악,7055,6803,13858,6929
20240729,경부선,안양,20088,20128,40216,20108
20240729,경부선,명학,8364,8323,16687,8343.5
20240729,경부선,금정,26877,27371,54248,27124
20240729,경부선,군포,6946,6807,13753,6876.5
20240729,경부선,의왕,8807,8693,17500,8750
20240729,경부선,성균관대,14360,14360,28720,14360
20240729,경부선,화서,12282,11778,24060,12030
20240729,경부선,수원,36404,37797,74201,37100.5
20240729,경부선,독산,17507,18321,35828,17914
20240729,2호선,을지로입구,51190,52474,103664,51832
20240729,2호선,을지로3가,26144,26007,52151,26075.5
20240729,2호선,을지로4가,15140,14822,29962,14981
20240729,2호선,동대문역사문화공원(DDP),15083,17616,32699,16349.5
20240729,2호선,신당,14592,15067,29659,14829.5
20240729,2호선,상왕십리,14519,14285,28804,14402
20240729,2호선,왕십리(성동구청),14641,13495,28136,14068
20240729,2호선,한양대,7993,8476,16469,8234.5
20240729,2호선,뚝섬,25070,26681,51751,25875.5
20240729,2호선,성수,44079,47709,91788,45894
20240729,2호선,건대입구,34244,35941,70185,35092.5
20240729,경부선,세류,3472,3196,6668,3334
20240729,경부선,병점,14066,14015,28081,14040.5
20240729,경부선,세마,3233,2997,6230,3115
20240729,경부선,오산대,3425,3077,6502,3251
20240729,경부선,오산,9799,9995,19794,9897
20240729,경부선,진위,1532,1462,2994,1497
20240729,경부선,송탄,4215,4145,8360,4180
20240729,경부선,서정리,7803,7553,15356,7678
20240729,경부선,평택지제,4229,4031,8260,4130
20240729,경부선,평택,12542,12154,24696,12348
20240729,경부선,성환,3827,3828,7655,3827.5
20240729,경부선,직산,1077,1036,2113,1056.5
20240729,경부선,두정,6198,6379,12577,6288.5
20240729,경부선,천안,6067,6217,12284,6142
20240729,경부선,당정,5703,5518,11221,5610.5
20240729,경부선,서동탄,1593,1337,2930,1465
20240729,경부선,광명,4231,3684,7915,3957.5
20240729,2호선,구의(광진구청),25322,24826,50148,25074
20240729,2호선,강변(동서울터미널),32108,29507,61615,30807.5
20240729,2호선,잠실나루,15771,15251,31022,15511
20240729,2호선,잠실(송파구청),84413,83897,168310,84155
20240729,2호선,잠실새내,22901,22115,45016,22508
20240729,2호선,종합운동장,6628,7252,13880,6940
20240729,2호선,삼성(무역센터),56454,57514,113968,56984
20240729,2호선,선릉,62658,54997,117655,58827.5
20240729,2호선,역삼,56390,63928,120318,60159
20240729,2호선,강남,84740,83047,167787,83893.5
20240729,2호선,교대(법원.검찰청),31311,36907,68218,34109
20240729,2호선,서초,22138,21605,43743,21871.5
20240729,2호선,방배,15131,15587,30718,15359
20240729,2호선,사당,38652,41778,80430,40215
20240729,2호선,낙성대(강감찬),27543,27191,54734,27367
20240729,2호선,서울대입구(관악구청),45856,45299,91155,45577.5
20240729,2호선,봉천,24460,23276,47736,23868
20240729,2호선,신림,54659,53019,107678,53839
20240729,2호선,신대방,25437,24638,50075,25037.5
20240729,2호선,구로디지털단지,59117,58853,117970,58985
20240729,2호선,대림(구로구청),23809,24139,47948,23974
20240729,2호선,신도림,48916,47168,96084,48042
20240729,2호선,문래,24204,24673,48877,24438.5
20240729,2호선,영등포구청,22932,23388,46320,23160
20240729,2호선,당산,17691,20780,38471,19235.5
20240729,2호선,합정,30625,32676,63301,31650.5
20240729,2호선,홍대입구,69854,74098,143952,71976
20240729,2호선,신촌,34201,34959,69160,34580
20240729,2호선,이대,14773,16280,31053,15526.5
20240729,2호선,아현,10481,9900,20381,10190.5
20240729,2호선,충정로(경기대입구),10455,11020,21475,10737.5
20240729,2호선,용답,2855,2790,5645,2822.5
20240729,2호선,신답,1663,1866,3529,1764.5
20240729,2호선,신설동,3146,3173,6319,3159.5
20240729,2호선,도림천,1376,1391,2767,1383.5
20240729,2호선,양천구청,6566,7067,13633,6816.5
20240729,2호선,신정네거리,10124,10462,20586,10293
20240729,2호선,용두(동대문구청),2543,2625,5168,2584
20240729,3호선,지축,7509,7479,14988,7494
20240729,3호선,구파발,22054,21320,43374,21687
20240729,3호선,연신내,33486,31972,65458,32729
20240729,3호선,불광,16391,17602,33993,16996.5
20240729,3호선,녹번,15493,14222,29715,14857.5
20240729,3호선,홍제,17529,16752,34281,17140.5
20240729,3호선,무악재,4449,4350,8799,4399.5
20240729,3호선,독립문,6925,6890,13815,6907.5
20240729,3호선,경복궁(정부서울청사),23287,24238,47525,23762.5
20240729,3호선,안국,25475,26083,51558,25779
20240729,3호선,종로3가,11969,13437,25406,12703
20240729,3호선,을지로3가,12408,12055,24463,12231.5
20240729,3호선,충무로,4,0,4,2
20240729,3호선,동대입구,7634,8467,16101,8050.5
20240729,3호선,약수,12825,12483,25308,12654
20240729,3호선,금호,7962,7505,15467,7733.5
20240729,3호선,옥수,8501,8795,17296,8648
20240729,3호선,압구정,32299,34014,66313,33156.5
20240729,3호선,신사,28205,29460,57665,28832.5
20240729,3호선,잠원,5025,4840,9865,4932.5
20240729,3호선,고속터미널,47291,44547,91838,45919
20240729,3호선,교대(법원.검찰청),16576,10074,26650,13325
20240729,3호선,남부터미널(예술의전당),29928,30295,60223,30111.5
20240729,3호선,양재(서초구청),37297,40274,77571,38785.5
20240729,3호선,매봉,13357,12787,26144,13072
20240729,3호선,도곡,5730,5444,11174,5587
20240729,3호선,대치,13173,12641,25814,12907
20240729,3호선,학여울,1801,1861,3662,1831
20240729,3호선,대청,10636,10097,20733,10366.5
20240729,3호선,일원,10795,10722,21517,10758.5
20240729,3호선,수서,18283,18356,36639,18319.5
20240729,3호선,가락시장,9051,8790,17841,8920.5
20240729,3호선,경찰병원,8013,7979,15992,7996
20240729,3호선,오금,6726,5890,12616,6308
20240729,4호선,당고개,9578,8117,17695,8847.5
20240729,4호선,상계,18979,17715,36694,18347
20240729,4호선,노원,28098,31233,59331,29665.5
20240729,4호선,창동,25471,26750,52221,26110.5
20240729,4호선,쌍문,29526,27431,56957,28478.5
20240729,4호선,수유(강북구청),33139,33261,66400,33200
20240729,4호선,미아(서울사이버대학),15302,15007,30309,15154.5
20240729,4호선,미아사거리,26178,25963,52141,26070.5
20240729,4호선,길음,20533,20138,40671,20335.5
20240729,4호선,성신여대입구(돈암),20354,19996,40350,20175
20240729,4호선,한성대입구(삼선교),12529,12019,24548,12274
20240729,4호선,혜화,31566,31958,63524,31762
20240729,4호선,동대문,22704,23239,45943,22971.5
20240729,4호선,동대문역사문화공원(DDP),20508,17874,38382,19191
20240729,4호선,충무로,30449,31324,61773,30886.5
20240729,4호선,명동,33905,36589,70494,35247
20240729,4호선,회현(남대문시장),29085,30239,59324,29662
20240729,4호선,서울역,13568,22582,36150,18075
20240729,4호선,숙대입구(갈월),13601,13345,26946,13473
20240729,4호선,삼각지,5668,6401,12069,6034.5
20240729,4호선,신용산,20404,22050,42454,21227
20240729,4호선,이촌(국립중앙박물관),9553,10319,19872,9936
20240729,4호선,동작(현충원),1286,1429,2715,1357.5
20240729,4호선,총신대입구(이수),18723,20198,38921,19460.5
20240729,4호선,사당,24988,21678,46666,23333
20240729,4호선,남태령,1342,1141,2483,1241.5
20240729,신림선,관악산(서울대),2777,2702,5479,2739.5
20240729,신림선,서울대벤처타운,9572,9167,18739,9369.5
20240729,신림선,서원,3629,3209,6838,3419
20240729,신림선,신림,1963,2586,4549,2274.5
20240729,신림선,당곡,4859,4949,9808,4904
20240729,신림선,보라매병원,8056,8515,16571,8285.5
20240729,신림선,보라매공원,2291,2529,4820,2410
20240729,신림선,보라매,4102,3742,7844,3922
20240729,신림선,서울지방병무청,3006,3396,6402,3201
20240729,신림선,대방,3000,2496,5496,2748
20240729,신림선,샛강,3102,3428,6530,3265
20240729,수인선,인천,1126,1716,2842,1421
20240729,수인선,신포,1670,1702,3372,1686
20240729,수인선,숭의,3993,3657,7650,3825
20240729,수인선,인하대,5972,5669,11641,5820.5
20240729,수인선,송도,2279,2074,4353,2176.5
20240729,수인선,연수,4533,4522,9055,4527.5
20240729,수인선,원인재,4130,4266,8396,4198
20240729,수인선,남동인더스파크,2174,2361,4535,2267.5
20240729,수인선,호구포,3722,3838,7560,3780
20240729,수인선,인천논현,5272,5500,10772,5386
20240729,수인선,소래포구,4657,4326,8983,4491.5
20240729,수인선,월곶,2566,2298,4864,2432
20240729,수인선,달월,121,75,196,98
20240729,수인선,사리,4763,4110,8873,4436.5
20240729,수인선,야목,420,375,795,397.5
20240729,수인선,어천,1302,1288,2590,1295
20240729,수인선,오목천,3784,3318,7102,3551
20240729,수인선,고색,5013,4572,9585,4792.5
20240729,서해선,부천종합운동장,2604,2122,4726,2363
20240729,서해선,원종,4674,4614,9288,4644
20240729,서해선,김포공항,3064,3879,6943,3471.5
20240729,분당선,매교,4753,4759,9512,4756
20240729,분당선,수원시청,13648,14505,28153,14076.5
20240729,분당선,매탄권선,5034,4881,9915,4957.5
20240729,분당선,망포,14862,14537,29399,14699.5
20240729,분당선,영통,8365,8499,16864,8432
20240729,분당선,청명,4423,4214,8637,4318.5
20240729,분당선,상갈,5199,4911,10110,5055
20240729,분당선,기흥,10121,9443,19564,9782
20240729,분당선,신갈,4907,4872,9779,4889.5
20240729,분당선,구성,6257,6350,12607,6303.5
20240729,분당선,죽전,12124,13516,25640,12820
20240729,분당선,보정,2441,2161,4602,2301
20240729,분당선,이매,5340,5153,10493,5246.5
20240729,분당선,오리,11363,9985,21348,10674
20240729,분당선,미금,15395,16001,31396,15698
20240729,분당선,정자,17418,18272,35690,17845
20240729,분당선,수내,14018,14179,28197,14098.5
20240729,분당선,서현,24325,24667,48992,24496
20240729,분당선,야탑,24967,26474,51441,25720.5
20240729,분당선,모란,23430,24011,47441,23720.5
20240729,분당선,태평,13440,12729,26169,13084.5
20240729,공항철도 1호선,공항화물청사,2240,2436,4676,2338
20240729,분당선,가천대,6784,7104,13888,6944
20240729,분당선,선정릉,7950,8155,16105,8052.5
20240729,분당선,강남구청,9718,11158,20876,10438
20240729,분당선,압구정로데오,17852,19198,37050,18525
20240729,분당선,서울숲,12820,12885,25705,12852.5
20240729,분당선,수원,7882,7226,15108,7554
20240729,분당선,수서,16850,17499,34349,17174.5
20240729,분당선,대모산입구,5884,5596,11480,5740
20240729,분당선,개포동,4394,4549,8943,4471.5
20240729,분당선,구룡,3446,3346,6792,3396
20240729,분당선,도곡,7348,7795,15143,7571.5
20240729,분당선,한티,16101,17126,33227,16613.5
20240729,분당선,선릉,14232,21843,36075,18037.5
20240729,과천선,범계,26717,26579,53296,26648
20240729,과천선,평촌,18427,18052,36479,18239.5
20240729,과천선,인덕원,24690,25517,50207,25103.5
20240729,과천선,정부과천청사,12431,13068,25499,12749.5
20240729,과천선,과천,6361,5824,12185,6092.5
20240729,과천선,대공원,2568,2662,5230,2615
20240729,과천선,경마공원,816,791,1607,803.5
20240729,과천선,선바위,7404,6573,13977,6988.5
20240729,공항철도 1호선,영종,4416,4265,8681,4340.5
20240729,공항철도 1호선,인천공항2터미널,7192,6731,13923,6961.5
20240729,공항철도 1호선,인천공항1터미널,14721,15713,30434,15217
20240729,중앙선,지평,59,65,124,62
20240729,중앙선,용문,1993,2060,4053,2026.5
20240729,중앙선,원덕,363,338,701,350.5
20240729,중앙선,양평,3115,3051,6166,3083
20240729,중앙선,오빈,303,276,579,289.5
20240729,중앙선,아신,557,535,1092,546
20240729,중앙선,국수,663,658,1321,660.5
20240729,중앙선,신원,150,151,301,150.5
20240729,중앙선,양수,1921,1930,3851,1925.5
20240729,중앙선,운길산,641,604,1245,622.5
20240729,중앙선,팔당,781,781,1562,781
20240729,중앙선,도심,2362,1836,4198,2099
20240729,중앙선,덕소,5274,5151,10425,5212.5
20240729,중앙선,양정,638,509,1147,573.5
20240729,중앙선,도농,10726,9972,20698,10349
20240729,중앙선,구리,13153,13113,26266,13133
20240729,중앙선,양원,2881,2883,5764,2882
20240729,중앙선,망우,7484,7320,14804,7402
20240729,중앙선,상봉,5807,5926,11733,5866.5
20240729,중앙선,중랑,5540,5281,10821,5410.5
20240729,중앙선,회기,23272,22118,45390,22695
20240729,장항선,신창(순천향대),1130,1207,2337,1168.5
20240729,장항선,온양온천,5587,5574,11161,5580.5
20240729,장항선,배방,1170,1151,2321,1160.5
20240729,장항선,탕정,1618,1500,3118,1559
20240729,장항선,아산,3718,3461,7179,3589.5
20240729,장항선,쌍용(나사렛대),2397,2212,4609,2304.5
20240729,장항선,봉명,1421,1440,2861,1430.5
20240729,일산선,대화,13467,10301,23768,11884
20240729,일산선,주엽,10036,10073,20109,10054.5
20240729,일산선,정발산,6929,7049,13978,6989
20240729,일산선,마두,8145,8217,16362,8181
20240729,일산선,백석,10015,10095,20110,10055
20240729,일산선,대곡,2946,2250,5196,2598
20240729,일산선,화정,16994,17082,34076,17038
20240729,일산선,원당,10927,10349,21276,10638
20240729,일산선,삼송,19336,18414,37750,18875
20240729,일산선,지축,2,0,2,1
20240729,일산선,원흥,11404,10951,22355,11177.5
20240729,우이신설선,신설동,2405,2206,4611,2305.5
20240729,우이신설선,보문,1523,1601,3124,1562
20240729,우이신설선,성신여대입구(돈암),3555,3741,7296,3648
20240729,우이신설선,정릉,4443,4106,8549,4274.5
20240729,우이신설선,북한산보국문,5815,5698,11513,5756.5
20240729,우이신설선,솔샘,5807,5660,11467,5733.5
20240729,우이신설선,삼양사거리,2631,2665,5296,2648
20240729,우이신설선,삼양,2250,2406,4656,2328
20240729,우이신설선,화계,3699,3469,7168,3584
20240729,우이신설선,가오리,4338,4358,8696,4348
20240729,우이신설선,4.19민주묘지,3004,2799,5803,2901.5
20240729,우이신설선,솔밭공원,2626,2583,5209,2604.5
20240729,우이신설선,북한산우이,2869,2638,5507,2753.5
20240729,안산선,수리산,3863,3212,7075,3537.5
20240729,안산선,오이도,7793,7425,15218,7609
20240729,안산선,정왕,8776,9017,17793,8896.5
20240729,안산선,신길온천,2079,1821,3900,1950
20240729,안산선,안산,12693,11821,24514,12257
20240729,안산선,초지,4986,4943,9929,4964.5
20240729,안산선,고잔,8738,8083,16821,8410.5
20240729,안산선,중앙,17901,18444,36345,18172.5
20240729,안산선,한대앞,8754,8658,17412,8706
20240729,안산선,상록수,14192,14460,28652,14326
20240729,안산선,반월,4175,4042,8217,4108.5
20240729,안산선,대야미,4785,4228,9013,4506.5
20240729,안산선,산본,15770,16739,32509,16254.5
20240729,5호선,청구,3940,3756,7696,3848
20240729,분당선,복정,2,0,2,1
20240729,1호선,서울역,58420,54055,112475,56237.5
20240729,1호선,시청,25349,25493,50842,25421
20240729,1호선,종각,40855,40420,81275,40637.5
20240729,1호선,종로3가,25209,22794,48003,24001.5
20240729,1호선,종로5가,23946,23583,47529,23764.5
20240729,1호선,동대문,11782,11838,23620,11810
20240729,1호선,신설동,14188,13867,28055,14027.5
20240729,1호선,제기동,16098,16583,32681,16340.5
20240730,경부선,서동탄,1593,1329,2922,1461
20240730,수인선,월곶,2689,2457,5146,2573
20240730,수인선,달월,111,61,172,86
20240730,수인선,사리,4838,4248,9086,4543
20240730,수인선,야목,434,363,797,398.5
20240730,수인선,어천,1394,1388,2782,1391
20240730,수인선,오목천,3811,3418,7229,3614.5
20240730,수인선,고색,5124,4750,9874,4937
20240730,서해선,부천종합운동장,2708,2211,4919,2459.5
20240730,서해선,원종,4773,4859,9632,4816
20240730,서해선,김포공항,3149,4074,7223,3611.5
20240730,분당선,매교,4857,4801,9658,4829
20240730,분당선,수원시청,13761,14821,28582,14291
20240730,분당선,매탄권선,5375,5282,10657,5328.5
20240730,분당선,망포,15391,14706,30097,15048.5
20240730,분당선,영통,8572,8582,17154,8577
20240730,분당선,청명,4532,4307,8839,4419.5
20240730,분당선,상갈,5284,5196,10480,5240
20240730,분당선,기흥,10374,9524,19898,9949
20240730,분당선,신갈,4934,5001,9935,4967.5
20240730,분당선,구성,6379,6412,12791,6395.5
20240730,분당선,죽전,12401,13930,26331,13165.5
20240730,분당선,보정,2531,2263,4794,2397
20240730,분당선,이매,5378,5312,10690,5345
20240730,분당선,오리,11756,10124,21880,10940
20240730,분당선,미금,15641,16372,32013,16006.5
20240730,분당선,정자,18498,19310,37808,18904
20240730,분당선,수내,14426,14681,29107,14553.5
20240730,분당선,서현,25248,25613,50861,25430.5
20240730,분당선,야탑,26100,27325,53425,26712.5
20240730,분당선,모란,19867,20031,39898,19949
20240730,분당선,태평,13507,12699,26206,13103
20240730,분당선,가천대,7039,7395,14434,7217
20240730,분당선,선정릉,8142,8589,16731,8365.5
20240730,분당선,강남구청,9952,11485,21437,10718.5
20240730,분당선,압구정로데오,19755,21224,40979,20489.5
20240730,분당선,서울숲,13245,13391,26636,13318
20240730,분당선,수원,8085,7299,15384,7692
20240730,분당선,복정,7,0,7,3.5
20240730,분당선,수서,16885,17553,34438,17219
20240730,분당선,대모산입구,5991,5698,11689,5844.5
20240730,분당선,개포동,4376,4523,8899,4449.5
20240730,분당선,구룡,3408,3434,6842,3421
20240730,분당선,도곡,7499,7819,15318,7659
20240730,분당선,한티,16421,17274,33695,16847.5
20240730,분당선,선릉,14586,21810,36396,18198
20240730,과천선,범계,27805,27619,55424,27712
20240730,과천선,평촌,18346,17700,36046,18023
20240730,과천선,인덕원,25693,26302,51995,25997.5
20240730,과천선,정부과천청사,12803,13337,26140,13070
20240730,과천선,과천,6666,6202,12868,6434
20240730,과천선,대공원,4014,4193,8207,4103.5
20240730,과천선,경마공원,1530,1480,3010,1505
20240730,과천선,선바위,7900,6939,14839,7419.5
20240730,공항철도 1호선,영종,4508,4395,8903,4451.5
20240730,공항철도 1호선,인천공항2터미널,7513,6620,14133,7066.5
20240730,공항철도 1호선,인천공항1터미널,14434,14780,29214,14607
20240730,공항철도 1호선,공항화물청사,2240,2407,4647,2323.5
20240730,공항철도 1호선,운서,9951,10397,20348,10174
20240730,공항철도 1호선,청라국제도시,7951,7547,15498,7749
20240730,공항철도 1호선,검암,6730,6967,13697,6848.5
20240730,공항철도 1호선,계양,13776,13225,27001,13500.5
20240730,공항철도 1호선,김포공항,9188,6098,15286,7643
20240730,공항철도 1호선,마곡나루(서울식물원),11727,11228,22955,11477.5
20240730,공항철도 1호선,디지털미디어시티,15522,14490,30012,15006
20240730,공항철도 1호선,홍대입구,15535,14807,30342,15171
20240730,공항철도 1호선,공덕,3036,3943,6979,3489.5
20240730,공항철도 1호선,서울역,14028,12397,26425,13212.5
20240730,경춘선,춘천,1424,1217,2641,1320.5
20240730,경춘선,남춘천,2496,2635,5131,2565.5
20240730,경춘선,김유정,410,401,811,405.5
20240730,경춘선,강촌,564,474,1038,519
20240730,경춘선,백양리,121,77,198,99
20240730,경춘선,굴봉산,236,134,370,185
20240730,경춘선,가평,2896,2625,5521,2760.5
20240730,경춘선,상천,254,258,512,256
20240730,경춘선,청평,2101,1838,3939,1969.5
20240730,경춘선,대성리,1023,926,1949,974.5
20240730,경춘선,마석,3656,3589,7245,3622.5
20240730,경춘선,천마산,1434,1333,2767,1383.5
20240730,경춘선,평내호평,6128,5908,12036,6018
20240730,경춘선,금곡,1488,1312,2800,1400
20240730,경춘선,사릉,2080,2005,4085,2042.5
20240730,경춘선,퇴계원,3586,3392,6978,3489
20240730,경춘선,별내,3552,3332,6884,3442
20240730,경춘선,갈매,3037,2660,5697,2848.5
20240730,경춘선,신내,2900,2631,5531,2765.5
20240730,경인선,도화,4084,3718,7802,3901
20240730,경인선,중동,9251,8596,17847,8923.5
20240730,경인선,온수(성공회대입구),6052,5734,11786,5893
20240730,경인선,도원,2610,2683,5293,2646.5
20240730,경인선,간석,5781,5687,11468,5734
20240730,경인선,부개,8765,8168,16933,8466.5
20240730,경인선,소사,7231,6854,14085,7042.5
20240730,경인선,구일,9468,9681,19149,9574.5
20240730,경인선,인천,4172,3431,7603,3801.5
20240730,경인선,동인천,13858,13084,26942,13471
20240730,경인선,제물포,10209,9679,19888,9944
20240730,경인선,주안,18090,16372,34462,17231
20240730,경인선,동암,15518,15543,31061,15530.5
20240730,경인선,백운,7418,7129,14547,7273.5
20240730,경인선,부평,29197,30513,59710,29855
20240730,경인선,송내,27059,26615,53674,26837
20240730,경인선,부천,31231,31402,62633,31316.5
20240730,경인선,역곡,25812,25897,51709,25854.5
20240730,경인선,오류동,11481,10692,22173,11086.5
20240730,경인선,개봉,21858,21581,43439,21719.5
20240730,경의선,운천,1,1,2,1
20240730,경의선,임진강,14,2,16,8
20240730,경의선,문산,5449,5395,10844,5422
20240730,경의선,파주,1146,961,2107,1053.5
20240730,경의선,월롱,1940,1781,3721,1860.5
20240730,5호선,마천,7651,6930,14581,7290.5
20240730,5호선,거여,10336,9986,20322,10161
20240730,5호선,개롱,6711,6859,13570,6785
20240730,5호선,오금,3743,3763,7506,3753
20240730,5호선,방이,7351,7667,15018,7509
20240730,5호선,올림픽공원(한국체대),5444,4423,9867,4933.5
20240730,5호선,강일,6148,5628,11776,5888
20240730,5호선,미사,18045,18256,36301,18150.5
20240730,5호선,하남풍산,4586,4679,9265,4632.5
20240730,5호선,하남시청(덕풍·신장),8398,8003,16401,8200.5
20240730,5호선,하남검단산,6423,6137,12560,6280
20240730,6호선,응암,18120,18035,36155,18077.5
20240730,6호선,역촌,3991,4577,8568,4284
20240730,6호선,불광,5065,4866,9931,4965.5
20240730,6호선,독바위,2865,3039,5904,2952
20240730,6호선,연신내,4,0,4,2
20240730,6호선,구산,8452,6683,15135,7567.5
20240730,6호선,새절(신사),13141,12252,25393,12696.5
20240730,6호선,증산(명지대앞),10069,10030,20099,10049.5
20240730,6호선,디지털미디어시티,15707,17089,32796,16398
20240730,6호선,월드컵경기장(성산),14686,15271,29957,14978.5
20240730,6호선,마포구청,15338,13828,29166,14583
20240730,6호선,망원,15656,16828,32484,16242
20240730,6호선,합정,14341,14062,28403,14201.5
20240730,6호선,상수,9838,10740,20578,10289
20240730,6호선,광흥창(서강),9889,9473,19362,9681
20240730,6호선,대흥(서강대앞),8675,9087,17762,8881
20240730,6호선,공덕,20489,20115,40604,20302
20240730,6호선,효창공원앞,7349,6509,13858,6929
20240730,6호선,삼각지,8004,7020,15024,7512
20240730,6호선,녹사평(용산구청),4970,4811,9781,4890.5
20240730,6호선,이태원,10534,10902,21436,10718
20240730,6호선,한강진,9703,11382,21085,10542.5
20240730,6호선,버티고개,2209,2219,4428,2214
20240730,6호선,약수,3892,3830,7722,3861
20240730,6호선,청구,4110,4055,8165,4082.5
20240730,6호선,신당,9243,9626,18869,9434.5
20240730,6호선,동묘앞,8529,8890,17419,8709.5
20240730,6호선,창신,3437,2746,6183,3091.5
20240730,6호선,보문,7974,7417,15391,7695.5
20240730,6호선,안암(고대병원앞),11482,11468,22950,11475
20240730,6호선,고려대(종암),8617,8248,16865,8432.5
20240730,6호선,월곡(동덕여대),12094,11856,23950,11975
20240730,6호선,상월곡(한국과학기술연구원),6471,5843,12314,6157
20240730,6호선,돌곶이,10266,9441,19707,9853.5
20240730,6호선,석계,12541,13039,25580,12790
20240730,6호선,태릉입구,5749,6297,12046,6023
20240730,6호선,화랑대(서울여대입구),12008,9365,21373,10686.5
20240730,6호선,봉화산(서울의료원),9456,8770,18226,9113
20240730,7호선,장암,3078,1316,4394,2197
20240730,7호선,도봉산,8969,10423,19392,9696
20240730,7호선,수락산,12499,12502,25001,12500.5
20240730,7호선,마들,13494,12781,26275,13137.5
20240730,7호선,노원,24810,25918,50728,25364
20240730,7호선,중계,14596,13319,27915,13957.5
20240730,7호선,하계,18428,17325,35753,17876.5
20240730,7호선,공릉(서울과학기술대),11779,11890,23669,11834.5
20240730,7호선,태릉입구,8885,8287,17172,8586
20240730,7호선,먹골,10432,10331,20763,10381.5
20240730,7호선,중화,10627,10448,21075,10537.5
20240730,7호선,상봉,18202,17667,35869,17934.5
20240730,7호선,면목,15066,14636,29702,14851
20240730,7호선,사가정,16328,16479,32807,16403.5
20240730,7호선,용마산(용마폭포공원),5752,5663,11415,5707.5
20240730,7호선,중곡,11019,10563,21582,10791
20240730,7호선,군자(능동),15871,12657,28528,14264
20240730,7호선,어린이대공원(세종대),14088,13881,27969,13984.5
20240730,7호선,건대입구,13312,13324,26636,13318
20240730,7호선,자양(뚝섬한강공원),9550,9173,18723,9361.5
20240730,7호선,청담,19799,21513,41312,20656
20240730,7호선,강남구청,17017,19021,36038,18019
20240730,7호선,학동,25464,26351,51815,25907.5
20240730,7호선,논현,19806,20059,39865,19932.5
20240730,7호선,반포,6385,5994,12379,6189.5
20240730,7호선,고속터미널,17611,14822,32433,16216.5
20240730,7호선,내방,15364,15529,30893,15446.5
20240730,7호선,이수,16807,16552,33359,16679.5
20240730,7호선,남성,11645,11187,22832,11416
20240730,7호선,숭실대입구(살피재),12280,12305,24585,12292.5
20240730,7호선,상도,11472,11173,22645,11322.5
20240730,7호선,장승배기,9555,9420,18975,9487.5
20240730,7호선,신대방삼거리,15353,14666,30019,15009.5
20240730,7호선,보라매,6602,6829,13431,6715.5
20240730,7호선,신풍,11541,10723,22264,11132
20240730,7호선,대림(구로구청),9321,9545,18866,9433
20240730,7호선,남구로,15525,16292,31817,15908.5
20240730,7호선,가산디지털단지,48707,48809,97516,48758
20240730,7호선,철산,21858,22169,44027,22013.5
20240730,7호선,광명사거리,20238,19891,40129,20064.5
20240730,7호선,천왕,11697,11198,22895,11447.5
20240730,7호선,온수(성공회대입구),9341,8439,17780,8890
20240730,8호선,암사,19782,17573,37355,18677.5
20240730,8호선,천호(풍납토성),15771,17632,33403,16701.5
20240730,8호선,강동구청,10836,11132,21968,10984
20240730,8호선,몽촌토성(평화의문),6947,7152,14099,7049.5
20240730,8호선,잠실(송파구청),17543,20451,37994,18997
20240730,8호선,석촌,8541,9656,18197,9098.5
20240730,8호선,송파,9505,9301,18806,9403
20240730,8호선,가락시장,8099,8903,17002,8501
20240730,8호선,문정,23391,24544,47935,23967.5
20240730,8호선,장지,18060,16759,34819,17409.5
20240730,8호선,복정,9493,7973,17466,8733
20240730,8호선,산성,6342,6472,12814,6407
20240730,8호선,남한산성입구(성남법원.검찰청),12943,11678,24621,12310.5
20240730,8호선,단대오거리,11992,11577,23569,11784.5
20240730,8호선,신흥,5148,5439,10587,5293.5
20240730,8호선,수진,5363,4940,10303,5151.5
20240730,8호선,모란,4669,3588,8257,4128.5
20240730,8호선,남위례,7124,7213,14337,7168.5
20240730,9호선,개화,3122,2141,5263,2631.5
20240730,9호선,김포공항,7206,10472,17678,8839
20240730,9호선,공항시장,3174,3445,6619,3309.5
20240730,9호선,신방화,7260,7127,14387,7193.5
20240730,9호선,마곡나루(서울식물원),14672,14428,29100,14550
20240730,9호선,양천향교,10414,10785,21199,10599.5
20240730,9호선,가양,22975,22636,45611,22805.5
20240730,9호선,증미,8842,8722,17564,8782
20240730,9호선,등촌,13082,12630,25712,12856
20240730,9호선,염창,18562,17885,36447,18223.5
20240730,9호선,신목동,4555,4047,8602,4301
20240730,9호선,선유도,9459,9014,18473,9236.5
20240730,9호선,당산,20624,20304,40928,20464
20240730,9호선,국회의사당,17690,18349,36039,18019.5
20240730,9호선,여의도,33881,32863,66744,33372
20240730,9호선,샛강,6958,6910,13868,6934
20240730,9호선,노량진,26075,25412,51487,25743.5
20240730,9호선,노들,5024,4182,9206,4603
20240730,9호선,흑석(중앙대입구),8835,8956,17791,8895.5
20240730,9호선,동작(현충원),1941,1647,3588,1794
20240730,9호선,구반포,1378,1304,2682,1341
20240730,9호선,신반포,4020,3994,8014,4007
20240730,9호선,고속터미널,15466,20190,35656,17828
20240730,9호선,사평,3901,3738,7639,3819.5
20240730,9호선,신논현,32785,32610,65395,32697.5
20240730,9호선2~3단계,언주,13092,13495,26587,13293.5
20240730,9호선2~3단계,선정릉,10812,11541,22353,11176.5
20240730,9호선2~3단계,삼성중앙,8398,8884,17282,8641
20240730,9호선2~3단계,봉은사,21729,22365,44094,22047
20240730,9호선2~3단계,종합운동장,5369,5462,10831,5415.5
20240730,9호선2~3단계,삼전,8361,7888,16249,8124.5
20240730,9호선2~3단계,석촌고분,7510,7436,14946,7473
20240730,9호선2~3단계,석촌,9997,8953,18950,9475
20240730,9호선2~3단계,송파나루,5845,6327,12172,6086
20240730,9호선2~3단계,한성백제,3253,2937,6190,3095
20240730,9호선2~3단계,올림픽공원(한국체대),5354,5808,11162,5581
20240730,9호선2~3단계,둔촌오륜,1242,1195,2437,1218.5
20240730,9호선2~3단계,중앙보훈병원,13405,11798,25203,12601.5
20240730,경강선,판교,6176,6060,12236,6118
20240730,경강선,이매,1043,943,1986,993
20240730,경강선,삼동,2636,2459,5095,2547.5
20240730,경강선,경기광주,8282,7878,16160,8080
20240730,경강선,초월,3600,3426,7026,3513
20240730,경강선,곤지암,2276,2141,4417,2208.5
20240730,경강선,신둔도예촌,1501,1436,2937,1468.5
20240730,경강선,이천,2808,3004,5812,2906
20240730,경강선,부발,2315,2219,4534,2267
20240730,경강선,세종대왕릉,348,357,705,352.5
20240730,경강선,여주,2774,2698,5472,2736
20240730,경강선,성남,1004,889,1893,946.5
20240730,경부선,서울역,10383,3233,13616,6808
20240730,경부선,남영,9668,10104,19772,9886
20240730,경부선,용산,43099,43856,86955,43477.5
20240730,경부선,노량진,7921,7822,15743,7871.5
20240730,경부선,대방,10565,11614,22179,11089.5
20240730,경부선,영등포,42037,42912,84949,42474.5
20240730,경부선,신도림,3977,4124,8101,4050.5
20240730,경부선,신길,8870,7479,16349,8174.5
20240730,경부선,구로,17610,18000,35610,17805
20240730,경부선,가산디지털단지,18364,21358,39722,19861
20240730,경부선,금천구청,11046,11125,22171,11085.5
20240730,경부선,석수,8517,7822,16339,8169.5
20240730,경부선,관악,7266,7122,14388,7194
20240730,경부선,안양,20488,20422,40910,20455
20240730,경부선,명학,8373,8294,16667,8333.5
20240730,경부선,금정,27587,28242,55829,27914.5
20240730,경부선,군포,6995,6744,13739,6869.5
20240730,경부선,의왕,8901,8852,17753,8876.5
20240730,경부선,성균관대,14538,14314,28852,14426
20240730,경부선,화서,12593,12505,25098,12549
20240730,경부선,수원,37227,38849,76076,38038
20240730,경부선,독산,17764,18563,36327,18163.5
20240730,경부선,세류,3567,3093,6660,3330
20240730,경부선,병점,14472,14265,28737,14368.5
20240730,경부선,세마,3310,3095,6405,3202.5
20240730,경부선,오산대,3465,3169,6634,3317
20240730,경부선,오산,9691,9845,19536,9768
20240730,경부선,진위,1606,1534,3140,1570
20240730,경부선,송탄,4208,4219,8427,4213.5
20240730,경부선,서정리,7813,7326,15139,7569.5
20240730,경부선,평택지제,4104,4039,8143,4071.5
20240730,경부선,평택,12411,12037,24448,12224
20240730,경부선,성환,3723,3668,7391,3695.5
20240730,경부선,직산,1047,1008,2055,1027.5
20240730,경부선,두정,6161,6226,12387,6193.5
20240730,경부선,천안,6010,6291,12301,6150.5
20240730,경부선,당정,5921,5638,11559,5779.5
20240730,경의선,금촌,6489,6215,12704,6352
20240730,경부선,광명,4088,3401,7489,3744.5
20240730,경원선,이촌(국립중앙박물관),4000,3067,7067,3533.5
20240730,경원선,서빙고,2186,2096,4282,2141
20240730,경원선,한남,3982,3786,7768,3884
20240730,경원선,옥수,62,44,106,53
20240730,경원선,응봉,1850,1547,3397,1698.5
20240730,경원선,왕십리(성동구청),16461,16863,33324,16662
20240730,경원선,청량리(서울시립대입구),16917,17538,34455,17227.5
20240730,경원선,외대앞,8570,8300,16870,8435
20240730,경원선,신이문,8650,8031,16681,8340.5
20240730,경원선,석계,7503,8694,16197,8098.5
20240730,경원선,광운대,7948,7453,15401,7700.5
20240730,경원선,월계,6434,6012,12446,6223
20240730,경원선,녹천,4615,3864,8479,4239.5
20240730,경원선,창동,3,0,3,1.5
20240730,경원선,방학,10153,9751,19904,9952
20240730,경원선,도봉,6048,5857,11905,5952.5
20240730,경원선,도봉산,7527,4697,12224,6112
20240730,경원선,망월사,7132,7181,14313,7156.5
20240730,경원선,회룡,13220,12956,26176,13088
20240730,경원선,의정부,19021,19251,38272,19136
20240730,경원선,가능,6563,6389,12952,6476
20240730,경원선,녹양,4259,4102,8361,4180.5
20240730,경원선,양주,7360,6834,14194,7097
20240730,경원선,덕계,5944,5421,11365,5682.5
20240730,경원선,덕정,5984,5656,11640,5820
20240730,경원선,지행,6364,6366,12730,6365
20240730,경원선,동두천중앙,3193,3098,6291,3145.5
20240730,경원선,보산,1388,1325,2713,1356.5
20240730,경원선,동두천,1719,1710,3429,1714.5
20240730,경원선,소요산,1878,1857,3735,1867.5
20240730,경원선,청산,152,123,275,137.5
20240730,경원선,전곡,1188,966,2154,1077
20240730,경원선,연천,1335,1215,2550,1275
20240730,경의선,서울역,5004,5917,10921,5460.5
20240730,경의선,신촌,1047,1467,2514,1257
20240730,경의선,효창공원앞,3321,3689,7010,3505
20240730,경의선,공덕,4504,3547,8051,4025.5
20240730,경의선,서강대,2121,2125,4246,2123
20240730,경의선,홍대입구,2165,2761,4926,2463
20240730,경의선,가좌,5917,5729,11646,5823
20240730,경의선,디지털미디어시티,3003,2814,5817,2908.5
20240730,경의선,수색,3538,3621,7159,3579.5
20240730,경의선,한국항공대,1811,1697,3508,1754
20240730,경의선,강매,3279,2740,6019,3009.5
20240730,경의선,행신,8430,8394,16824,8412
20240730,경의선,능곡,4756,4530,9286,4643
20240730,경의선,곡산,691,695,1386,693
20240730,경의선,백마,7578,7376,14954,7477
20240730,경의선,풍산,6309,6136,12445,6222.5
20240730,경의선,일산,10790,10468,21258,10629
20240730,경의선,탄현,7898,7671,15569,7784.5
20240730,경의선,야당,8789,8690,17479,8739.5
20240730,경의선,운정,7878,7243,15121,7560.5
20240730,경의선,금릉,5649,5247,10896,5448
20240730,1호선,서울역,59488,55426,114914,57457
20240730,1호선,시청,28208,28426,56634,28317
20240730,1호선,종각,42755,42406,85161,42580.5
20240730,1호선,종로3가,25959,23601,49560,24780
20240730,1호선,종로5가,25812,24981,50793,25396.5
20240730,1호선,동대문,12228,12169,24397,12198.5
20240730,1호선,신설동,14258,14064,28322,14161
20240730,1호선,제기동,16684,16997,33681,16840.5
20240730,1호선,청량리(서울시립대입구),23512,22876,46388,23194
20240730,1호선,동묘앞,8644,8656,17300,8650
20240730,2호선,시청,30262,28786,59048,29524
20240730,2호선,을지로입구,53166,54480,107646,53823
20240730,2호선,을지로3가,27102,26720,53822,26911
20240730,2호선,을지로4가,15809,15537,31346,15673
20240730,2호선,동대문역사문화공원(DDP),16189,18649,34838,17419
20240730,2호선,신당,15132,16173,31305,15652.5
20240730,2호선,상왕십리,14695,14712,29407,14703.5
20240730,2호선,왕십리(성동구청),15398,14163,29561,14780.5
20240730,2호선,한양대,8373,8813,17186,8593
20240730,2호선,뚝섬,26045,27574,53619,26809.5
20240730,2호선,성수,46080,50267,96347,48173.5
20240730,2호선,건대입구,34886,36986,71872,35936
20240730,2호선,구의(광진구청),26303,25558,51861,25930.5
20240730,2호선,강변(동서울터미널),31739,29426,61165,30582.5
20240730,2호선,잠실나루,16068,15495,31563,15781.5
20240730,2호선,잠실(송파구청),91286,89591,180877,90438.5
20240730,2호선,잠실새내,24586,24031,48617,24308.5
20240730,2호선,종합운동장,19374,21432,40806,20403
20240730,2호선,삼성(무역센터),59225,59946,119171,59585.5
20240730,2호선,선릉,64097,56586,120683,60341.5
20240730,2호선,역삼,58459,66297,124756,62378
20240730,2호선,강남,87843,85562,173405,86702.5
20240730,2호선,교대(법원.검찰청),32452,37988,70440,35220
20240730,2호선,서초,22982,22420,45402,22701
20240730,2호선,방배,15790,16272,32062,16031
20240730,2호선,사당,40829,44413,85242,42621
20240730,2호선,낙성대(강감찬),28649,27710,56359,28179.5
20240730,2호선,서울대입구(관악구청),47069,46418,93487,46743.5
20240730,2호선,봉천,25293,23829,49122,24561
20240730,2호선,신림,56151,54362,110513,55256.5
20240730,2호선,신대방,25977,25063,51040,25520
20240730,2호선,구로디지털단지,60521,60540,121061,60530.5
20240730,2호선,대림(구로구청),24216,24498,48714,24357
20240730,2호선,신도림,51513,50509,102022,51011
20240730,2호선,문래,24669,25459,50128,25064
20240730,2호선,영등포구청,23267,23887,47154,23577
20240730,2호선,당산,18315,21320,39635,19817.5
20240730,2호선,합정,33654,35605,69259,34629.5
20240730,2호선,홍대입구,71546,76525,148071,74035.5
20240730,2호선,신촌,37224,37743,74967,37483.5
20240730,2호선,이대,15162,16661,31823,15911.5
20240730,2호선,아현,10891,10162,21053,10526.5
20240730,2호선,충정로(경기대입구),10966,11322,22288,11144
20240730,2호선,용답,2876,2836,5712,2856
20240730,2호선,신답,1683,1838,3521,1760.5
20240730,2호선,신설동,3412,3242,6654,3327
20240730,2호선,도림천,1320,1425,2745,1372.5
20240730,2호선,양천구청,6787,7215,14002,7001
20240730,2호선,신정네거리,10400,10892,21292,10646
20240730,2호선,용두(동대문구청),2609,2680,5289,2644.5
20240730,3호선,지축,7704,7657,15361,7680.5
20240730,3호선,구파발,22828,22098,44926,22463
20240730,3호선,연신내,34851,33024,67875,33937.5
20240730,3호선,불광,17158,18209,35367,17683.5
20240730,3호선,녹번,15899,14489,30388,15194
20240730,3호선,홍제,18023,17114,35137,17568.5
20240730,3호선,무악재,4751,4576,9327,4663.5
20240730,3호선,독립문,8008,8043,16051,8025.5
20240730,3호선,경복궁(정부서울청사),22129,21956,44085,22042.5
20240730,3호선,안국,27369,27908,55277,27638.5
20240730,3호선,종로3가,12498,14008,26506,13253
20240730,3호선,을지로3가,12807,12536,25343,12671.5
20240730,3호선,충무로,12,0,12,6
20240730,3호선,동대입구,8629,9473,18102,9051
20240730,3호선,약수,13190,12776,25966,12983
20240730,3호선,금호,8231,7627,15858,7929
20240730,3호선,옥수,8905,9150,18055,9027.5
20240730,3호선,압구정,32718,34968,67686,33843
20240730,3호선,신사,29218,30814,60032,30016
20240730,3호선,잠원,5207,4934,10141,5070.5
20240730,3호선,고속터미널,48568,44673,93241,46620.5
20240730,3호선,교대(법원.검찰청),16787,10307,27094,13547
20240730,3호선,남부터미널(예술의전당),31715,31939,63654,31827
20240730,3호선,양재(서초구청),38495,41338,79833,39916.5
20240730,3호선,매봉,13494,12816,26310,13155
20240730,3호선,도곡,5798,5559,11357,5678.5
20240730,3호선,대치,13280,12896,26176,13088
20240730,3호선,학여울,1858,1873,3731,1865.5
20240730,3호선,대청,10811,10154,20965,10482.5
20240730,3호선,일원,11369,11011,22380,11190
20240730,3호선,수서,18550,18574,37124,18562
20240730,3호선,가락시장,9281,9025,18306,9153
20240730,3호선,경찰병원,8017,8043,16060,8030
20240730,3호선,오금,6903,6025,12928,6464
20240730,4호선,당고개,9937,8507,18444,9222
20240730,4호선,상계,19773,18321,38094,19047
20240730,4호선,노원,28631,31847,60478,30239
20240730,4호선,창동,26818,28457,55275,27637.5
20240730,4호선,쌍문,30461,28367,58828,29414
20240730,4호선,수유(강북구청),34168,34620,68788,34394
20240730,4호선,미아(서울사이버대학),15491,15062,30553,15276.5
20240730,4호선,미아사거리,27108,26852,53960,26980
20240730,4호선,길음,21498,21184,42682,21341
20240730,4호선,성신여대입구(돈암),21229,20627,41856,20928
20240730,4호선,한성대입구(삼선교),13273,12697,25970,12985
20240730,4호선,혜화,36935,37322,74257,37128.5
20240730,4호선,동대문,23645,24046,47691,23845.5
20240730,4호선,동대문역사문화공원(DDP),21198,18894,40092,20046
20240730,4호선,충무로,31286,32478,63764,31882
20240730,4호선,명동,33720,35726,69446,34723
20240730,4호선,회현(남대문시장),30695,31185,61880,30940
20240730,4호선,서울역,14004,23649,37653,18826.5
20240730,4호선,숙대입구(갈월),14149,13960,28109,14054.5
20240730,4호선,삼각지,6464,7301,13765,6882.5
20240730,4호선,신용산,21399,23052,44451,22225.5
20240730,4호선,이촌(국립중앙박물관),10866,11451,22317,11158.5
20240730,4호선,동작(현충원),1294,1408,2702,1351
20240730,4호선,총신대입구(이수),19556,21127,40683,20341.5
20240730,4호선,사당,26830,23004,49834,24917
20240730,4호선,남태령,1476,1293,2769,1384.5
20240730,5호선,방화,7362,6958,14320,7160
20240730,5호선,개화산,6356,6114,12470,6235
20240730,5호선,김포공항,11699,8672,20371,10185.5
20240730,5호선,송정,6453,6217,12670,6335
20240730,5호선,마곡,12857,12994,25851,12925.5
20240730,5호선,발산,23617,24098,47715,23857.5
20240730,5호선,우장산,14688,14684,29372,14686
20240730,5호선,화곡,29174,27074,56248,28124
20240730,5호선,까치산,28707,27747,56454,28227
20240730,5호선,신정(은행정),13730,11526,25256,12628
20240730,5호선,목동,16919,18159,35078,17539
20240730,5호선,오목교(목동운동장앞),21479,22782,44261,22130.5
20240730,5호선,양평,8297,8086,16383,8191.5
20240730,5호선,영등포구청,5052,5018,10070,5035
20240730,5호선,영등포시장,11727,11742,23469,11734.5
20240730,5호선,신길,5306,5322,10628,5314
20240730,5호선,여의도,32912,34173,67085,33542.5
20240730,5호선,여의나루,13921,16285,30206,15103
20240730,5호선,마포,15901,16381,32282,16141
20240730,5호선,공덕,15373,16268,31641,15820.5
20240730,5호선,애오개,7275,7099,14374,7187
20240730,5호선,충정로(경기대입구),5242,5252,10494,5247
20240730,5호선,서대문,21435,21838,43273,21636.5
20240730,5호선,광화문(세종문화회관),36348,38309,74657,37328.5
20240730,5호선,종로3가,15600,15686,31286,15643
20240730,5호선,을지로4가,7165,7310,14475,7237.5
20240730,5호선,동대문역사문화공원(DDP),3400,3956,7356,3678
20240730,5호선,청구,4019,3911,7930,3965
20240730,5호선,신금호,6531,6803,13334,6667
20240730,5호선,행당,8158,7256,15414,7707
20240730,5호선,왕십리(성동구청),4658,5260,9918,4959
20240730,5호선,마장,5914,5540,11454,5727
20240730,5호선,답십리,16556,14958,31514,15757
20240730,5호선,장한평,19739,19666,39405,19702.5
20240730,5호선,군자(능동),11475,12660,24135,12067.5
20240730,5호선,아차산(어린이대공원후문),14115,13972,28087,14043.5
20240730,5호선,광나루(장신대),13475,12262,25737,12868.5
20240730,5호선,천호(풍납토성),19987,19504,39491,19745.5
20240730,5호선,강동,18977,18785,37762,18881
20240730,5호선,길동,8785,8940,17725,8862.5
20240730,5호선,굽은다리(강동구민회관앞),10129,9691,19820,9910
20240730,5호선,명일,8586,8821,17407,8703.5
20240730,5호선,고덕,11154,10926,22080,11040
20240730,5호선,상일동,15322,14403,29725,14862.5
20240730,5호선,둔촌동,9023,9089,18112,9056
20240730,중앙선,지평,38,52,90,45
20240730,중앙선,용문,3529,3540,7069,3534.5
20240730,중앙선,원덕,377,340,717,358.5
20240730,중앙선,양평,3117,3075,6192,3096
20240730,중앙선,오빈,337,340,677,338.5
20240730,중앙선,아신,524,533,1057,528.5
20240730,중앙선,국수,711,645,1356,678
20240730,중앙선,신원,187,153,340,170
20240730,중앙선,양수,2079,2019,4098,2049
20240730,중앙선,운길산,645,611,1256,628
20240730,중앙선,팔당,824,906,1730,865
20240730,중앙선,도심,2455,1954,4409,2204.5
20240730,중앙선,덕소,5435,5363,10798,5399
20240730,중앙선,양정,639,540,1179,589.5
20240730,중앙선,도농,11141,10443,21584,10792
20240730,중앙선,구리,13642,13784,27426,13713
20240730,중앙선,양원,2950,2884,5834,2917
20240730,중앙선,망우,7839,7539,15378,7689
20240730,중앙선,상봉,6002,5984,11986,5993
20240730,중앙선,중랑,5780,5461,11241,5620.5
20240730,중앙선,회기,24364,23070,47434,23717
20240730,장항선,신창(순천향대),1117,1090,2207,1103.5
20240730,장항선,온양온천,4388,4407,8795,4397.5
20240730,장항선,배방,1199,1133,2332,1166
20240730,장항선,탕정,1529,1446,2975,1487.5
20240730,장항선,아산,3755,3308,7063,3531.5
20240730,장항선,쌍용(나사렛대),2259,2079,4338,2169
20240730,장항선,봉명,1356,1351,2707,1353.5
20240730,일산선,대화,13725,11066,24791,12395.5
20240730,일산선,주엽,10122,10314,20436,10218
20240730,일산선,정발산,7209,7360,14569,7284.5
20240730,일산선,마두,8514,8610,17124,8562
20240730,일산선,백석,10374,10546,20920,10460
20240730,일산선,대곡,2996,2245,5241,2620.5
20240730,일산선,화정,17141,17558,34699,17349.5
20240730,일산선,원당,11013,10522,21535,10767.5
20240730,일산선,삼송,19666,18966,38632,19316
20240730,일산선,지축,3,0,3,1.5
20240730,일산선,원흥,11760,11095,22855,11427.5
20240730,우이신설선,신설동,2465,2179,4644,2322
20240730,우이신설선,보문,1594,1629,3223,1611.5
20240730,우이신설선,성신여대입구(돈암),3643,3993,7636,3818
20240730,우이신설선,정릉,4622,4367,8989,4494.5
20240730,우이신설선,북한산보국문,6082,5803,11885,5942.5
20240730,우이신설선,솔샘,6061,5670,11731,5865.5
20240730,우이신설선,삼양사거리,2692,2684,5376,2688
20240730,우이신설선,삼양,2073,2215,4288,2144
20240730,우이신설선,화계,3686,3481,7167,3583.5
20240730,우이신설선,가오리,4449,4575,9024,4512
20240730,우이신설선,4.19민주묘지,3003,2789,5792,2896
20240730,우이신설선,솔밭공원,2807,2673,5480,2740
20240730,우이신설선,북한산우이,2914,2738,5652,2826
20240730,안산선,수리산,4061,3293,7354,3677
20240730,안산선,오이도,8353,7957,16310,8155
20240730,안산선,정왕,8752,8792,17544,8772
20240730,안산선,신길온천,2034,1884,3918,1959
20240730,안산선,안산,12390,11766,24156,12078
20240730,안산선,초지,4997,4903,9900,4950
20240730,안산선,고잔,8646,8239,16885,8442.5
20240730,안산선,중앙,18156,18909,37065,18532.5
20240730,안산선,한대앞,8700,8711,17411,8705.5
20240730,안산선,상록수,14400,14631,29031,14515.5
20240730,안산선,반월,4115,4002,8117,4058.5
20240730,안산선,대야미,4935,4380,9315,4657.5
20240730,안산선,산본,16496,17598,34094,17047
20240730,신림선,관악산(서울대),3288,3098,6386,3193
20240730,신림선,서울대벤처타운,9599,9007,18606,9303
20240730,신림선,서원,3697,3342,7039,3519.5
20240730,신림선,신림,2099,2664,4763,2381.5
20240730,신림선,당곡,5157,5104,10261,5130.5
20240730,신림선,보라매병원,8525,8797,17322,8661
20240730,신림선,보라매공원,2503,2772,5275,2637.5
20240730,신림선,보라매,4134,3862,7996,3998
20240730,신림선,서울지방병무청,3114,3379,6493,3246.5
20240730,신림선,대방,3008,2452,5460,2730
20240730,신림선,샛강,3118,3558,6676,3338
20240730,수인선,인천,1378,1990,3368,1684
20240730,수인선,신포,1796,1816,3612,1806
20240730,수인선,숭의,4072,3755,7827,3913.5
20240730,수인선,인하대,6212,5891,12103,6051.5
20240730,수인선,송도,2341,2100,4441,2220.5
20240730,수인선,연수,4508,4523,9031,4515.5
20240730,수인선,원인재,4315,4315,8630,4315
20240730,수인선,남동인더스파크,2159,2355,4514,2257
20240730,수인선,호구포,3766,3897,7663,3831.5
20240730,수인선,인천논현,5456,5626,11082,5541
20240730,수인선,소래포구,4684,4314,8998,4499
20240731,5호선,방이,7500,7819,15319,7659.5
20240731,7호선,광명사거리,20015,19751,39766,19883
20240731,7호선,천왕,11618,11082,22700,11350
20240731,7호선,온수(성공회대입구),9273,8567,17840,8920
20240731,8호선,암사,19893,17491,37384,18692
20240731,8호선,천호(풍납토성),16366,18378,34744,17372
20240731,8호선,강동구청,10710,10990,21700,10850
20240731,8호선,몽촌토성(평화의문),7087,7189,14276,7138
20240731,8호선,잠실(송파구청),18358,21832,40190,20095
20240731,8호선,석촌,8258,9494,17752,8876
20240731,8호선,송파,9534,9374,18908,9454
20240731,8호선,가락시장,7976,8648,16624,8312
20240731,8호선,문정,23157,24400,47557,23778.5
20240731,8호선,장지,18216,16917,35133,17566.5
20240731,8호선,복정,9577,7920,17497,8748.5
20240731,8호선,산성,6336,6442,12778,6389
20240731,8호선,남한산성입구(성남법원.검찰청),12945,11379,24324,12162
20240731,8호선,단대오거리,12149,11865,24014,12007
20240731,8호선,신흥,5439,5744,11183,5591.5
20240731,8호선,수진,5863,5420,11283,5641.5
20240731,8호선,모란,4672,3656,8328,4164
20240731,8호선,남위례,7295,7301,14596,7298
20240731,9호선,개화,3048,2002,5050,2525
20240731,9호선,김포공항,7749,10497,18246,9123
20240731,9호선,공항시장,3182,3529,6711,3355.5
20240731,9호선,신방화,7401,7205,14606,7303
20240731,9호선,마곡나루(서울식물원),14750,14490,29240,14620
20240731,9호선,양천향교,10600,10836,21436,10718
20240731,9호선,가양,23079,22751,45830,22915
20240731,9호선,증미,8808,8556,17364,8682
20240731,9호선,등촌,13059,12556,25615,12807.5
20240731,9호선,염창,18837,18140,36977,18488.5
20240731,9호선,신목동,4622,4158,8780,4390
20240731,9호선,선유도,9472,8718,18190,9095
20240731,9호선,당산,20907,20299,41206,20603
20240731,9호선,국회의사당,18689,19161,37850,18925
20240731,9호선,여의도,33976,33053,67029,33514.5
20240731,9호선,샛강,7006,7031,14037,7018.5
20240731,9호선,노량진,26628,26344,52972,26486
20240731,9호선,노들,5218,4311,9529,4764.5
20240731,9호선,흑석(중앙대입구),8827,9140,17967,8983.5
20240731,9호선,동작(현충원),1883,1549,3432,1716
20240731,9호선,구반포,1440,1414,2854,1427
20240731,9호선,신반포,4216,4038,8254,4127
20240731,9호선,고속터미널,15955,21845,37800,18900
20240731,9호선,사평,3991,3812,7803,3901.5
20240731,9호선,신논현,33075,33321,66396,33198
20240731,9호선2~3단계,언주,12678,12999,25677,12838.5
20240731,9호선2~3단계,선정릉,10674,11379,22053,11026.5
20240731,9호선2~3단계,삼성중앙,8585,8959,17544,8772
20240731,9호선2~3단계,봉은사,27230,27764,54994,27497
20240731,9호선2~3단계,종합운동장,5472,5585,11057,5528.5
20240731,9호선2~3단계,삼전,8607,8108,16715,8357.5
20240731,9호선2~3단계,석촌고분,7691,7482,15173,7586.5
20240731,9호선2~3단계,석촌,10118,9000,19118,9559
20240731,9호선2~3단계,송파나루,5990,6509,12499,6249.5
20240731,9호선2~3단계,한성백제,3335,2977,6312,3156
20240731,9호선2~3단계,올림픽공원(한국체대),5428,5756,11184,5592
20240731,9호선2~3단계,둔촌오륜,1288,1301,2589,1294.5
20240731,9호선2~3단계,중앙보훈병원,12963,11540,24503,12251.5
20240731,경강선,판교,6181,6052,12233,6116.5
20240731,경강선,이매,1067,900,1967,983.5
20240731,경강선,삼동,2616,2409,5025,2512.5
20240731,경강선,경기광주,8347,7754,16101,8050.5
20240731,경강선,초월,3669,3371,7040,3520
20240731,경강선,곤지암,2346,2159,4505,2252.5
20240731,경강선,신둔도예촌,1460,1413,2873,1436.5
20240731,경강선,이천,3072,3274,6346,3173
20240731,경강선,부발,2283,2300,4583,2291.5
20240731,경강선,세종대왕릉,356,360,716,358
20240731,경강선,여주,3000,2996,5996,2998
20240731,경강선,성남,1019,867,1886,943
20240731,경부선,서울역,10719,3742,14461,7230.5
20240731,경부선,남영,9617,9948,19565,9782.5
20240731,경부선,용산,47348,47783,95131,47565.5
20240731,경부선,노량진,7871,7875,15746,7873
20240731,경부선,대방,10490,11453,21943,10971.5
20240731,경부선,영등포,43186,44595,87781,43890.5
20240731,경부선,신도림,4603,4324,8927,4463.5
20240731,경부선,신길,8780,7226,16006,8003
20240731,경부선,구로,17568,18058,35626,17813
20240731,경부선,가산디지털단지,17901,20777,38678,19339
20240731,경부선,금천구청,10803,10883,21686,10843
20240731,경부선,석수,8308,7740,16048,8024
20240731,경부선,관악,7207,6929,14136,7068
20240731,경부선,안양,20903,20664,41567,20783.5
20240731,경부선,명학,8070,7781,15851,7925.5
20240731,경부선,금정,27572,27613,55185,27592.5
20240731,경부선,군포,6357,6014,12371,6185.5
20240731,경부선,의왕,8754,8712,17466,8733
20240731,경부선,성균관대,14610,14328,28938,14469
20240731,경부선,화서,13069,12873,25942,12971
20240731,경부선,수원,39621,41879,81500,40750
20240731,경부선,독산,17184,17596,34780,17390
20240731,경부선,세류,3622,3219,6841,3420.5
20240731,경부선,병점,14745,14357,29102,14551
20240731,경부선,세마,3397,3170,6567,3283.5
20240731,경부선,오산대,3496,3167,6663,3331.5
20240731,경부선,오산,10366,10155,20521,10260.5
20240731,경부선,진위,1569,1475,3044,1522
20240731,경부선,송탄,4305,4175,8480,4240
20240731,경부선,서정리,8124,7591,15715,7857.5
20240731,경부선,평택지제,4122,4068,8190,4095
20240731,경부선,평택,13391,12792,26183,13091.5
20240731,경부선,성환,3869,3877,7746,3873
20240731,경부선,직산,1034,1029,2063,1031.5
20240731,경부선,두정,6379,6427,12806,6403
20240731,경부선,천안,6472,6388,12860,6430
20240731,경부선,당정,5922,5652,11574,5787
20240731,경부선,서동탄,1561,1379,2940,1470
20240731,경부선,광명,3956,3631,7587,3793.5
20240731,경원선,이촌(국립중앙박물관),3979,3199,7178,3589
20240731,경원선,서빙고,2158,1985,4143,2071.5
20240731,경원선,한남,3939,3748,7687,3843.5
20240731,경원선,옥수,55,40,95,47.5
20240731,경원선,응봉,1871,1522,3393,1696.5
20240731,경원선,왕십리(성동구청),17133,17558,34691,17345.5
20240731,경원선,청량리(서울시립대입구),17397,18249,35646,17823
20240731,경원선,외대앞,8479,8331,16810,8405
20240731,경원선,신이문,8674,8036,16710,8355
20240731,경원선,석계,7342,8493,15835,7917.5
20240731,경원선,광운대,7892,7379,15271,7635.5
20240731,경원선,월계,6229,5706,11935,5967.5
20240731,경원선,녹천,4613,3868,8481,4240.5
20240731,경원선,창동,3,0,3,1.5
20240731,경원선,방학,10030,9751,19781,9890.5
20240731,경원선,도봉,5885,5745,11630,5815
20240731,경원선,도봉산,7677,4880,12557,6278.5
20240731,경원선,망월사,7187,7309,14496,7248
20240731,경원선,회룡,13362,12890,26252,13126
20240731,경원선,의정부,19498,19614,39112,19556
20240731,경원선,가능,6514,6253,12767,6383.5
20240731,경원선,녹양,4228,3963,8191,4095.5
20240731,경원선,양주,7476,6985,14461,7230.5
20240731,경원선,덕계,6069,5443,11512,5756
20240731,경원선,덕정,5902,5483,11385,5692.5
20240731,경원선,지행,6493,6502,12995,6497.5
20240731,경원선,동두천중앙,3052,2933,5985,2992.5
20240731,경원선,보산,1389,1299,2688,1344
20240731,경원선,동두천,1776,1710,3486,1743
20240731,경원선,소요산,2056,2090,4146,2073
20240731,경원선,청산,194,141,335,167.5
20240731,경원선,전곡,1207,989,2196,1098
20240731,경원선,연천,1442,1515,2957,1478.5
20240731,경의선,서울역,4903,6288,11191,5595.5
20240731,경의선,신촌,1060,1352,2412,1206
20240731,경의선,효창공원앞,3229,3726,6955,3477.5
20240731,경의선,공덕,4498,3744,8242,4121
20240731,경의선,서강대,2149,2132,4281,2140.5
20240731,경의선,홍대입구,2208,2758,4966,2483
20240731,경의선,가좌,6024,5727,11751,5875.5
20240731,경의선,디지털미디어시티,3232,3123,6355,3177.5
20240731,경의선,수색,3605,3654,7259,3629.5
20240731,경의선,한국항공대,1900,1684,3584,1792
20240731,경의선,강매,3259,2709,5968,2984
20240731,경의선,행신,8304,8608,16912,8456
20240731,경의선,능곡,4729,4432,9161,4580.5
20240731,경의선,곡산,620,685,1305,652.5
20240731,경의선,백마,7574,7404,14978,7489
20240731,경의선,풍산,6288,5897,12185,6092.5
20240731,경의선,일산,10706,10427,21133,10566.5
20240731,경의선,탄현,7991,7652,15643,7821.5
20240731,경의선,야당,8999,9017,18016,9008
20240731,경의선,운정,7987,7242,15229,7614.5
20240731,경의선,금릉,5580,5135,10715,5357.5
20240731,경의선,금촌,6754,6432,13186,6593
20240731,경의선,월롱,1986,1710,3696,1848
20240731,경의선,파주,1093,876,1969,984.5
20240731,경의선,문산,5601,5456,11057,5528.5
20240731,경의선,임진강,12,11,23,11.5
20240731,경의선,운천,4,5,9,4.5
20240731,경인선,개봉,21775,21297,43072,21536
20240731,경인선,오류동,11498,10710,22208,11104
20240731,경인선,역곡,25455,25376,50831,25415.5
20240731,경인선,부천,31750,31688,63438,31719
20240731,경인선,송내,26702,26024,52726,26363
20240731,경인선,부평,30306,31766,62072,31036
20240731,경인선,백운,7450,7330,14780,7390
20240731,경인선,동암,15653,15651,31304,15652
20240731,경인선,주안,18489,16588,35077,17538.5
20240731,경인선,제물포,10200,9586,19786,9893
20240731,경인선,동인천,13805,13135,26940,13470
20240731,경인선,인천,4528,3657,8185,4092.5
20240731,경인선,구일,9189,9503,18692,9346
20240731,경인선,소사,7142,6815,13957,6978.5
20240731,경인선,부개,8623,7998,16621,8310.5
20240731,경인선,간석,5921,5575,11496,5748
20240731,경인선,도원,2763,2753,5516,2758
20240731,경인선,온수(성공회대입구),6118,5928,12046,6023
20240731,경인선,중동,9196,8613,17809,8904.5
20240731,경인선,도화,4018,3721,7739,3869.5
20240731,경춘선,신내,2743,2501,5244,2622
20240731,경춘선,갈매,3047,2605,5652,2826
20240731,경춘선,별내,3539,3291,6830,3415
20240731,경춘선,퇴계원,3509,3238,6747,3373.5
20240731,경춘선,사릉,1983,1987,3970,1985
20240731,경춘선,금곡,1444,1385,2829,1414.5
20240731,경춘선,평내호평,6076,5897,11973,5986.5
20240731,경춘선,천마산,1430,1302,2732,1366
20240731,경춘선,마석,3696,3595,7291,3645.5
20240731,경춘선,대성리,1021,719,1740,870
20240731,경춘선,청평,2103,1902,4005,2002.5
20240731,경춘선,상천,283,283,566,283
20240731,경춘선,가평,2861,2861,5722,2861
20240731,경춘선,굴봉산,233,155,388,194
20240731,경춘선,백양리,119,83,202,101
20240731,경춘선,강촌,540,464,1004,502
20240731,경춘선,김유정,411,396,807,403.5
20240731,경춘선,남춘천,2749,2778,5527,2763.5
20240731,경춘선,춘천,1575,1392,2967,1483.5
20240731,공항철도 1호선,서울역,14724,14070,28794,14397
20240731,공항철도 1호선,공덕,3087,4125,7212,3606
20240731,공항철도 1호선,홍대입구,15776,15704,31480,15740
20240731,공항철도 1호선,디지털미디어시티,18481,15308,33789,16894.5
20240731,공항철도 1호선,마곡나루(서울식물원),11462,10958,22420,11210
20240731,공항철도 1호선,김포공항,9591,5876,15467,7733.5
20240731,공항철도 1호선,계양,14327,13453,27780,13890
20240731,공항철도 1호선,검암,7080,7150,14230,7115
20240731,공항철도 1호선,청라국제도시,8177,7757,15934,7967
20240731,공항철도 1호선,운서,9932,10224,20156,10078
20240731,공항철도 1호선,공항화물청사,2192,2412,4604,2302
20240731,공항철도 1호선,인천공항1터미널,15424,15185,30609,15304.5
20240731,공항철도 1호선,인천공항2터미널,7570,6639,14209,7104.5
20240731,공항철도 1호선,영종,4500,4519,9019,4509.5
20240731,과천선,선바위,7838,6880,14718,7359
20240731,과천선,경마공원,1589,1622,3211,1605.5
20240731,과천선,대공원,3851,3956,7807,3903.5
20240731,과천선,과천,6854,6332,13186,6593
20240731,과천선,정부과천청사,12807,13269,26076,13038
20240731,과천선,인덕원,25635,26263,51898,25949
20240731,과천선,평촌,18231,17755,35986,17993
20240731,과천선,범계,28058,27869,55927,27963.5
20240731,분당선,선릉,14203,21579,35782,17891
20240731,분당선,한티,16549,17597,34146,17073
20240731,분당선,도곡,7491,7898,15389,7694.5
20240731,분당선,구룡,3482,3420,6902,3451
20240731,분당선,개포동,4631,4666,9297,4648.5
20240731,분당선,대모산입구,5972,5640,11612,5806
20240731,분당선,수서,16622,17790,34412,17206
20240731,분당선,복정,4,0,4,2
20240731,분당선,수원,8680,7779,16459,8229.5
20240731,분당선,서울숲,12840,13267,26107,13053.5
20240731,분당선,압구정로데오,18871,20596,39467,19733.5
20240731,분당선,강남구청,9904,11461,21365,10682.5
20240731,분당선,선정릉,8114,8556,16670,8335
20240731,분당선,가천대,7004,7352,14356,7178
20240731,분당선,태평,13565,12573,26138,13069
20240731,분당선,모란,19815,20221,40036,20018
20240731,분당선,야탑,26354,27757,54111,27055.5
20240731,분당선,서현,25348,25652,51000,25500
20240731,분당선,수내,14569,14653,29222,14611
20240731,분당선,정자,18625,19106,37731,18865.5
20240731,분당선,미금,15901,16560,32461,16230.5
20240731,분당선,오리,11840,10301,22141,11070.5
20240731,분당선,이매,5401,5271,10672,5336
20240731,분당선,보정,2489,2263,4752,2376
20240731,분당선,죽전,12503,14034,26537,13268.5
20240731,분당선,구성,6389,6455,12844,6422
20240731,분당선,신갈,4996,4765,9761,4880.5
20240731,분당선,기흥,10379,9732,20111,10055.5
20240731,분당선,상갈,5347,5154,10501,5250.5
20240731,분당선,청명,4425,4341,8766,4383
20240731,분당선,영통,8531,8646,17177,8588.5
20240731,분당선,망포,15188,14540,29728,14864
20240731,분당선,매탄권선,5286,4945,10231,5115.5
20240731,분당선,수원시청,13731,14734,28465,14232.5
20240731,분당선,매교,4846,4778,9624,4812
20240731,서해선,김포공항,3209,4299,7508,3754
20240731,서해선,원종,4710,4733,9443,4721.5
20240731,서해선,부천종합운동장,2628,2166,4794,2397
20240731,수인선,고색,4973,4613,9586,4793
20240731,수인선,오목천,3833,3238,7071,3535.5
20240731,수인선,어천,1433,1363,2796,1398
20240731,수인선,야목,425,378,803,401.5
20240731,수인선,사리,4886,4076,8962,4481
20240731,수인선,달월,116,46,162,81
20240731,수인선,월곶,3160,2903,6063,3031.5
20240731,수인선,소래포구,4940,4554,9494,4747
20240731,수인선,인천논현,5346,5663,11009,5504.5
20240731,수인선,호구포,3575,3571,7146,3573
20240731,수인선,남동인더스파크,1850,1942,3792,1896
20240731,수인선,원인재,4223,4256,8479,4239.5
20240731,수인선,연수,4546,4542,9088,4544
20240731,수인선,송도,2229,2038,4267,2133.5
20240731,수인선,인하대,6000,5711,11711,5855.5
20240731,수인선,숭의,4030,3719,7749,3874.5
20240731,수인선,신포,1720,1741,3461,1730.5
20240731,수인선,인천,1316,1959,3275,1637.5
20240731,신림선,샛강,3069,3469,6538,3269
20240731,신림선,대방,3047,2507,5554,2777
20240731,신림선,서울지방병무청,3025,3378,6403,3201.5
20240731,신림선,보라매,4230,3761,7991,3995.5
20240731,신림선,보라매공원,2442,2601,5043,2521.5
20240731,신림선,보라매병원,8296,8775,17071,8535.5
20240731,신림선,당곡,5269,5129,10398,5199
20240731,신림선,신림,2135,2708,4843,2421.5
20240731,신림선,서원,3697,3285,6982,3491
20240731,신림선,서울대벤처타운,9593,8968,18561,9280.5
20240731,신림선,관악산(서울대),3454,3303,6757,3378.5
20240731,안산선,산본,16409,17677,34086,17043
20240731,안산선,대야미,4871,4318,9189,4594.5
20240731,안산선,반월,4177,4024,8201,4100.5
20240731,안산선,상록수,14437,14590,29027,14513.5
20240731,안산선,한대앞,8824,8676,17500,8750
20240731,안산선,중앙,18703,19435,38138,19069
20240731,안산선,고잔,8513,8074,16587,8293.5
20240731,안산선,초지,4780,4934,9714,4857
20240731,안산선,안산,13005,12899,25904,12952
20240731,안산선,신길온천,1984,1824,3808,1904
20240731,안산선,정왕,8802,8822,17624,8812
20240731,안산선,오이도,8287,8090,16377,8188.5
20240731,안산선,수리산,3942,3189,7131,3565.5
20240731,우이신설선,북한산우이,2986,2755,5741,2870.5
20240731,우이신설선,솔밭공원,2737,2617,5354,2677
20240731,우이신설선,4.19민주묘지,3029,2869,5898,2949
20240731,우이신설선,가오리,4508,4518,9026,4513
20240731,우이신설선,화계,3663,3425,7088,3544
20240731,우이신설선,삼양,2045,2184,4229,2114.5
20240731,우이신설선,삼양사거리,2603,2642,5245,2622.5
20240731,우이신설선,솔샘,6082,5846,11928,5964
20240731,우이신설선,북한산보국문,6130,5798,11928,5964
20240731,우이신설선,정릉,4631,4244,8875,4437.5
20240731,우이신설선,성신여대입구(돈암),3685,4355,8040,4020
20240731,우이신설선,보문,1649,1603,3252,1626
20240731,우이신설선,신설동,2405,2208,4613,2306.5
20240731,일산선,원흥,11762,11197,22959,11479.5
20240731,일산선,지축,1,0,1,0.5
20240731,일산선,삼송,19966,19134,39100,19550
20240731,일산선,원당,10855,10254,21109,10554.5
20240731,일산선,화정,17840,18170,36010,18005
20240731,일산선,대곡,2918,2269,5187,2593.5
20240731,일산선,백석,10270,10351,20621,10310.5
20240731,일산선,마두,8637,8647,17284,8642
20240731,일산선,정발산,7293,7408,14701,7350.5
20240731,일산선,주엽,10290,10482,20772,10386
20240731,일산선,대화,13896,10839,24735,12367.5
20240731,장항선,봉명,1405,1416,2821,1410.5
20240731,장항선,쌍용(나사렛대),2192,2076,4268,2134
20240731,장항선,아산,3827,3467,7294,3647
20240731,장항선,탕정,1655,1476,3131,1565.5
20240731,장항선,배방,1181,1122,2303,1151.5
20240731,장항선,온양온천,4265,4348,8613,4306.5
20240731,장항선,신창(순천향대),1086,1132,2218,1109
20240731,중앙선,회기,24188,22933,47121,23560.5
20240731,중앙선,중랑,5703,5482,11185,5592.5
20240731,중앙선,상봉,5947,6088,12035,6017.5
20240731,중앙선,망우,7668,7601,15269,7634.5
20240731,중앙선,양원,2964,2910,5874,2937
20240731,중앙선,구리,13404,13545,26949,13474.5
20240731,중앙선,도농,10984,10184,21168,10584
20240731,중앙선,양정,596,490,1086,543
20240731,중앙선,덕소,5310,5338,10648,5324
20240731,중앙선,도심,2414,1871,4285,2142.5
20240731,중앙선,팔당,817,829,1646,823
20240731,중앙선,운길산,643,604,1247,623.5
20240731,중앙선,양수,2088,2032,4120,2060
20240731,중앙선,신원,162,164,326,163
20240731,중앙선,국수,618,589,1207,603.5
20240731,중앙선,아신,554,505,1059,529.5
20240731,중앙선,오빈,282,296,578,289
20240731,중앙선,양평,3080,3073,6153,3076.5
20240731,중앙선,원덕,337,344,681,340.5
20240731,중앙선,용문,2202,2294,4496,2248
20240731,중앙선,지평,49,71,120,60
20240731,1호선,서울역,60182,55881,116063,58031.5
20240731,1호선,시청,28372,28565,56937,28468.5
20240731,1호선,종각,42856,42515,85371,42685.5
20240731,1호선,종로3가,22384,20087,42471,21235.5
20240731,1호선,종로5가,24361,23994,48355,24177.5
20240731,1호선,동대문,12597,12329,24926,12463
20240731,1호선,신설동,14214,13966,28180,14090
20240731,1호선,제기동,16513,16536,33049,16524.5
20240731,1호선,청량리(서울시립대입구),23250,22787,46037,23018.5
20240731,1호선,동묘앞,8735,8828,17563,8781.5
20240731,2호선,시청,30336,28756,59092,29546
20240731,2호선,을지로입구,53734,54603,108337,54168.5
20240731,2호선,을지로3가,27570,27201,54771,27385.5
20240731,2호선,을지로4가,14775,14595,29370,14685
20240731,2호선,동대문역사문화공원(DDP),16475,19060,35535,17767.5
20240731,2호선,신당,15396,16213,31609,15804.5
20240731,2호선,상왕십리,14963,14729,29692,14846
20240731,2호선,왕십리(성동구청),15697,14656,30353,15176.5
20240731,2호선,한양대,8297,8715,17012,8506
20240731,2호선,뚝섬,26094,27367,53461,26730.5
20240731,2호선,성수,45142,49117,94259,47129.5
20240731,2호선,건대입구,35854,38020,73874,36937
20240731,2호선,구의(광진구청),26152,25447,51599,25799.5
20240731,2호선,강변(동서울터미널),32632,30722,63354,31677
20240731,2호선,잠실나루,16126,15383,31509,15754.5
20240731,2호선,잠실(송파구청),93113,91472,184585,92292.5
20240731,2호선,잠실새내,24635,24223,48858,24429
20240731,2호선,종합운동장,19920,21957,41877,20938.5
20240731,2호선,삼성(무역센터),65224,65597,130821,65410.5
20240731,2호선,선릉,64068,56024,120092,60046
20240731,2호선,역삼,57922,65524,123446,61723
20240731,2호선,강남,86727,84399,171126,85563
20240731,2호선,교대(법원.검찰청),31765,37513,69278,34639
20240731,2호선,서초,22945,22046,44991,22495.5
20240731,2호선,방배,15810,16285,32095,16047.5
20240731,2호선,사당,41366,45287,86653,43326.5
20240731,2호선,낙성대(강감찬),28316,27559,55875,27937.5
20240731,2호선,서울대입구(관악구청),47290,46489,93779,46889.5
20240731,2호선,봉천,25429,23666,49095,24547.5
20240731,2호선,신림,58000,55739,113739,56869.5
20240731,2호선,신대방,25683,25094,50777,25388.5
20240731,2호선,구로디지털단지,60974,60532,121506,60753
20240731,2호선,대림(구로구청),24175,24509,48684,24342
20240731,2호선,신도림,52757,52064,104821,52410.5
20240731,2호선,문래,24459,25139,49598,24799
20240731,2호선,영등포구청,23356,24179,47535,23767.5
20240731,2호선,당산,18769,21703,40472,20236
20240731,2호선,합정,33908,36726,70634,35317
20240731,2호선,홍대입구,74348,79424,153772,76886
20240731,2호선,신촌,37151,38034,75185,37592.5
20240731,2호선,이대,15040,16689,31729,15864.5
20240731,2호선,아현,10969,10245,21214,10607
20240731,2호선,충정로(경기대입구),11081,11488,22569,11284.5
20240731,2호선,용답,2909,2811,5720,2860
20240731,2호선,신답,1726,1887,3613,1806.5
20240731,2호선,신설동,3333,3309,6642,3321
20240731,2호선,도림천,1276,1384,2660,1330
20240731,2호선,양천구청,6724,7129,13853,6926.5
20240731,2호선,신정네거리,10181,10644,20825,10412.5
20240731,2호선,용두(동대문구청),2596,2620,5216,2608
20240731,3호선,지축,7784,7693,15477,7738.5
20240731,3호선,구파발,23328,22760,46088,23044
20240731,3호선,연신내,34619,33125,67744,33872
20240731,3호선,불광,17073,18339,35412,17706
20240731,3호선,녹번,15728,14381,30109,15054.5
20240731,3호선,홍제,18112,16988,35100,17550
20240731,3호선,무악재,4692,4475,9167,4583.5
20240731,3호선,독립문,7825,7889,15714,7857
20240731,3호선,경복궁(정부서울청사),25352,25887,51239,25619.5
20240731,3호선,안국,27589,28494,56083,28041.5
20240731,3호선,종로3가,8418,9452,17870,8935
20240731,3호선,을지로3가,12452,12469,24921,12460.5
20240731,3호선,충무로,9,0,9,4.5
20240731,3호선,동대입구,8399,9168,17567,8783.5
20240731,3호선,약수,13390,12884,26274,13137
20240731,3호선,금호,8300,7615,15915,7957.5
20240731,3호선,옥수,8997,9311,18308,9154
20240731,3호선,압구정,32301,34490,66791,33395.5
20240731,3호선,신사,28944,30093,59037,29518.5
20240731,3호선,잠원,5275,4950,10225,5112.5
20240731,3호선,고속터미널,50253,47716,97969,48984.5
20240731,3호선,교대(법원.검찰청),17082,10305,27387,13693.5
20240731,3호선,남부터미널(예술의전당),32655,33000,65655,32827.5
20240731,3호선,양재(서초구청),38961,41724,80685,40342.5
20240731,3호선,매봉,13610,13115,26725,13362.5
20240731,3호선,도곡,5878,5531,11409,5704.5
20240731,3호선,대치,12933,12700,25633,12816.5
20240731,3호선,학여울,1845,1860,3705,1852.5
20240731,3호선,대청,10957,10374,21331,10665.5
20240731,3호선,일원,11038,10678,21716,10858
20240731,3호선,수서,18615,18506,37121,18560.5
20240731,3호선,가락시장,9293,9038,18331,9165.5
20240731,3호선,경찰병원,8177,8145,16322,8161
20240731,3호선,오금,6984,6022,13006,6503
20240731,4호선,당고개,9940,8487,18427,9213.5
20240731,4호선,상계,19595,18089,37684,18842
20240731,4호선,노원,29545,33023,62568,31284
20240731,4호선,창동,26747,28358,55105,27552.5
20240731,4호선,쌍문,30243,27858,58101,29050.5
20240731,4호선,수유(강북구청),34242,34393,68635,34317.5
20240731,4호선,미아(서울사이버대학),15651,15155,30806,15403
20240731,4호선,미아사거리,27484,26967,54451,27225.5
20240731,4호선,길음,21662,21039,42701,21350.5
20240731,4호선,성신여대입구(돈암),21711,21321,43032,21516
20240731,4호선,한성대입구(삼선교),13327,12707,26034,13017
20240731,4호선,혜화,39960,40093,80053,40026.5
20240731,4호선,동대문,23615,24130,47745,23872.5
20240731,4호선,동대문역사문화공원(DDP),21564,19082,40646,20323
20240731,4호선,충무로,29417,30522,59939,29969.5
20240731,4호선,명동,34215,36755,70970,35485
20240731,4호선,회현(남대문시장),30333,30485,60818,30409
20240731,4호선,서울역,14303,24358,38661,19330.5
20240731,4호선,숙대입구(갈월),14253,14155,28408,14204
20240731,4호선,삼각지,6518,7461,13979,6989.5
20240731,4호선,신용산,22326,23634,45960,22980
20240731,4호선,이촌(국립중앙박물관),11633,12108,23741,11870.5
20240731,4호선,동작(현충원),1325,1408,2733,1366.5
20240731,4호선,총신대입구(이수),19493,21120,40613,20306.5
20240731,4호선,사당,27365,23342,50707,25353.5
20240731,4호선,남태령,1406,1249,2655,1327.5
20240731,5호선,방화,7328,7052,14380,7190
20240731,5호선,개화산,6421,5973,12394,6197
20240731,5호선,김포공항,12350,9082,21432,10716
20240731,5호선,송정,6560,6111,12671,6335.5
20240731,5호선,마곡,12805,12841,25646,12823
20240731,5호선,발산,23295,24094,47389,23694.5
20240731,5호선,우장산,15167,15001,30168,15084
20240731,5호선,화곡,29020,26953,55973,27986.5
20240731,5호선,까치산,28429,27329,55758,27879
20240731,5호선,신정(은행정),13930,11703,25633,12816.5
20240731,5호선,목동,16982,18411,35393,17696.5
20240731,5호선,오목교(목동운동장앞),21741,23083,44824,22412
20240731,5호선,양평,8125,7934,16059,8029.5
20240731,5호선,영등포구청,4906,4835,9741,4870.5
20240731,5호선,영등포시장,11770,11938,23708,11854
20240731,5호선,신길,5279,5400,10679,5339.5
20240731,5호선,여의도,32876,33972,66848,33424
20240731,5호선,여의나루,14014,16077,30091,15045.5
20240731,5호선,마포,15551,16142,31693,15846.5
20240731,5호선,공덕,15361,16348,31709,15854.5
20240731,5호선,애오개,7107,6869,13976,6988
20240731,5호선,충정로(경기대입구),5080,5184,10264,5132
20240731,5호선,서대문,21353,21674,43027,21513.5
20240731,5호선,광화문(세종문화회관),37971,40083,78054,39027
20240731,5호선,종로3가,14578,14612,29190,14595
20240731,5호선,을지로4가,6543,6606,13149,6574.5
20240731,5호선,동대문역사문화공원(DDP),3290,3787,7077,3538.5
20240731,5호선,청구,4010,3826,7836,3918
20240731,5호선,신금호,6490,6736,13226,6613
20240731,5호선,행당,8323,7208,15531,7765.5
20240731,5호선,왕십리(성동구청),4685,5420,10105,5052.5
20240731,5호선,마장,5944,5558,11502,5751
20240731,5호선,답십리,16453,14918,31371,15685.5
20240731,5호선,장한평,20484,20286,40770,20385
20240731,5호선,군자(능동),11534,12812,24346,12173
20240731,5호선,아차산(어린이대공원후문),14061,13993,28054,14027
20240731,5호선,광나루(장신대),13388,12202,25590,12795
20240731,5호선,천호(풍납토성),20409,20084,40493,20246.5
20240731,5호선,강동,19555,18935,38490,19245
20240731,5호선,길동,8669,8933,17602,8801
20240731,5호선,굽은다리(강동구민회관앞),10175,9777,19952,9976
20240731,5호선,명일,8851,9111,17962,8981
20240731,5호선,고덕,10883,10725,21608,10804
20240731,5호선,상일동,15348,14354,29702,14851
20240731,5호선,둔촌동,9142,9118,18260,9130
20240731,5호선,올림픽공원(한국체대),5485,4408,9893,4946.5
20240731,5호선,오금,3796,3790,7586,3793
20240731,5호선,개롱,6790,7034,13824,6912
20240731,5호선,거여,10292,10050,20342,10171
20240731,5호선,마천,7595,6819,14414,7207
20240731,5호선,강일,6011,5591,11602,5801
20240731,5호선,미사,18426,18742,37168,18584
20240731,5호선,하남풍산,4602,4581,9183,4591.5
20240731,5호선,하남시청(덕풍·신장),8356,7809,16165,8082.5
20240731,5호선,하남검단산,6543,6254,12797,6398.5
20240731,6호선,응암,18249,17992,36241,18120.5
20240731,6호선,역촌,4042,4582,8624,4312
20240731,6호선,불광,5229,4912,10141,5070.5
20240731,6호선,독바위,2956,3013,5969,2984.5
20240731,6호선,연신내,4,0,4,2
20240731,6호선,구산,8647,6637,15284,7642
20240731,6호선,새절(신사),13186,12306,25492,12746
20240731,6호선,증산(명지대앞),10171,9907,20078,10039
20240731,6호선,디지털미디어시티,18992,17518,36510,18255
20240731,6호선,월드컵경기장(성산),30240,43623,73863,36931.5
20240731,6호선,마포구청,18525,15227,33752,16876
20240731,6호선,망원,16813,17603,34416,17208
20240731,6호선,합정,15930,16002,31932,15966
20240731,6호선,상수,10231,11214,21445,10722.5
20240731,6호선,광흥창(서강),10011,9513,19524,9762
20240731,6호선,대흥(서강대앞),8995,9380,18375,9187.5
20240731,6호선,공덕,21122,20721,41843,20921.5
20240731,6호선,효창공원앞,7362,6569,13931,6965.5
20240731,6호선,삼각지,8259,7358,15617,7808.5
20240731,6호선,녹사평(용산구청),5221,5077,10298,5149
20240731,6호선,이태원,10946,11510,22456,11228
20240731,6호선,한강진,10965,12334,23299,11649.5
20240731,6호선,버티고개,2264,2244,4508,2254
20240731,6호선,약수,3890,3971,7861,3930.5
20240731,6호선,청구,4247,4172,8419,4209.5
20240731,6호선,신당,9591,9865,19456,9728
20240731,6호선,동묘앞,8601,8881,17482,8741
20240731,6호선,창신,3564,2779,6343,3171.5
20240731,6호선,보문,8040,7562,15602,7801
20240731,6호선,안암(고대병원앞),11446,11333,22779,11389.5
20240731,6호선,고려대(종암),8746,8369,17115,8557.5
20240731,6호선,월곡(동덕여대),12011,11706,23717,11858.5
20240731,6호선,상월곡(한국과학기술연구원),6401,5779,12180,6090
20240731,6호선,돌곶이,10559,9599,20158,10079
20240731,6호선,석계,12600,12869,25469,12734.5
20240731,6호선,태릉입구,5620,6310,11930,5965
20240731,6호선,화랑대(서울여대입구),11892,9221,21113,10556.5
20240731,6호선,봉화산(서울의료원),9438,8724,18162,9081
20240731,7호선,장암,2882,1320,4202,2101
20240731,7호선,도봉산,9020,10453,19473,9736.5
20240731,7호선,수락산,12493,12486,24979,12489.5
20240731,7호선,마들,13310,12549,25859,12929.5
20240731,7호선,노원,25423,26275,51698,25849
20240731,7호선,중계,15204,13969,29173,14586.5
20240731,7호선,하계,18656,17475,36131,18065.5
20240731,7호선,공릉(서울과학기술대),11920,11752,23672,11836
20240731,7호선,태릉입구,8850,8337,17187,8593.5
20240731,7호선,먹골,10509,10314,20823,10411.5
20240731,7호선,중화,10706,10533,21239,10619.5
20240731,7호선,상봉,18374,17507,35881,17940.5
20240731,7호선,면목,15289,14631,29920,14960
20240731,7호선,사가정,16399,16534,32933,16466.5
20240731,7호선,용마산(용마폭포공원),5838,5623,11461,5730.5
20240731,7호선,중곡,11259,10692,21951,10975.5
20240731,7호선,군자(능동),15914,12615,28529,14264.5
20240731,7호선,어린이대공원(세종대),13787,13781,27568,13784
20240731,7호선,건대입구,14212,14269,28481,14240.5
20240731,7호선,자양(뚝섬한강공원),9607,9325,18932,9466
20240731,7호선,청담,19820,21600,41420,20710
20240731,7호선,강남구청,16730,18769,35499,17749.5
20240731,7호선,학동,25297,26211,51508,25754
20240731,7호선,논현,19441,20174,39615,19807.5
20240731,7호선,반포,6693,6359,13052,6526
20240731,7호선,고속터미널,18067,14642,32709,16354.5
20240731,7호선,내방,15484,15774,31258,15629
20240731,7호선,이수,17091,16845,33936,16968
20240731,7호선,남성,11580,11054,22634,11317
20240731,7호선,숭실대입구(살피재),12480,12455,24935,12467.5
20240731,7호선,상도,11366,10934,22300,11150
20240731,7호선,장승배기,9522,9163,18685,9342.5
20240731,7호선,신대방삼거리,15155,14679,29834,14917
20240731,7호선,보라매,6720,6871,13591,6795.5
20240731,7호선,신풍,11494,10664,22158,11079
20240731,7호선,대림(구로구청),9328,9366,18694,9347
20240731,7호선,남구로,15284,16072,31356,15678
20240731,7호선,가산디지털단지,47493,47452,94945,47472.5
20240731,7호선,철산,21851,22156,44007,22003.5
